speaker,start,stop,duration,country,family,recipient,theme,round,speech_act
mother,2400,3140,740,Argentina,A01,c,1,1,a
mother,6750,8070,1320,Argentina,A01,c,3,1,a
child,9070,9980,910,Argentina,A01,b,3,2,a
mother,12830,14710,1880,Argentina,A01,c,3,3,a
father,15760,16330,570,Argentina,A01,c,3,4,q
mother,16120,17020,900,Argentina,A01,c,3,5,q
father,22170,22770,600,Argentina,A01,m,4,1,q
mother,22860,29480,6620,Argentina,A01,c,5,1,a
father,25020,25670,650,Argentina,A01,m,5,2,q
father,30030,30780,750,Argentina,A01,m,5,3,q
mother,32520,37535,5015,Argentina,A01,f,5,4,a
mother,40880,44030,3150,Argentina,A01,f,5,5,a
mother,46670,47790,1120,Argentina,A01,f,5,6,a
father,46810,48480,1670,Argentina,A01,m,5,7,a
mother,48370,49660,1290,Argentina,A01,f,5,8,a
child,52420,55620,3200,Argentina,A01,f,6,1,a
child,60490,61270,780,Argentina,A01,f,6,2,a
father,61360,62840,1480,Argentina,A01,c,6,3,a
father,64790,69190,4400,Argentina,A01,m,6,4,a
mother,69230,70830,1600,Argentina,A01,f,6,5,a
father,71060,71750,690,Argentina,A01,m,6,6,a
mother,74090,75460,1370,Argentina,A01,f,6,7,q
father,76190,78590,2400,Argentina,A01,m,6,8,a
mother,78650,80540,1890,Argentina,A01,f,6,9,a
father,83400,92960,9560,Argentina,A01,m,6,10,a
mother,94930,95910,980,Argentina,A01,f,6,11,a
father,96660,99580,2920,Argentina,A01,m,6,12,a
mother,104770,108070,3300,Argentina,A01,c,7,1,i
father,111450,112390,940,Argentina,A01,c,7,2,q
child,112700,113660,960,Argentina,A01,m,7,3,a
mother,114940,116100,1160,Argentina,A01,c,7,4,q
child,117200,117970,770,Argentina,A01,m,7,5,a
mother,118600,119510,910,Argentina,A01,c,7,6,q
child,119630,120430,800,Argentina,A01,m,7,7,a
mother,120140,121190,1050,Argentina,A01,c,7,8,a
father,122940,124560,1620,Argentina,A01,m,7,9,a
child,125480,126390,910,Argentina,A01,m,7,10,a
child,130420,131350,930,Argentina,A01,m,7,11,a
mother,131450,132510,1060,Argentina,A01,c,7,12,a
mother,138920,140340,1420,Argentina,A01,f,8,1,a
father,141080,142120,1040,Argentina,A01,m,8,2,a
mother,149480,157020,7540,Argentina,A01,f,8,3,a
father,163040,163880,840,Argentina,A01,m,8,4,a
child,166490,167480,990,Argentina,A01,f,8,5,q
mother,169250,173850,4600,Argentina,A01,c,8,6,a
father,175440,176500,1060,Argentina,A01,c,8,7,a
father,192470,196000,3530,Argentina,A01,m,10,1,a
mother,197640,199140,1500,Argentina,A01,f,10,2,a
father,199400,207620,8220,Argentina,A01,m,10,3,a
mother,207770,209300,1530,Argentina,A01,f,10,4,a
father,209190,212310,3120,Argentina,A01,m,10,5,a
father,218110,219370,1260,Argentina,A01,c,11,1,q
child,221250,222210,960,Argentina,A01,f,11,2,a
father,222580,223710,1130,Argentina,A01,c,11,3,a
mother,222990,224060,1070,Argentina,A01,c,11,4,a
father,225140,227000,1860,Argentina,A01,c,11,5,a
mother,225400,231360,5960,Argentina,A01,c,11,6,a
father,229330,230940,1610,Argentina,A01,c,11,7,i
mother,232010,243650,11640,Argentina,A01,c,11,8,a
father,241870,244150,2280,Argentina,A01,c,11,9,a
child,254160,255150,990,Argentina,A01,f,11,10,a
mother,255530,257240,1710,Argentina,A01,f,12,1,q
father,255600,258860,3260,Argentina,A01,m,12,2,a
mother,258590,261340,2750,Argentina,A01,f,12,3,a
father,261220,262430,1210,Argentina,A01,m,12,4,a
father,264910,267470,2560,Argentina,A01,m,12,5,a
father,270570,271520,950,Argentina,A01,m,12,6,a
mother,274510,279550,5040,Argentina,A01,f,12,7,a
father,278910,281970,3060,Argentina,A01,m,12,8,a
father,287470,290650,3180,Argentina,A01,m,12,9,a
child,276600,278670,2070,Argentina,A01,b,13,1,a
father,296220,297530,1310,Argentina,A01,c,14,1,a
mother,298420,299700,1280,Argentina,A01,c,15,1,q
child,300120,300900,780,Argentina,A01,m,15,2,a
child,303200,304120,920,Argentina,A01,b,15,3,a
mother,303700,305310,1610,Argentina,A01,c,15,4,a
child,305520,312570,7050,Argentina,A01,f,15,5,i
father,312350,316070,3720,Argentina,A01,c,15,6,a
child,317830,318370,540,Argentina,A01,f,15,7,a
mother,318970,320220,1250,Argentina,A01,c,15,8,q
father,325540,328580,3040,Argentina,A01,c,15,9,i
mother,327880,329980,2100,Argentina,A01,f,15,10,a
child,328150,328900,750,Argentina,A01,f,15,11,a
mother,330940,332720,1780,Argentina,A01,c,15,12,q
child,331420,332380,960,Argentina,A01,f,15,13,a
father,335980,336800,820,Argentina,A01,c,15,14,q
child,336030,336710,680,Argentina,A01,f,15,15,a
mother,342320,343240,920,Argentina,A01,c,15,16,q
child,343260,344230,970,Argentina,A01,m,15,17,a
mother,344150,351850,7700,Argentina,A01,c,15,18,i
mother,353670,355420,1750,Argentina,A01,c,15,19,i
mother,337780,339260,1480,Argentina,A01,f,16,1,a
child,353370,354350,980,Argentina,A01,b,17,1,a
child,356030,358430,2400,Argentina,A01,f,17,2,a
father,358350,359050,700,Argentina,A01,c,17,3,q
child,359280,360400,1120,Argentina,A01,f,17,4,a
father,360440,361550,1110,Argentina,A01,c,17,5,a
child,362520,363410,890,Argentina,A01,b,17,6,a
child,364960,366930,1970,Argentina,A01,m,18,1,a
mother,367340,369030,1690,Argentina,A01,c,18,2,a
child,369470,373210,3740,Argentina,A01,m,18,3,a
mother,371870,375500,3630,Argentina,A01,c,18,4,q
child,377930,378590,660,Argentina,A01,m,18,5,a
mother,378890,382110,3220,Argentina,A01,c,18,6,a
child,380660,383690,3030,Argentina,A01,m,18,7,a
mother,383450,385450,2000,Argentina,A01,c,18,8,i
father,386580,388560,1980,Argentina,A01,c,18,9,i
child,391680,392340,660,Argentina,A01,m,18,10,a
father,392360,393000,640,Argentina,A01,c,18,11,i
child,393070,393980,910,Argentina,A01,m,18,12,a
father,397940,399040,1100,Argentina,A01,c,18,13,a
child,402250,403790,1540,Argentina,A01,f,18,14,a
child,425350,428230,2880,Argentina,A01,m,19,1,a
mother,434850,435630,780,Argentina,A01,c,19,2,a
father,435490,437680,2190,Argentina,A01,c,19,3,a
mother,437860,438750,890,Argentina,A01,c,19,4,q
child,440500,443070,2570,Argentina,A01,m,19,5,a
mother,442010,443590,1580,Argentina,A01,c,19,6,a
child,446830,447680,850,Argentina,A01,m,19,7,a
child,472130,473180,1050,Argentina,A01,m,20,1,a
father,474010,474930,920,Argentina,A01,m,21,1,a
child,477250,478170,920,Argentina,A01,b,22,1,a
mother,481210,489570,8360,Argentina,A01,f,22,2,a
father,486700,491410,4710,Argentina,A01,c,22,3,i
child,488720,489240,520,Argentina,A01,f,22,4,a
child,491460,491940,480,Argentina,A01,f,22,5,a
father,492110,496310,4200,Argentina,A01,c,22,6,a
child,493770,494670,900,Argentina,A01,f,22,7,a
father,497410,501870,4460,Argentina,A01,m,22,8,i
father,503720,504750,1030,Argentina,A01,c,22,9,a
mother,507740,509460,1720,Argentina,A01,f,22,10,a
father,510910,511630,720,Argentina,A01,c,22,11,i
child,513100,514000,900,Argentina,A01,f,22,12,a
child,516710,519650,2940,Argentina,A01,b,22,13,a
father,575540,577360,1820,Argentina,A01,m,23,1,a
mother,577580,578770,1190,Argentina,A01,f,23,2,a
father,582900,588020,5120,Argentina,A01,c,24,1,q
child,588700,589510,810,Argentina,A01,f,24,2,q
father,589530,590130,600,Argentina,A01,c,24,3,a
child,590340,591220,880,Argentina,A01,f,24,4,a
father,591200,591710,510,Argentina,A01,c,24,5,a
child,592790,595400,2610,Argentina,A01,f,25,1,a
father,595420,596550,1130,Argentina,A01,c,26,1,i
father,522370,524900,2530,Argentina,A01,m,30,1,i
mother,527230,528500,1270,Argentina,A01,f,30,2,a
child,536080,537000,920,Argentina,A01,m,30,3,a
father,538320,540930,2610,Argentina,A01,c,30,4,i
mother,539420,540190,770,Argentina,A01,c,30,5,q
child,546190,546850,660,Argentina,A01,m,30,6,a
mother,546890,547970,1080,Argentina,A01,c,30,7,a
father,546910,547480,570,Argentina,A01,c,30,8,a
child,549060,550160,1100,Argentina,A01,b,30,9,a
mother,550240,551350,1110,Argentina,A01,c,30,10,i
child,551590,552660,1070,Argentina,A01,m,30,11,a
father,551980,552970,990,Argentina,A01,c,30,12,a
mother,553920,558130,4210,Argentina,A01,c,30,13,a
mother,561410,563360,1950,Argentina,A01,c,30,14,i
silence,1430,2400,970,Argentina,A01,NA,NA,NA,NA
silence,3140,6750,3610,Argentina,A01,NA,NA,NA,NA
silence,8070,9070,1000,Argentina,A01,NA,NA,NA,NA
silence,9980,12830,2850,Argentina,A01,NA,NA,NA,NA
silence,14710,15760,1050,Argentina,A01,NA,NA,NA,NA
silence,17020,22170,5150,Argentina,A01,NA,NA,NA,NA
silence,22770,22860,90,Argentina,A01,NA,NA,NA,NA
silence,29480,30030,550,Argentina,A01,NA,NA,NA,NA
silence,30780,32520,1740,Argentina,A01,NA,NA,NA,NA
mother_gesture,35350,36670,1320,Argentina,A01,NA,NA,NA,NA
silence,37535,40880,3345,Argentina,A01,NA,NA,NA,NA
mother_gesture,40385,43178,2793,Argentina,A01,NA,NA,NA,NA
silence,44030,46670,2640,Argentina,A01,NA,NA,NA,NA
mother_gesture,47227,49988,2761,Argentina,A01,NA,NA,NA,NA
silence,49660,52420,2760,Argentina,A01,NA,NA,NA,NA
child_gesture,51622,53751,2129,Argentina,A01,NA,NA,NA,NA
silence,55620,60490,4870,Argentina,A01,NA,NA,NA,NA
child_gesture,59980,61600,1620,Argentina,A01,NA,NA,NA,NA
silence,61270,61360,90,Argentina,A01,NA,NA,NA,NA
silence,62840,64790,1950,Argentina,A01,NA,NA,NA,NA
silence,69190,69230,40,Argentina,A01,NA,NA,NA,NA
silence,70830,71060,230,Argentina,A01,NA,NA,NA,NA
silence,71750,74090,2340,Argentina,A01,NA,NA,NA,NA
mother_gesture,74293,75878,1585,Argentina,A01,NA,NA,NA,NA
silence,75460,76190,730,Argentina,A01,NA,NA,NA,NA
silence,78590,78650,60,Argentina,A01,NA,NA,NA,NA
silence,80540,83400,2860,Argentina,A01,NA,NA,NA,NA
father_gesture,90116,91496,1380,Argentina,A01,NA,NA,NA,NA
father_gesture,91630,93596,1966,Argentina,A01,NA,NA,NA,NA
silence,92960,94930,1970,Argentina,A01,NA,NA,NA,NA
silence,95910,96660,750,Argentina,A01,NA,NA,NA,NA
father_gesture,96114,97913,1799,Argentina,A01,NA,NA,NA,NA
silence,99580,104770,5190,Argentina,A01,NA,NA,NA,NA
silence,108070,111450,3380,Argentina,A01,NA,NA,NA,NA
child_gesture,111161,113772,2611,Argentina,A01,NA,NA,NA,NA
silence,112390,112700,310,Argentina,A01,NA,NA,NA,NA
silence,113660,114940,1280,Argentina,A01,NA,NA,NA,NA
silence,116100,117200,1100,Argentina,A01,NA,NA,NA,NA
silence,117970,118600,630,Argentina,A01,NA,NA,NA,NA
silence,119510,119630,120,Argentina,A01,NA,NA,NA,NA
silence,121190,122940,1750,Argentina,A01,NA,NA,NA,NA
father_gesture,123101,124781,1680,Argentina,A01,NA,NA,NA,NA
silence,124560,125480,920,Argentina,A01,NA,NA,NA,NA
silence,126390,130420,4030,Argentina,A01,NA,NA,NA,NA
silence,131350,131450,100,Argentina,A01,NA,NA,NA,NA
silence,132510,138920,6410,Argentina,A01,NA,NA,NA,NA
silence,140340,141080,740,Argentina,A01,NA,NA,NA,NA
silence,142120,149480,7360,Argentina,A01,NA,NA,NA,NA
silence,157020,163040,6020,Argentina,A01,NA,NA,NA,NA
silence,163880,166490,2610,Argentina,A01,NA,NA,NA,NA
silence,167480,169250,1770,Argentina,A01,NA,NA,NA,NA
mother_gesture,169832,171391,1559,Argentina,A01,NA,NA,NA,NA
silence,173850,175440,1590,Argentina,A01,NA,NA,NA,NA
silence,176500,192470,15970,Argentina,A01,NA,NA,NA,NA
father_gesture,193230,195402,2172,Argentina,A01,NA,NA,NA,NA
silence,196000,197640,1640,Argentina,A01,NA,NA,NA,NA
silence,199140,199400,260,Argentina,A01,NA,NA,NA,NA
father_gesture,199767,201147,1380,Argentina,A01,NA,NA,NA,NA
father_gesture,205720,207704,1984,Argentina,A01,NA,NA,NA,NA
silence,207620,207770,150,Argentina,A01,NA,NA,NA,NA
father_gesture,209807,211428,1621,Argentina,A01,NA,NA,NA,NA
silence,212310,218110,5800,Argentina,A01,NA,NA,NA,NA
silence,219370,221250,1880,Argentina,A01,NA,NA,NA,NA
silence,222210,222580,370,Argentina,A01,NA,NA,NA,NA
silence,224060,225140,1080,Argentina,A01,NA,NA,NA,NA
silence,231360,232010,650,Argentina,A01,NA,NA,NA,NA
mother_gesture,234282,236113,1831,Argentina,A01,NA,NA,NA,NA
mother_gesture,236930,238730,1800,Argentina,A01,NA,NA,NA,NA
father_gesture,242395,243955,1560,Argentina,A01,NA,NA,NA,NA
silence,244150,254160,10010,Argentina,A01,NA,NA,NA,NA
father_gesture,254666,257006,2340,Argentina,A01,NA,NA,NA,NA
silence,255150,255530,380,Argentina,A01,NA,NA,NA,NA
silence,262430,264910,2480,Argentina,A01,NA,NA,NA,NA
silence,267470,270570,3100,Argentina,A01,NA,NA,NA,NA
silence,271520,274510,2990,Argentina,A01,NA,NA,NA,NA
silence,281970,287470,5500,Argentina,A01,NA,NA,NA,NA
silence,290650,296220,5570,Argentina,A01,NA,NA,NA,NA
silence,297530,298420,890,Argentina,A01,NA,NA,NA,NA
silence,299700,300120,420,Argentina,A01,NA,NA,NA,NA
silence,300900,303200,2300,Argentina,A01,NA,NA,NA,NA
silence,305310,305520,210,Argentina,A01,NA,NA,NA,NA
silence,316070,317830,1760,Argentina,A01,NA,NA,NA,NA
silence,318370,318970,600,Argentina,A01,NA,NA,NA,NA
silence,320220,325540,5320,Argentina,A01,NA,NA,NA,NA
silence,329980,330940,960,Argentina,A01,NA,NA,NA,NA
silence,332720,335980,3260,Argentina,A01,NA,NA,NA,NA
silence,336800,337780,980,Argentina,A01,NA,NA,NA,NA
silence,339260,342320,3060,Argentina,A01,NA,NA,NA,NA
silence,343240,343260,20,Argentina,A01,NA,NA,NA,NA
silence,351850,353370,1520,Argentina,A01,NA,NA,NA,NA
silence,355420,356030,610,Argentina,A01,NA,NA,NA,NA
silence,359050,359280,230,Argentina,A01,NA,NA,NA,NA
silence,360400,360440,40,Argentina,A01,NA,NA,NA,NA
silence,361550,362520,970,Argentina,A01,NA,NA,NA,NA
silence,363410,364960,1550,Argentina,A01,NA,NA,NA,NA
silence,366930,367340,410,Argentina,A01,NA,NA,NA,NA
silence,369030,369470,440,Argentina,A01,NA,NA,NA,NA
silence,375500,377930,2430,Argentina,A01,NA,NA,NA,NA
silence,378590,378890,300,Argentina,A01,NA,NA,NA,NA
silence,385450,386580,1130,Argentina,A01,NA,NA,NA,NA
silence,388560,391680,3120,Argentina,A01,NA,NA,NA,NA
silence,392340,392360,20,Argentina,A01,NA,NA,NA,NA
silence,393000,393070,70,Argentina,A01,NA,NA,NA,NA
silence,393980,397940,3960,Argentina,A01,NA,NA,NA,NA
silence,399040,402250,3210,Argentina,A01,NA,NA,NA,NA
silence,403790,425350,21560,Argentina,A01,NA,NA,NA,NA
silence,428230,434850,6620,Argentina,A01,NA,NA,NA,NA
silence,437680,437860,180,Argentina,A01,NA,NA,NA,NA
silence,438750,440500,1750,Argentina,A01,NA,NA,NA,NA
silence,443590,446830,3240,Argentina,A01,NA,NA,NA,NA
silence,447680,472130,24450,Argentina,A01,NA,NA,NA,NA
silence,473180,474010,830,Argentina,A01,NA,NA,NA,NA
silence,474930,477250,2320,Argentina,A01,NA,NA,NA,NA
silence,478170,481210,3040,Argentina,A01,NA,NA,NA,NA
mother_gesture,485319,487270,1951,Argentina,A01,NA,NA,NA,NA
silence,491410,491460,50,Argentina,A01,NA,NA,NA,NA
silence,491940,492110,170,Argentina,A01,NA,NA,NA,NA
silence,496310,497410,1100,Argentina,A01,NA,NA,NA,NA
silence,501870,503720,1850,Argentina,A01,NA,NA,NA,NA
silence,504750,507740,2990,Argentina,A01,NA,NA,NA,NA
silence,509460,510910,1450,Argentina,A01,NA,NA,NA,NA
silence,511630,513100,1470,Argentina,A01,NA,NA,NA,NA
silence,514000,516710,2710,Argentina,A01,NA,NA,NA,NA
silence,519650,522370,2720,Argentina,A01,NA,NA,NA,NA
silence,524900,527230,2330,Argentina,A01,NA,NA,NA,NA
silence,528500,536080,7580,Argentina,A01,NA,NA,NA,NA
silence,537000,538320,1320,Argentina,A01,NA,NA,NA,NA
silence,540930,546190,5260,Argentina,A01,NA,NA,NA,NA
silence,546850,546890,40,Argentina,A01,NA,NA,NA,NA
silence,547970,549060,1090,Argentina,A01,NA,NA,NA,NA
silence,550160,550240,80,Argentina,A01,NA,NA,NA,NA
silence,551350,551590,240,Argentina,A01,NA,NA,NA,NA
silence,552970,553920,950,Argentina,A01,NA,NA,NA,NA
silence,558130,561410,3280,Argentina,A01,NA,NA,NA,NA
silence,563360,575540,12180,Argentina,A01,NA,NA,NA,NA
silence,577360,577580,220,Argentina,A01,NA,NA,NA,NA
silence,578770,582900,4130,Argentina,A01,NA,NA,NA,NA
silence,588020,588700,680,Argentina,A01,NA,NA,NA,NA
silence,589510,589530,20,Argentina,A01,NA,NA,NA,NA
silence,590130,590340,210,Argentina,A01,NA,NA,NA,NA
silence,591710,592790,1080,Argentina,A01,NA,NA,NA,NA
silence,595400,595420,20,Argentina,A01,NA,NA,NA,NA
mother,3300,5380,2080,Argentina,A02,f,1,1,q
father,5740,8630,2890,Argentina,A02,m,1,2,a
mother,8300,9330,1030,Argentina,A02,f,1,3,q
father,9630,24870,15240,Argentina,A02,m,1,4,a
mother,13600,14290,690,Argentina,A02,f,1,5,a
mother,17580,18140,560,Argentina,A02,f,1,6,a
mother,25300,27200,1900,Argentina,A02,f,1,7,a
father,27750,31160,3410,Argentina,A02,m,1,8,a
father,32020,44500,12480,Argentina,A02,m,1,9,a
mother,38220,38860,640,Argentina,A02,f,1,10,a
mother,45000,47920,2920,Argentina,A02,f,1,11,q
father,48950,49650,700,Argentina,A02,m,1,12,a
mother,49520,50410,890,Argentina,A02,f,1,13,q
father,50130,52380,2250,Argentina,A02,m,1,14,a
mother,51930,56690,4760,Argentina,A02,f,1,15,a
father,56880,61840,4960,Argentina,A02,m,1,16,a
mother,61980,64660,2680,Argentina,A02,f,1,17,a
father,65090,66170,1080,Argentina,A02,c,2,1,q
mother,67490,68740,1250,Argentina,A02,f,3,1,a
father,70280,71270,990,Argentina,A02,m,4,1,q
mother,71930,72450,520,Argentina,A02,f,4,2,a
mother,72620,89270,16650,Argentina,A02,o,5,1,a
mother,93970,95780,1810,Argentina,A02,c,6,1,q
child,98680,101540,2860,Argentina,A02,m,6,2,a
mother,101320,103710,2390,Argentina,A02,b,6,3,a
child,102510,103250,740,Argentina,A02,m,6,4,a
father,103780,105910,2130,Argentina,A02,b,6,5,a
mother,104960,106060,1100,Argentina,A02,c,6,6,q
child,105110,106680,1570,Argentina,A02,b,6,7,a
mother,106790,107650,860,Argentina,A02,c,6,8,q
father,107680,110000,2320,Argentina,A02,c,6,9,q
child,108300,108800,500,Argentina,A02,b,6,10,a
mother,110180,111640,1460,Argentina,A02,c,6,11,q
child,111740,112360,620,Argentina,A02,m,6,12,a
mother,112710,114690,1980,Argentina,A02,c,6,13,q
child,114790,115560,770,Argentina,A02,m,6,14,a
mother,116210,119030,2820,Argentina,A02,c,6,15,q
child,119070,120030,960,Argentina,A02,m,6,16,a
father,119870,125030,5160,Argentina,A02,m,7,1,a
mother,125660,126340,680,Argentina,A02,f,7,2,a
child,122410,125490,3080,Argentina,A02,b,8,1,a
mother,127980,128900,920,Argentina,A02,c,8,2,q
mother,131550,132350,800,Argentina,A02,c,8,3,q
mother,134180,137150,2970,Argentina,A02,f,9,1,a
father,138280,140040,1760,Argentina,A02,m,10,1,q
mother,140060,142230,2170,Argentina,A02,f,10,2,a
father,146160,151220,5060,Argentina,A02,m,11,1,q
mother,151700,156450,4750,Argentina,A02,f,11,2,a
father,156720,157680,960,Argentina,A02,m,11,3,q
mother,157720,161510,3790,Argentina,A02,f,11,4,a
father,163080,166960,3880,Argentina,A02,m,11,5,q
mother,166980,168190,1210,Argentina,A02,f,11,6,a
father,168190,168840,650,Argentina,A02,m,11,7,q
mother,169130,173550,4420,Argentina,A02,f,11,8,a
mother,175610,177930,2320,Argentina,A02,f,11,9,a
father,179630,180200,570,Argentina,A02,c,12,1,a
mother,180370,180960,590,Argentina,A02,f,13,1,q
father,181540,190460,8920,Argentina,A02,m,13,2,a
mother,191310,192010,700,Argentina,A02,f,13,3,q
mother,194370,196020,1650,Argentina,A02,f,13,4,q
father,196490,197440,950,Argentina,A02,m,13,5,a
mother,197310,198180,870,Argentina,A02,f,13,6,q
father,198240,202200,3960,Argentina,A02,m,13,7,a
child,192490,193780,1290,Argentina,A02,b,14,1,a
mother,205010,206290,1280,Argentina,A02,c,15,1,a
mother,210460,211950,1490,Argentina,A02,c,15,2,q
child,212110,213410,1300,Argentina,A02,m,15,3,a
child,214930,216420,1490,Argentina,A02,m,15,4,a
mother,216470,218240,1770,Argentina,A02,c,15,5,q
child,218540,218960,420,Argentina,A02,m,15,6,a
father,204520,206320,1800,Argentina,A02,m,17,1,q
father,210630,211730,1100,Argentina,A02,m,17,2,a
father,213750,214680,930,Argentina,A02,m,17,3,a
father,218450,219470,1020,Argentina,A02,m,17,4,a
father,219470,221530,2060,Argentina,A02,c,18,1,q
mother,221170,222760,1590,Argentina,A02,f,18,2,a
child,221490,222080,590,Argentina,A02,f,18,3,a
father,222600,223390,790,Argentina,A02,b,18,4,a
mother,226420,228440,2020,Argentina,A02,c,18,5,q
father,226520,227710,1190,Argentina,A02,m,19,1,a
father,230110,232550,2440,Argentina,A02,m,19,2,a
mother,231770,234920,3150,Argentina,A02,f,19,3,q
father,235230,238320,3090,Argentina,A02,m,19,4,a
mother,237790,238930,1140,Argentina,A02,f,19,5,q
father,240170,242580,2410,Argentina,A02,m,19,6,a
mother,243770,244370,600,Argentina,A02,f,19,7,a
child,251550,255690,4140,Argentina,A02,m,19,8,a
father,256340,256910,570,Argentina,A02,c,19,9,q
mother,256620,257410,790,Argentina,A02,c,19,10,q
child,257600,260620,3020,Argentina,A02,m,19,11,q
father,260430,261990,1560,Argentina,A02,m,19,12,q
mother,261910,266010,4100,Argentina,A02,c,19,13,q
child,265910,266440,530,Argentina,A02,m,19,14,a
father,266470,267340,870,Argentina,A02,c,19,15,a
mother,266530,269070,2540,Argentina,A02,c,19,16,q
child,269370,270380,1010,Argentina,A02,m,19,17,a
mother,270110,271910,1800,Argentina,A02,c,19,18,a
father,272390,273730,1340,Argentina,A02,m,20,1,a
father,277080,279560,2480,Argentina,A02,m,20,2,a
mother,290240,292060,1820,Argentina,A02,f,20,3,NA
father,292800,294280,1480,Argentina,A02,m,20,4,a
mother,294970,296740,1770,Argentina,A02,c,22,1,i
mother,299270,301970,2700,Argentina,A02,c,22,2,a
mother,306200,310610,4410,Argentina,A02,c,22,3,a
father,311410,315850,4440,Argentina,A02,c,22,4,a
mother,312150,313210,1060,Argentina,A02,f,22,5,a
mother,317210,318850,1640,Argentina,A02,c,22,6,a
father,318860,325460,6600,Argentina,A02,m,22,7,a
mother,327030,327590,560,Argentina,A02,f,22,8,a
child,330900,333420,2520,Argentina,A02,m,22,9,a
father,333440,335240,1800,Argentina,A02,c,22,10,a
mother,335340,336390,1050,Argentina,A02,c,22,11,a
father,296940,299830,2890,Argentina,A02,m,23,1,a
father,302100,305240,3140,Argentina,A02,m,23,2,a
father,345490,346370,880,Argentina,A02,c,23,3,q
child,347720,348440,720,Argentina,A02,f,23,4,a
father,348720,349820,1100,Argentina,A02,c,23,5,a
child,348960,350850,1890,Argentina,A02,f,23,6,i
mother,362240,365360,3120,Argentina,A02,c,23,7,q
child,366030,366770,740,Argentina,A02,m,23,8,a
child,372890,374770,1880,Argentina,A02,f,23,9,q
father,374970,377520,2550,Argentina,A02,c,23,10,a
child,380200,382840,2640,Argentina,A02,f,23,11,a
mother,380260,380930,670,Argentina,A02,f,23,12,a
mother,383550,385270,1720,Argentina,A02,f,23,13,q
child,384820,387410,2590,Argentina,A02,f,23,14,a
father,385210,385710,500,Argentina,A02,m,23,15,a
father,387780,391550,3770,Argentina,A02,c,23,16,a
child,392030,395140,3110,Argentina,A02,f,23,17,a
father,394500,395530,1030,Argentina,A02,c,23,18,a
mother,395280,397100,1820,Argentina,A02,c,23,19,a
father,397120,398360,1240,Argentina,A02,m,23,20,a
mother,401290,406440,5150,Argentina,A02,f,23,21,a
father,406760,408650,1890,Argentina,A02,m,23,22,q
mother,408560,411750,3190,Argentina,A02,f,23,23,a
father,412560,414140,1580,Argentina,A02,m,23,24,a
mother,414640,416860,2220,Argentina,A02,f,23,25,a
father,415470,416620,1150,Argentina,A02,m,23,26,q
mother,416920,418450,1530,Argentina,A02,f,23,27,a
father,417690,418920,1230,Argentina,A02,m,23,28,q
mother,419060,422140,3080,Argentina,A02,f,23,29,a
father,420860,423390,2530,Argentina,A02,m,23,30,a
mother,425860,426460,600,Argentina,A02,f,23,31,a
father,409070,410990,1920,Argentina,A02,m,24,1,q
mother,435010,435650,640,Argentina,A02,f,25,1,a
child,435770,436700,930,Argentina,A02,b,26,1,a
father,437900,439340,1440,Argentina,A02,c,26,2,q
child,439690,440260,570,Argentina,A02,f,26,3,a
father,441820,442630,810,Argentina,A02,c,26,4,q
child,443910,444750,840,Argentina,A02,f,26,5,a
father,444990,445970,980,Argentina,A02,c,26,6,q
child,445860,449090,3230,Argentina,A02,m,27,1,a
mother,449500,450160,660,Argentina,A02,c,27,2,a
child,450190,453310,3120,Argentina,A02,m,27,3,a
mother,453890,455840,1950,Argentina,A02,c,27,4,i
mother,461540,466890,5350,Argentina,A02,c,28,1,q
child,470980,473130,2150,Argentina,A02,m,28,2,a
mother,473480,474450,970,Argentina,A02,c,28,3,q
child,474680,475760,1080,Argentina,A02,m,28,4,a
mother,477490,478140,650,Argentina,A02,c,28,5,a
child,467540,468300,760,Argentina,A02,b,29,1,a
father,483890,486260,2370,Argentina,A02,c,29,2,q
father,488110,490920,2810,Argentina,A02,m,29,3,a
mother,490340,494680,4340,Argentina,A02,c,29,4,a
child,494920,501610,6690,Argentina,A02,m,29,5,a
mother,499830,501600,1770,Argentina,A02,c,29,6,a
mother,503500,505050,1550,Argentina,A02,c,29,7,i
child,505740,510910,5170,Argentina,A02,m,29,8,a
mother,508070,509210,1140,Argentina,A02,c,29,9,q
father,548490,550960,2470,Argentina,A02,m,29,10,a
mother,551510,555130,3620,Argentina,A02,f,29,11,a
father,551670,555860,4190,Argentina,A02,m,29,12,a
mother,556620,557150,530,Argentina,A02,f,29,13,a
father,564460,565120,660,Argentina,A02,c,30,1,q
mother,574680,577200,2520,Argentina,A02,f,31,1,q
father,577520,582750,5230,Argentina,A02,m,31,2,a
father,587530,588970,1440,Argentina,A02,c,31,3,a
father,595520,596720,1200,Argentina,A02,c,31,4,a
mother,30970,32270,1300,Argentina,A02,c,33,1,a
child,479440,483840,4400,Argentina,A02,b,34,1,a
father,516400,517860,1460,Argentina,A02,c,35,1,q
child,517960,523240,5280,Argentina,A02,f,35,2,a
mother,523270,524190,920,Argentina,A02,c,35,3,i
father,525340,526460,1120,Argentina,A02,c,35,4,q
mother,527770,528820,1050,Argentina,A02,c,35,5,a
father,528060,528650,590,Argentina,A02,c,35,6,a
father,530920,531500,580,Argentina,A02,c,35,7,a
child,531000,532880,1880,Argentina,A02,f,35,8,a
father,533110,536360,3250,Argentina,A02,c,35,9,q
mother,536260,542480,6220,Argentina,A02,c,35,10,a
child,540160,542370,2210,Argentina,A02,b,35,11,a
father,541160,542010,850,Argentina,A02,m,35,12,a
child,546070,548180,2110,Argentina,A02,b,35,13,a
silence,5380,5740,360,Argentina,A02,NA,NA,NA,NA
silence,9330,9630,300,Argentina,A02,NA,NA,NA,NA
silence,24870,25300,430,Argentina,A02,NA,NA,NA,NA
silence,27200,27750,550,Argentina,A02,NA,NA,NA,NA
silence,44500,45000,500,Argentina,A02,NA,NA,NA,NA
silence,47920,48950,1030,Argentina,A02,NA,NA,NA,NA
silence,56690,56880,190,Argentina,A02,NA,NA,NA,NA
silence,61840,61980,140,Argentina,A02,NA,NA,NA,NA
silence,64660,65090,430,Argentina,A02,NA,NA,NA,NA
silence,66170,67490,1320,Argentina,A02,NA,NA,NA,NA
silence,68740,70280,1540,Argentina,A02,NA,NA,NA,NA
silence,71270,71930,660,Argentina,A02,NA,NA,NA,NA
silence,72450,72620,170,Argentina,A02,NA,NA,NA,NA
silence,89270,93970,4700,Argentina,A02,NA,NA,NA,NA
silence,95780,98680,2900,Argentina,A02,NA,NA,NA,NA
silence,103710,103780,70,Argentina,A02,NA,NA,NA,NA
silence,106680,106790,110,Argentina,A02,NA,NA,NA,NA
silence,107650,107680,30,Argentina,A02,NA,NA,NA,NA
silence,110000,110180,180,Argentina,A02,NA,NA,NA,NA
silence,111640,111740,100,Argentina,A02,NA,NA,NA,NA
silence,112360,112710,350,Argentina,A02,NA,NA,NA,NA
silence,114690,114790,100,Argentina,A02,NA,NA,NA,NA
silence,115560,116210,650,Argentina,A02,NA,NA,NA,NA
silence,119030,119070,40,Argentina,A02,NA,NA,NA,NA
silence,125490,125660,170,Argentina,A02,NA,NA,NA,NA
silence,126340,127980,1640,Argentina,A02,NA,NA,NA,NA
silence,128900,131550,2650,Argentina,A02,NA,NA,NA,NA
silence,132350,134180,1830,Argentina,A02,NA,NA,NA,NA
mother_gesture,134642,135894,1252,Argentina,A02,NA,NA,NA,NA
silence,137150,138280,1130,Argentina,A02,NA,NA,NA,NA
silence,140040,140060,20,Argentina,A02,NA,NA,NA,NA
silence,142230,146160,3930,Argentina,A02,NA,NA,NA,NA
silence,151220,151700,480,Argentina,A02,NA,NA,NA,NA
mother_gesture,154462,156506,2044,Argentina,A02,NA,NA,NA,NA
silence,156450,156720,270,Argentina,A02,NA,NA,NA,NA
silence,157680,157720,40,Argentina,A02,NA,NA,NA,NA
silence,161510,163080,1570,Argentina,A02,NA,NA,NA,NA
silence,166960,166980,20,Argentina,A02,NA,NA,NA,NA
silence,168840,169130,290,Argentina,A02,NA,NA,NA,NA
silence,173550,175610,2060,Argentina,A02,NA,NA,NA,NA
silence,177930,179630,1700,Argentina,A02,NA,NA,NA,NA
silence,180200,180370,170,Argentina,A02,NA,NA,NA,NA
silence,180960,181540,580,Argentina,A02,NA,NA,NA,NA
silence,190460,191310,850,Argentina,A02,NA,NA,NA,NA
silence,192010,192490,480,Argentina,A02,NA,NA,NA,NA
silence,193780,194370,590,Argentina,A02,NA,NA,NA,NA
silence,196020,196490,470,Argentina,A02,NA,NA,NA,NA
silence,198180,198240,60,Argentina,A02,NA,NA,NA,NA
silence,202200,204520,2320,Argentina,A02,NA,NA,NA,NA
silence,206320,210460,4140,Argentina,A02,NA,NA,NA,NA
silence,211950,212110,160,Argentina,A02,NA,NA,NA,NA
silence,213410,213750,340,Argentina,A02,NA,NA,NA,NA
silence,214680,214930,250,Argentina,A02,NA,NA,NA,NA
silence,216420,216470,50,Argentina,A02,NA,NA,NA,NA
silence,218240,218450,210,Argentina,A02,NA,NA,NA,NA
silence,223390,226420,3030,Argentina,A02,NA,NA,NA,NA
silence,228440,230110,1670,Argentina,A02,NA,NA,NA,NA
silence,234920,235230,310,Argentina,A02,NA,NA,NA,NA
father_gesture,238860,241273,2413,Argentina,A02,NA,NA,NA,NA
silence,238930,240170,1240,Argentina,A02,NA,NA,NA,NA
silence,242580,243770,1190,Argentina,A02,NA,NA,NA,NA
silence,244370,251550,7180,Argentina,A02,NA,NA,NA,NA
child_gesture,254140,256180,2040,Argentina,A02,NA,NA,NA,NA
silence,255690,256340,650,Argentina,A02,NA,NA,NA,NA
silence,257410,257600,190,Argentina,A02,NA,NA,NA,NA
silence,266440,266470,30,Argentina,A02,NA,NA,NA,NA
mother_gesture,268017,270027,2010,Argentina,A02,NA,NA,NA,NA
silence,269070,269370,300,Argentina,A02,NA,NA,NA,NA
silence,271910,272390,480,Argentina,A02,NA,NA,NA,NA
silence,273730,277080,3350,Argentina,A02,NA,NA,NA,NA
silence,279560,290240,10680,Argentina,A02,NA,NA,NA,NA
silence,292060,292800,740,Argentina,A02,NA,NA,NA,NA
silence,294280,294970,690,Argentina,A02,NA,NA,NA,NA
silence,296740,296940,200,Argentina,A02,NA,NA,NA,NA
silence,301970,302100,130,Argentina,A02,NA,NA,NA,NA
silence,305240,306200,960,Argentina,A02,NA,NA,NA,NA
mother_gesture,308239,310425,2186,Argentina,A02,NA,NA,NA,NA
silence,310610,311410,800,Argentina,A02,NA,NA,NA,NA
silence,315850,317210,1360,Argentina,A02,NA,NA,NA,NA
silence,318850,318860,10,Argentina,A02,NA,NA,NA,NA
silence,325460,327030,1570,Argentina,A02,NA,NA,NA,NA
silence,327590,330900,3310,Argentina,A02,NA,NA,NA,NA
child_gesture,331531,333923,2392,Argentina,A02,NA,NA,NA,NA
silence,333420,333440,20,Argentina,A02,NA,NA,NA,NA
silence,335240,335340,100,Argentina,A02,NA,NA,NA,NA
silence,336390,345490,9100,Argentina,A02,NA,NA,NA,NA
silence,346370,347720,1350,Argentina,A02,NA,NA,NA,NA
silence,348440,348720,280,Argentina,A02,NA,NA,NA,NA
silence,350850,362240,11390,Argentina,A02,NA,NA,NA,NA
silence,365360,366030,670,Argentina,A02,NA,NA,NA,NA
silence,366770,372890,6120,Argentina,A02,NA,NA,NA,NA
silence,374770,374970,200,Argentina,A02,NA,NA,NA,NA
silence,377520,380200,2680,Argentina,A02,NA,NA,NA,NA
child_gesture,380053,382192,2139,Argentina,A02,NA,NA,NA,NA
silence,382840,383550,710,Argentina,A02,NA,NA,NA,NA
silence,387410,387780,370,Argentina,A02,NA,NA,NA,NA
silence,391550,392030,480,Argentina,A02,NA,NA,NA,NA
silence,397100,397120,20,Argentina,A02,NA,NA,NA,NA
silence,398360,401290,2930,Argentina,A02,NA,NA,NA,NA
silence,406440,406760,320,Argentina,A02,NA,NA,NA,NA
mother_gesture,408607,410340,1733,Argentina,A02,NA,NA,NA,NA
silence,411750,412560,810,Argentina,A02,NA,NA,NA,NA
silence,414140,414640,500,Argentina,A02,NA,NA,NA,NA
silence,416860,416920,60,Argentina,A02,NA,NA,NA,NA
silence,418920,419060,140,Argentina,A02,NA,NA,NA,NA
silence,423390,425860,2470,Argentina,A02,NA,NA,NA,NA
silence,426460,435010,8550,Argentina,A02,NA,NA,NA,NA
silence,435650,435770,120,Argentina,A02,NA,NA,NA,NA
silence,436700,437900,1200,Argentina,A02,NA,NA,NA,NA
silence,439340,439690,350,Argentina,A02,NA,NA,NA,NA
silence,440260,441820,1560,Argentina,A02,NA,NA,NA,NA
silence,442630,443910,1280,Argentina,A02,NA,NA,NA,NA
silence,444750,444990,240,Argentina,A02,NA,NA,NA,NA
child_gesture,446608,449093,2485,Argentina,A02,NA,NA,NA,NA
silence,449090,449500,410,Argentina,A02,NA,NA,NA,NA
silence,450160,450190,30,Argentina,A02,NA,NA,NA,NA
silence,453310,453890,580,Argentina,A02,NA,NA,NA,NA
silence,455840,461540,5700,Argentina,A02,NA,NA,NA,NA
silence,466890,467540,650,Argentina,A02,NA,NA,NA,NA
silence,468300,470980,2680,Argentina,A02,NA,NA,NA,NA
silence,473130,473480,350,Argentina,A02,NA,NA,NA,NA
silence,474450,474680,230,Argentina,A02,NA,NA,NA,NA
silence,475760,477490,1730,Argentina,A02,NA,NA,NA,NA
silence,478140,479440,1300,Argentina,A02,NA,NA,NA,NA
silence,483840,483890,50,Argentina,A02,NA,NA,NA,NA
silence,486260,488110,1850,Argentina,A02,NA,NA,NA,NA
silence,494680,494920,240,Argentina,A02,NA,NA,NA,NA
silence,501610,503500,1890,Argentina,A02,NA,NA,NA,NA
silence,505050,505740,690,Argentina,A02,NA,NA,NA,NA
silence,510910,516400,5490,Argentina,A02,NA,NA,NA,NA
silence,517860,517960,100,Argentina,A02,NA,NA,NA,NA
silence,523240,523270,30,Argentina,A02,NA,NA,NA,NA
silence,524190,525340,1150,Argentina,A02,NA,NA,NA,NA
father_gesture,525130,526606,1476,Argentina,A02,NA,NA,NA,NA
silence,526460,527770,1310,Argentina,A02,NA,NA,NA,NA
silence,528820,530920,2100,Argentina,A02,NA,NA,NA,NA
silence,532880,533110,230,Argentina,A02,NA,NA,NA,NA
silence,542480,546070,3590,Argentina,A02,NA,NA,NA,NA
silence,548180,548490,310,Argentina,A02,NA,NA,NA,NA
silence,550960,551510,550,Argentina,A02,NA,NA,NA,NA
silence,555860,556620,760,Argentina,A02,NA,NA,NA,NA
silence,557150,564460,7310,Argentina,A02,NA,NA,NA,NA
silence,565120,574680,9560,Argentina,A02,NA,NA,NA,NA
mother_gesture,575620,577330,1710,Argentina,A02,NA,NA,NA,NA
silence,577200,577520,320,Argentina,A02,NA,NA,NA,NA
father_gesture,577619,579767,2148,Argentina,A02,NA,NA,NA,NA
silence,582750,585380,2630,Argentina,A02,NA,NA,NA,NA
child_gesture,587991,589244,1253,Argentina,A02,NA,NA,NA,NA
child_gesture,595722,597267,1545,Argentina,A02,NA,NA,NA,NA
mother,730,2670,1940,Argentina,A03,f,1,1,a
child,2200,5020,2820,Argentina,A03,m,2,1,a
mother,4190,8340,4150,Argentina,A03,c,2,2,a
child,8140,9280,1140,Argentina,A03,m,2,3,a
mother,17460,21070,3610,Argentina,A03,c,2,4,q
child,20870,21590,720,Argentina,A03,m,2,5,a
mother,22250,23980,1730,Argentina,A03,c,2,6,a
child,26270,27850,1580,Argentina,A03,m,2,7,a
mother,28840,29650,810,Argentina,A03,c,2,8,a
child,30510,31620,1110,Argentina,A03,m,2,9,a
mother,32240,33590,1350,Argentina,A03,c,2,10,q
child,34920,37270,2350,Argentina,A03,m,2,11,a
mother,37720,39160,1440,Argentina,A03,c,2,12,a
child,39000,40610,1610,Argentina,A03,m,2,13,a
mother,41330,43680,2350,Argentina,A03,c,2,14,a
child,45900,47020,1120,Argentina,A03,m,2,15,a
mother,9440,13590,4150,Argentina,A03,f,3,1,a
mother,13630,15970,2340,Argentina,A03,c,4,1,a
child,57250,60600,3350,Argentina,A03,b,5,1,a
father,58240,58980,740,Argentina,A03,m,6,1,a
mother,59810,60600,790,Argentina,A03,f,6,2,q
father,60030,61600,1570,Argentina,A03,m,6,3,a
mother,65340,67070,1730,Argentina,A03,f,7,1,q
father,66890,68150,1260,Argentina,A03,m,7,2,a
child,67710,68780,1070,Argentina,A03,m,8,1,a
mother,69750,71360,1610,Argentina,A03,c,8,2,a
child,72040,73100,1060,Argentina,A03,m,8,3,q
mother,73120,73720,600,Argentina,A03,c,8,4,a
child,73750,74410,660,Argentina,A03,m,8,5,q
mother,74600,76550,1950,Argentina,A03,c,8,6,a
mother,79180,86990,7810,Argentina,A03,c,8,7,i
mother,88940,99390,10450,Argentina,A03,c,9,1,a
child,100860,103080,2220,Argentina,A03,m,9,2,a
child,105260,106070,810,Argentina,A03,m,9,3,a
child,111700,112480,780,Argentina,A03,m,9,4,a
mother,100890,102500,1610,Argentina,A03,f,10,1,a
father,100920,108920,8000,Argentina,A03,m,11,1,a
mother,105900,106480,580,Argentina,A03,f,11,2,a
father,111830,112810,980,Argentina,A03,m,11,3,i
child,113440,116190,2750,Argentina,A03,m,12,1,a
child,133020,136250,3230,Argentina,A03,m,13,1,a
mother,162010,164090,2080,Argentina,A03,f,14,1,a
mother,165110,167730,2620,Argentina,A03,f,15,1,q
father,171920,172830,910,Argentina,A03,m,16,1,q
father,178500,186110,7610,Argentina,A03,m,16,2,a
mother,182340,183140,800,Argentina,A03,f,16,3,a
mother,186250,188300,2050,Argentina,A03,f,16,4,a
father,188840,189450,610,Argentina,A03,m,16,5,q
mother,190650,194530,3880,Argentina,A03,f,16,6,a
father,194520,204960,10440,Argentina,A03,m,16,7,a
mother,203930,204810,880,Argentina,A03,f,16,8,a
mother,207160,208290,1130,Argentina,A03,c,17,1,q
child,208860,209390,530,Argentina,A03,m,17,2,a
child,215220,216510,1290,Argentina,A03,m,17,3,a
child,220050,221830,1780,Argentina,A03,m,17,4,a
child,225320,227010,1690,Argentina,A03,m,17,5,a
mother,227020,229830,2810,Argentina,A03,c,17,6,a
child,229740,231160,1420,Argentina,A03,f,17,7,a
father,234260,236220,1960,Argentina,A03,c,17,8,q
child,236160,236750,590,Argentina,A03,f,17,9,a
child,241074,241763,689,Argentina,A03,f,17,10,a
father,241920,245270,3350,Argentina,A03,c,18,1,q
child,247080,248020,940,Argentina,A03,f,18,2,a
father,247290,248500,1210,Argentina,A03,c,18,3,q
child,248650,249380,730,Argentina,A03,f,18,4,a
father,249400,250010,610,Argentina,A03,c,18,5,q
child,250380,251480,1100,Argentina,A03,f,18,6,a
father,251510,252920,1410,Argentina,A03,c,18,7,q
child,253490,254310,820,Argentina,A03,f,18,8,a
father,254390,255270,880,Argentina,A03,c,18,9,q
child,255090,256190,1100,Argentina,A03,f,18,10,a
father,256190,257820,1630,Argentina,A03,c,18,11,a
child,257830,258490,660,Argentina,A03,f,18,12,a
child,264600,267720,3120,Argentina,A03,NA,18,13,NA
father,267240,267980,740,Argentina,A03,c,18,14,a
child,271550,273580,2030,Argentina,A03,f,18,15,a
father,273100,273720,620,Argentina,A03,c,18,16,a
mother,262370,264940,2570,Argentina,A03,f,19,1,a
father,274150,278080,3930,Argentina,A03,c,20,1,a
child,278910,279510,600,Argentina,A03,f,20,2,q
father,279820,284530,4710,Argentina,A03,c,20,3,a
child,285680,287760,2080,Argentina,A03,f,20,4,a
father,287610,288500,890,Argentina,A03,c,20,5,a
child,289930,290780,850,Argentina,A03,f,20,6,q
father,290670,292500,1830,Argentina,A03,c,20,7,a
child,292590,293530,940,Argentina,A03,f,20,8,q
father,293660,295350,1690,Argentina,A03,c,20,9,a
child,295490,296330,840,Argentina,A03,f,20,10,q
father,296690,298030,1340,Argentina,A03,c,20,11,a
child,298080,299150,1070,Argentina,A03,f,20,12,q
child,301570,302530,960,Argentina,A03,f,20,13,q
father,302270,304780,2510,Argentina,A03,c,20,14,a
child,307110,308010,900,Argentina,A03,f,20,15,q
child,313830,317800,3970,Argentina,A03,f,21,1,a
father,318130,318850,720,Argentina,A03,c,21,2,q
child,318890,321120,2230,Argentina,A03,f,21,3,a
father,323910,325020,1110,Argentina,A03,c,21,4,q
child,325940,329390,3450,Argentina,A03,f,21,5,q
child,337820,340410,2590,Argentina,A03,f,21,6,q
father,341570,342510,940,Argentina,A03,c,21,7,q
child,342730,344260,1530,Argentina,A03,f,21,8,a
father,346280,347670,1390,Argentina,A03,c,21,9,q
child,347800,349600,1800,Argentina,A03,f,21,10,a
father,350540,352130,1590,Argentina,A03,c,21,11,q
child,352450,352920,470,Argentina,A03,f,21,12,a
father,353760,359140,5380,Argentina,A03,c,21,13,a
child,359200,359860,660,Argentina,A03,f,21,14,a
child,363340,367190,3850,Argentina,A03,f,21,15,q
father,367460,370590,3130,Argentina,A03,c,21,16,a
child,369810,370940,1130,Argentina,A03,f,21,17,a
father,370790,372810,2020,Argentina,A03,c,21,18,a
child,373510,375770,2260,Argentina,A03,f,21,19,a
father,375700,379530,3830,Argentina,A03,c,21,20,q
child,379530,380330,800,Argentina,A03,f,21,21,a
father,380300,380860,560,Argentina,A03,c,21,22,q
child,389130,394480,5350,Argentina,A03,f,21,23,a
father,394940,395780,840,Argentina,A03,c,21,24,a
child,397580,400460,2880,Argentina,A03,f,21,25,q
father,401050,401850,800,Argentina,A03,c,21,26,q
child,402010,404710,2700,Argentina,A03,f,21,27,q
father,404510,407070,2560,Argentina,A03,c,21,28,q
child,407340,411040,3700,Argentina,A03,f,21,29,a
mother,410180,427040,16860,Argentina,A03,f,22,1,a
child,428840,430100,1260,Argentina,A03,m,22,2,a
mother,430200,443800,13600,Argentina,A03,b,22,3,a
child,442070,442960,890,Argentina,A03,m,22,4,a
child,447790,450600,2810,Argentina,A03,f,23,1,q
father,451350,452530,1180,Argentina,A03,c,23,2,q
mother,453560,456950,3390,Argentina,A03,c,23,3,a
father,457110,459350,2240,Argentina,A03,c,23,4,a
child,458750,462080,3330,Argentina,A03,f,23,5,a
mother,459330,466090,6760,Argentina,A03,b,23,6,a
mother,466770,473720,6950,Argentina,A03,c,24,1,a
child,472640,473680,1040,Argentina,A03,m,24,2,a
mother,474240,478090,3850,Argentina,A03,c,24,3,a
mother,482390,490870,8480,Argentina,A03,c,24,4,i
child,490040,490820,780,Argentina,A03,m,24,5,q
child,478480,482270,3790,Argentina,A03,b,25,1,a
mother,492550,494410,1860,Argentina,A03,c,26,1,q
child,498230,500700,2470,Argentina,A03,f,27,1,a
child,503380,505690,2310,Argentina,A03,f,27,2,a
father,505560,506970,1410,Argentina,A03,c,27,3,a
child,507110,508180,1070,Argentina,A03,f,27,4,q
father,508560,509290,730,Argentina,A03,c,27,5,q
child,509480,510400,920,Argentina,A03,f,27,6,a
father,511020,511940,920,Argentina,A03,c,27,7,a
child,512160,512850,690,Argentina,A03,f,27,8,a
father,515930,516720,790,Argentina,A03,c,27,9,a
child,517810,519220,1410,Argentina,A03,f,27,10,a
child,523410,524940,1530,Argentina,A03,f,27,11,a
mother,525120,526160,1040,Argentina,A03,f,28,1,q
father,526360,526930,570,Argentina,A03,m,28,2,q
mother,532420,533420,1000,Argentina,A03,f,28,3,q
father,534070,534840,770,Argentina,A03,m,28,4,a
child,529180,531330,2150,Argentina,A03,b,29,1,a
child,537650,539430,1780,Argentina,A03,o,30,1,a
mother,542500,545170,2670,Argentina,A03,f,31,1,a
father,545110,545720,610,Argentina,A03,m,31,2,q
mother,545890,549040,3150,Argentina,A03,f,31,3,a
father,549030,549750,720,Argentina,A03,m,31,4,q
mother,549820,551530,1710,Argentina,A03,f,31,5,a
father,553240,554610,1370,Argentina,A03,m,31,6,a
father,563090,564100,1010,Argentina,A03,m,31,7,a
mother,565690,583620,17930,Argentina,A03,f,31,8,a
father,583680,584300,620,Argentina,A03,m,31,9,a
child,579400,583380,3980,Argentina,A03,o,32,1,a
mother,245810,247440,1630,Argentina,A03,f,35,1,q
silence,9280,9440,160,Argentina,A03,NA,NA,NA,NA
silence,13590,13630,40,Argentina,A03,NA,NA,NA,NA
silence,15970,17460,1490,Argentina,A03,NA,NA,NA,NA
silence,21590,22250,660,Argentina,A03,NA,NA,NA,NA
silence,23980,26270,2290,Argentina,A03,NA,NA,NA,NA
silence,27850,28840,990,Argentina,A03,NA,NA,NA,NA
silence,29650,30510,860,Argentina,A03,NA,NA,NA,NA
silence,31620,32240,620,Argentina,A03,NA,NA,NA,NA
silence,33590,34920,1330,Argentina,A03,NA,NA,NA,NA
silence,37270,37720,450,Argentina,A03,NA,NA,NA,NA
silence,40610,41330,720,Argentina,A03,NA,NA,NA,NA
silence,43680,45900,2220,Argentina,A03,NA,NA,NA,NA
silence,47020,57250,10230,Argentina,A03,NA,NA,NA,NA
silence,61600,65340,3740,Argentina,A03,NA,NA,NA,NA
silence,68780,69750,970,Argentina,A03,NA,NA,NA,NA
silence,71360,72040,680,Argentina,A03,NA,NA,NA,NA
silence,73100,73120,20,Argentina,A03,NA,NA,NA,NA
silence,73720,73750,30,Argentina,A03,NA,NA,NA,NA
silence,74410,74600,190,Argentina,A03,NA,NA,NA,NA
silence,76550,79180,2630,Argentina,A03,NA,NA,NA,NA
silence,86990,88940,1950,Argentina,A03,NA,NA,NA,NA
mother_gesture,95661,96404,743,Argentina,A03,NA,NA,NA,NA
mother_gesture,97093,98148,1055,Argentina,A03,NA,NA,NA,NA
silence,99390,100860,1470,Argentina,A03,NA,NA,NA,NA
silence,108920,111700,2780,Argentina,A03,NA,NA,NA,NA
silence,112810,113440,630,Argentina,A03,NA,NA,NA,NA
silence,116190,133020,16830,Argentina,A03,NA,NA,NA,NA
silence,136250,162010,25760,Argentina,A03,NA,NA,NA,NA
silence,164090,165110,1020,Argentina,A03,NA,NA,NA,NA
silence,167730,171920,4190,Argentina,A03,NA,NA,NA,NA
silence,172830,178500,5670,Argentina,A03,NA,NA,NA,NA
silence,186110,186250,140,Argentina,A03,NA,NA,NA,NA
silence,188300,188840,540,Argentina,A03,NA,NA,NA,NA
silence,189450,190650,1200,Argentina,A03,NA,NA,NA,NA
silence,204960,207160,2200,Argentina,A03,NA,NA,NA,NA
silence,208290,208860,570,Argentina,A03,NA,NA,NA,NA
silence,209390,215220,5830,Argentina,A03,NA,NA,NA,NA
silence,216510,220050,3540,Argentina,A03,NA,NA,NA,NA
silence,221830,225320,3490,Argentina,A03,NA,NA,NA,NA
silence,227010,227020,10,Argentina,A03,NA,NA,NA,NA
silence,231160,234260,3100,Argentina,A03,NA,NA,NA,NA
silence,236750,241074,4324,Argentina,A03,NA,NA,NA,NA
silence,241763,241920,157,Argentina,A03,NA,NA,NA,NA
silence,245270,245810,540,Argentina,A03,NA,NA,NA,NA
silence,248500,248650,150,Argentina,A03,NA,NA,NA,NA
silence,249380,249400,20,Argentina,A03,NA,NA,NA,NA
silence,250010,250380,370,Argentina,A03,NA,NA,NA,NA
silence,251480,251510,30,Argentina,A03,NA,NA,NA,NA
silence,252920,253490,570,Argentina,A03,NA,NA,NA,NA
silence,254310,254390,80,Argentina,A03,NA,NA,NA,NA
silence,257820,257830,10,Argentina,A03,NA,NA,NA,NA
silence,258490,262370,3880,Argentina,A03,NA,NA,NA,NA
silence,267980,271550,3570,Argentina,A03,NA,NA,NA,NA
silence,273720,274150,430,Argentina,A03,NA,NA,NA,NA
father_gesture,274680,276820,2140,Argentina,A03,NA,NA,NA,NA
father_gesture,277270,278330,1060,Argentina,A03,NA,NA,NA,NA
silence,278080,278910,830,Argentina,A03,NA,NA,NA,NA
child_gesture,278700,279710,1010,Argentina,A03,NA,NA,NA,NA
silence,279510,279820,310,Argentina,A03,NA,NA,NA,NA
silence,284530,285680,1150,Argentina,A03,NA,NA,NA,NA
silence,288500,289930,1430,Argentina,A03,NA,NA,NA,NA
silence,292500,292590,90,Argentina,A03,NA,NA,NA,NA
silence,293530,293660,130,Argentina,A03,NA,NA,NA,NA
silence,295350,295490,140,Argentina,A03,NA,NA,NA,NA
silence,296330,296690,360,Argentina,A03,NA,NA,NA,NA
silence,298030,298080,50,Argentina,A03,NA,NA,NA,NA
silence,299150,301570,2420,Argentina,A03,NA,NA,NA,NA
silence,304780,307110,2330,Argentina,A03,NA,NA,NA,NA
silence,308010,313830,5820,Argentina,A03,NA,NA,NA,NA
silence,317800,318130,330,Argentina,A03,NA,NA,NA,NA
silence,318850,318890,40,Argentina,A03,NA,NA,NA,NA
silence,321120,323910,2790,Argentina,A03,NA,NA,NA,NA
silence,325020,325940,920,Argentina,A03,NA,NA,NA,NA
child_gesture,328135,329548,1413,Argentina,A03,NA,NA,NA,NA
silence,329390,337820,8430,Argentina,A03,NA,NA,NA,NA
silence,340410,341570,1160,Argentina,A03,NA,NA,NA,NA
silence,342510,342730,220,Argentina,A03,NA,NA,NA,NA
silence,344260,346280,2020,Argentina,A03,NA,NA,NA,NA
silence,347670,347800,130,Argentina,A03,NA,NA,NA,NA
silence,349600,350540,940,Argentina,A03,NA,NA,NA,NA
silence,352130,352450,320,Argentina,A03,NA,NA,NA,NA
silence,352920,353760,840,Argentina,A03,NA,NA,NA,NA
father_gesture,354144,359402,5258,Argentina,A03,NA,NA,NA,NA
silence,359140,359200,60,Argentina,A03,NA,NA,NA,NA
silence,359860,363340,3480,Argentina,A03,NA,NA,NA,NA
silence,367190,367460,270,Argentina,A03,NA,NA,NA,NA
silence,372810,373510,700,Argentina,A03,NA,NA,NA,NA
silence,380860,389130,8270,Argentina,A03,NA,NA,NA,NA
silence,394480,394940,460,Argentina,A03,NA,NA,NA,NA
silence,395780,397580,1800,Argentina,A03,NA,NA,NA,NA
silence,400460,401050,590,Argentina,A03,NA,NA,NA,NA
silence,401850,402010,160,Argentina,A03,NA,NA,NA,NA
silence,407070,407340,270,Argentina,A03,NA,NA,NA,NA
silence,427040,428840,1800,Argentina,A03,NA,NA,NA,NA
silence,430100,430200,100,Argentina,A03,NA,NA,NA,NA
silence,443800,447790,3990,Argentina,A03,NA,NA,NA,NA
silence,450600,451350,750,Argentina,A03,NA,NA,NA,NA
silence,452530,453560,1030,Argentina,A03,NA,NA,NA,NA
silence,456950,457110,160,Argentina,A03,NA,NA,NA,NA
silence,466090,466770,680,Argentina,A03,NA,NA,NA,NA
mother_gesture,466640,467726,1086,Argentina,A03,NA,NA,NA,NA
silence,473720,474240,520,Argentina,A03,NA,NA,NA,NA
silence,478090,478480,390,Argentina,A03,NA,NA,NA,NA
silence,482270,482390,120,Argentina,A03,NA,NA,NA,NA
silence,490870,492550,1680,Argentina,A03,NA,NA,NA,NA
silence,494410,498230,3820,Argentina,A03,NA,NA,NA,NA
silence,500700,503380,2680,Argentina,A03,NA,NA,NA,NA
silence,506970,507110,140,Argentina,A03,NA,NA,NA,NA
silence,508180,508560,380,Argentina,A03,NA,NA,NA,NA
silence,509290,509480,190,Argentina,A03,NA,NA,NA,NA
silence,510400,511020,620,Argentina,A03,NA,NA,NA,NA
silence,511940,512160,220,Argentina,A03,NA,NA,NA,NA
silence,512850,515930,3080,Argentina,A03,NA,NA,NA,NA
silence,516720,517810,1090,Argentina,A03,NA,NA,NA,NA
silence,519220,523410,4190,Argentina,A03,NA,NA,NA,NA
silence,524940,525120,180,Argentina,A03,NA,NA,NA,NA
silence,526160,526360,200,Argentina,A03,NA,NA,NA,NA
silence,526930,529180,2250,Argentina,A03,NA,NA,NA,NA
silence,531330,532420,1090,Argentina,A03,NA,NA,NA,NA
silence,533420,534070,650,Argentina,A03,NA,NA,NA,NA
silence,534840,537650,2810,Argentina,A03,NA,NA,NA,NA
silence,539430,542500,3070,Argentina,A03,NA,NA,NA,NA
silence,545720,545890,170,Argentina,A03,NA,NA,NA,NA
silence,549750,549820,70,Argentina,A03,NA,NA,NA,NA
silence,551530,553240,1710,Argentina,A03,NA,NA,NA,NA
silence,554610,563090,8480,Argentina,A03,NA,NA,NA,NA
silence,564100,565690,1590,Argentina,A03,NA,NA,NA,NA
silence,583620,583680,60,Argentina,A03,NA,NA,NA,NA
silence,584300,586690,2390,Argentina,A03,NA,NA,NA,NA
mother,1110,3140,2030,Argentina,A04,f,1,1,a
father,3520,5020,1500,Argentina,A04,m,1,2,a
mother,4190,6080,1890,Argentina,A04,f,1,3,a
father,9590,11250,1660,Argentina,A04,m,1,4,a
mother,12270,16410,4140,Argentina,A04,f,1,5,a
father,17580,20080,2500,Argentina,A04,m,1,6,a
mother,24130,29560,5430,Argentina,A04,f,1,7,a
father,34610,38230,3620,Argentina,A04,m,1,8,a
father,45040,47580,2540,Argentina,A04,m,1,9,a
mother,51800,52560,760,Argentina,A04,f,1,10,a
child,7330,7820,490,Argentina,A04,o,3,1,q
child,27210,27830,620,Argentina,A04,o,4,1,a
mother,56270,57190,920,Argentina,A04,c,5,1,q
mother,61150,61770,620,Argentina,A04,c,5,2,q
father,62950,64860,1910,Argentina,A04,m,6,1,q
mother,65460,66650,1190,Argentina,A04,f,6,2,q
father,66790,67250,460,Argentina,A04,m,6,3,a
father,69670,70870,1200,Argentina,A04,m,6,4,a
father,77300,78200,900,Argentina,A04,m,6,5,a
mother,79310,80590,1280,Argentina,A04,f,6,6,a
father,81180,81770,590,Argentina,A04,m,6,7,q
mother,81910,83000,1090,Argentina,A04,f,6,8,a
father,83540,87270,3730,Argentina,A04,m,6,9,q
mother,89590,90160,570,Argentina,A04,f,6,10,a
father,92760,93440,680,Argentina,A04,m,6,11,a
father,109360,110090,730,Argentina,A04,m,7,1,q
mother,110210,110860,650,Argentina,A04,f,7,2,a
mother,113020,120050,7030,Argentina,A04,f,8,1,a
father,120890,123290,2400,Argentina,A04,m,8,2,a
mother,123330,124800,1470,Argentina,A04,f,8,3,a
mother,129700,134380,4680,Argentina,A04,f,8,4,a
father,132740,133590,850,Argentina,A04,m,8,5,a
child,135240,136170,930,Argentina,A04,m,9,1,a
mother,137550,138420,870,Argentina,A04,c,9,2,q
child,138700,141210,2510,Argentina,A04,m,10,1,a
mother,141760,142550,790,Argentina,A04,c,10,2,q
mother,153200,157550,4350,Argentina,A04,c,11,1,a
child,157440,157950,510,Argentina,A04,m,11,2,a
mother,158290,158910,620,Argentina,A04,c,11,3,a
child,159140,159560,420,Argentina,A04,m,11,4,a
mother,159810,162440,2630,Argentina,A04,c,11,5,a
mother,170410,172230,1820,Argentina,A04,f,12,1,a
father,187830,188760,930,Argentina,A04,m,13,1,q
mother,189560,190090,530,Argentina,A04,f,13,2,q
father,190550,191620,1070,Argentina,A04,m,13,3,q
mother,191858,208360,16502,Argentina,A04,f,13,4,a
mother,216100,216850,750,Argentina,A04,f,13,5,a
mother,219200,220610,1410,Argentina,A04,f,13,6,a
father,224320,228790,4470,Argentina,A04,c,15,1,a
mother,236310,237680,1370,Argentina,A04,f,16,1,a
father,238690,239720,1030,Argentina,A04,m,16,2,a
mother,240600,241630,1030,Argentina,A04,f,16,3,a
mother,245730,252350,6620,Argentina,A04,f,16,4,a
father,256270,257160,890,Argentina,A04,m,16,5,q
mother,258840,259790,950,Argentina,A04,f,16,6,a
father,264380,266630,2250,Argentina,A04,m,16,7,a
mother,266640,271510,4870,Argentina,A04,f,16,8,a
father,274740,275790,1050,Argentina,A04,m,16,9,a
mother,275790,276780,990,Argentina,A04,f,16,10,a
father,278290,280390,2100,Argentina,A04,m,16,11,q
mother,284280,288500,4220,Argentina,A04,f,16,12,a
father,290410,291160,750,Argentina,A04,m,16,13,q
mother,291190,292070,880,Argentina,A04,f,16,14,a
father,294000,296240,2240,Argentina,A04,m,16,15,q
mother,296740,297350,610,Argentina,A04,f,16,16,q
father,298410,299760,1350,Argentina,A04,m,16,17,q
mother,298500,300520,2020,Argentina,A04,f,16,18,a
mother,303110,307010,3900,Argentina,A04,f,16,19,a
father,307280,310610,3330,Argentina,A04,m,16,20,a
child,258070,260100,2030,Argentina,A04,b,17,1,a
child,267060,267980,920,Argentina,A04,b,18,1,a
father,313090,314360,1270,Argentina,A04,m,19,1,q
mother,315880,317630,1750,Argentina,A04,f,19,2,a
mother,324590,330920,6330,Argentina,A04,c,20,1,a
child,331010,331520,510,Argentina,A04,m,20,2,a
mother,331970,333190,1220,Argentina,A04,c,20,3,a
child,333330,336450,3120,Argentina,A04,m,20,4,a
father,349350,350500,1150,Argentina,A04,m,21,1,a
mother,352390,355560,3170,Argentina,A04,f,22,1,q
father,356230,356600,370,Argentina,A04,m,22,2,a
child,363130,364430,1300,Argentina,A04,m,23,1,a
mother,388040,388990,950,Argentina,A04,c,24,1,q
child,390110,391390,1280,Argentina,A04,m,24,2,a
child,396800,397460,660,Argentina,A04,m,24,3,a
mother,398690,399550,860,Argentina,A04,c,24,4,a
mother,403620,404410,790,Argentina,A04,f,25,1,a
mother,406590,407380,790,Argentina,A04,f,25,2,a
child,412150,417670,5520,Argentina,A04,b,26,1,a
father,413380,414170,790,Argentina,A04,c,26,2,a
father,416880,419150,2270,Argentina,A04,c,26,3,a
child,419410,420360,950,Argentina,A04,m,26,4,a
child,422770,423500,730,Argentina,A04,m,26,5,a
mother,423670,427890,4220,Argentina,A04,f,27,1,a
father,432340,433690,1350,Argentina,A04,m,27,2,a
mother,435710,437770,2060,Argentina,A04,f,27,3,a
father,438090,441990,3900,Argentina,A04,m,27,4,a
mother,444190,445790,1600,Argentina,A04,f,27,5,a
father,447710,448520,810,Argentina,A04,m,27,6,a
mother,453580,457720,4140,Argentina,A04,f,27,7,a
father,455280,459070,3790,Argentina,A04,m,27,8,a
mother,459620,460900,1280,Argentina,A04,f,27,9,a
father,464740,467260,2520,Argentina,A04,m,27,10,a
father,474560,479500,4940,Argentina,A04,m,27,11,a
mother,477930,480300,2370,Argentina,A04,f,27,12,a
mother,489930,497310,7380,Argentina,A04,f,28,1,a
father,497350,498560,1210,Argentina,A04,m,28,2,a
mother,499320,501520,2200,Argentina,A04,f,28,3,a
father,501800,502490,690,Argentina,A04,m,28,4,a
child,512900,513640,740,Argentina,A04,b,29,1,a
father,520100,527280,7180,Argentina,A04,m,30,1,a
mother,530530,535380,4850,Argentina,A04,f,30,2,a
mother,538180,544040,5860,Argentina,A04,f,30,3,a
child,525960,527470,1510,Argentina,A04,o,31,1,a
father,557110,558310,1200,Argentina,A04,m,32,1,q
mother,558940,560730,1790,Argentina,A04,f,32,2,a
father,565290,566190,900,Argentina,A04,m,32,3,q
mother,567320,568610,1290,Argentina,A04,f,32,4,a
mother,570740,576210,5470,Argentina,A04,f,32,5,a
mother,595730,599080,3350,Argentina,A04,f,33,1,q
silence,3140,3520,380,Argentina,A04,NA,NA,NA,NA
silence,6080,7330,1250,Argentina,A04,NA,NA,NA,NA
silence,7820,9590,1770,Argentina,A04,NA,NA,NA,NA
silence,11250,12270,1020,Argentina,A04,NA,NA,NA,NA
silence,16410,17580,1170,Argentina,A04,NA,NA,NA,NA
silence,20080,24130,4050,Argentina,A04,NA,NA,NA,NA
silence,29560,34610,5050,Argentina,A04,NA,NA,NA,NA
father_gesture,37509,38239,730,Argentina,A04,NA,NA,NA,NA
silence,38230,45040,6810,Argentina,A04,NA,NA,NA,NA
silence,47580,51800,4220,Argentina,A04,NA,NA,NA,NA
silence,52560,56270,3710,Argentina,A04,NA,NA,NA,NA
silence,57190,61150,3960,Argentina,A04,NA,NA,NA,NA
silence,61770,62950,1180,Argentina,A04,NA,NA,NA,NA
silence,64860,65460,600,Argentina,A04,NA,NA,NA,NA
silence,66650,66790,140,Argentina,A04,NA,NA,NA,NA
silence,67250,69670,2420,Argentina,A04,NA,NA,NA,NA
silence,70870,77300,6430,Argentina,A04,NA,NA,NA,NA
silence,78200,79310,1110,Argentina,A04,NA,NA,NA,NA
silence,80590,81180,590,Argentina,A04,NA,NA,NA,NA
silence,81770,81910,140,Argentina,A04,NA,NA,NA,NA
silence,83000,83540,540,Argentina,A04,NA,NA,NA,NA
silence,87270,89590,2320,Argentina,A04,NA,NA,NA,NA
silence,90160,92760,2600,Argentina,A04,NA,NA,NA,NA
silence,93440,109360,15920,Argentina,A04,NA,NA,NA,NA
father_gesture,109330,110660,1330,Argentina,A04,NA,NA,NA,NA
silence,110090,110210,120,Argentina,A04,NA,NA,NA,NA
silence,110860,113020,2160,Argentina,A04,NA,NA,NA,NA
silence,120050,120890,840,Argentina,A04,NA,NA,NA,NA
silence,123290,123330,40,Argentina,A04,NA,NA,NA,NA
silence,124800,129700,4900,Argentina,A04,NA,NA,NA,NA
silence,134380,135240,860,Argentina,A04,NA,NA,NA,NA
silence,136170,137550,1380,Argentina,A04,NA,NA,NA,NA
silence,138420,138700,280,Argentina,A04,NA,NA,NA,NA
silence,141210,141760,550,Argentina,A04,NA,NA,NA,NA
silence,142550,153200,10650,Argentina,A04,NA,NA,NA,NA
silence,157950,158290,340,Argentina,A04,NA,NA,NA,NA
silence,158910,159140,230,Argentina,A04,NA,NA,NA,NA
silence,159560,159810,250,Argentina,A04,NA,NA,NA,NA
mother_gesture,160170,161032,862,Argentina,A04,NA,NA,NA,NA
silence,162440,170410,7970,Argentina,A04,NA,NA,NA,NA
silence,172230,187830,15600,Argentina,A04,NA,NA,NA,NA
silence,188760,189560,800,Argentina,A04,NA,NA,NA,NA
silence,190090,190550,460,Argentina,A04,NA,NA,NA,NA
silence,191620,191858,238,Argentina,A04,NA,NA,NA,NA
mother_gesture,204774,207083,2309,Argentina,A04,NA,NA,NA,NA
silence,208360,216100,7740,Argentina,A04,NA,NA,NA,NA
silence,216850,219200,2350,Argentina,A04,NA,NA,NA,NA
silence,220610,224320,3710,Argentina,A04,NA,NA,NA,NA
silence,228790,236310,7520,Argentina,A04,NA,NA,NA,NA
silence,237680,238690,1010,Argentina,A04,NA,NA,NA,NA
silence,239720,240600,880,Argentina,A04,NA,NA,NA,NA
silence,241630,245730,4100,Argentina,A04,NA,NA,NA,NA
silence,252350,256270,3920,Argentina,A04,NA,NA,NA,NA
silence,257160,258070,910,Argentina,A04,NA,NA,NA,NA
silence,260100,264380,4280,Argentina,A04,NA,NA,NA,NA
silence,266630,266640,10,Argentina,A04,NA,NA,NA,NA
silence,271510,274740,3230,Argentina,A04,NA,NA,NA,NA
silence,276780,278290,1510,Argentina,A04,NA,NA,NA,NA
silence,280390,284280,3890,Argentina,A04,NA,NA,NA,NA
silence,288500,290410,1910,Argentina,A04,NA,NA,NA,NA
silence,291160,291190,30,Argentina,A04,NA,NA,NA,NA
silence,292070,294000,1930,Argentina,A04,NA,NA,NA,NA
silence,296240,296740,500,Argentina,A04,NA,NA,NA,NA
silence,297350,298410,1060,Argentina,A04,NA,NA,NA,NA
mother_gesture,300216,302342,2126,Argentina,A04,NA,NA,NA,NA
silence,300520,303110,2590,Argentina,A04,NA,NA,NA,NA
silence,307010,307280,270,Argentina,A04,NA,NA,NA,NA
silence,310610,313090,2480,Argentina,A04,NA,NA,NA,NA
silence,314360,315880,1520,Argentina,A04,NA,NA,NA,NA
silence,317630,324590,6960,Argentina,A04,NA,NA,NA,NA
silence,330920,331010,90,Argentina,A04,NA,NA,NA,NA
mother_gesture,331370,332793,1423,Argentina,A04,NA,NA,NA,NA
silence,331520,331970,450,Argentina,A04,NA,NA,NA,NA
silence,333190,333330,140,Argentina,A04,NA,NA,NA,NA
silence,336450,349350,12900,Argentina,A04,NA,NA,NA,NA
silence,350500,352390,1890,Argentina,A04,NA,NA,NA,NA
silence,355560,356230,670,Argentina,A04,NA,NA,NA,NA
silence,356600,363130,6530,Argentina,A04,NA,NA,NA,NA
silence,364430,388040,23610,Argentina,A04,NA,NA,NA,NA
silence,388990,390110,1120,Argentina,A04,NA,NA,NA,NA
silence,391390,396800,5410,Argentina,A04,NA,NA,NA,NA
silence,397460,398690,1230,Argentina,A04,NA,NA,NA,NA
silence,399550,403620,4070,Argentina,A04,NA,NA,NA,NA
silence,404410,406590,2180,Argentina,A04,NA,NA,NA,NA
silence,407380,412150,4770,Argentina,A04,NA,NA,NA,NA
silence,419150,419410,260,Argentina,A04,NA,NA,NA,NA
silence,420360,422770,2410,Argentina,A04,NA,NA,NA,NA
silence,423500,423670,170,Argentina,A04,NA,NA,NA,NA
silence,427890,432340,4450,Argentina,A04,NA,NA,NA,NA
silence,433690,435710,2020,Argentina,A04,NA,NA,NA,NA
silence,437770,438090,320,Argentina,A04,NA,NA,NA,NA
silence,441990,444190,2200,Argentina,A04,NA,NA,NA,NA
silence,445790,447710,1920,Argentina,A04,NA,NA,NA,NA
silence,448520,453580,5060,Argentina,A04,NA,NA,NA,NA
silence,459070,459620,550,Argentina,A04,NA,NA,NA,NA
silence,460900,464740,3840,Argentina,A04,NA,NA,NA,NA
silence,467260,474560,7300,Argentina,A04,NA,NA,NA,NA
silence,480300,489930,9630,Argentina,A04,NA,NA,NA,NA
mother_gesture,495935,497335,1400,Argentina,A04,NA,NA,NA,NA
silence,497310,497350,40,Argentina,A04,NA,NA,NA,NA
silence,498560,499320,760,Argentina,A04,NA,NA,NA,NA
silence,501520,501800,280,Argentina,A04,NA,NA,NA,NA
silence,502490,512900,10410,Argentina,A04,NA,NA,NA,NA
silence,513640,520100,6460,Argentina,A04,NA,NA,NA,NA
silence,527470,530530,3060,Argentina,A04,NA,NA,NA,NA
silence,535380,538180,2800,Argentina,A04,NA,NA,NA,NA
silence,544040,557110,13070,Argentina,A04,NA,NA,NA,NA
silence,558310,558940,630,Argentina,A04,NA,NA,NA,NA
silence,560730,565290,4560,Argentina,A04,NA,NA,NA,NA
silence,566190,567320,1130,Argentina,A04,NA,NA,NA,NA
silence,568610,570740,2130,Argentina,A04,NA,NA,NA,NA
silence,576210,595730,19520,Argentina,A04,NA,NA,NA,NA
silence,599080,599840,760,Argentina,A04,NA,NA,NA,NA
child,2460,3290,830,Argentina,A05,m,1,1,a
mother,3840,4740,900,Argentina,A05,c,1,2,q
father,9390,10100,710,Argentina,A05,c,1,3,a
father,12600,15350,2750,Argentina,A05,c,1,4,a
child,12850,13420,570,Argentina,A05,f,1,5,a
father,17980,18960,980,Argentina,A05,c,1,6,a
child,19420,20700,1280,Argentina,A05,f,1,7,q
father,20600,21790,1190,Argentina,A05,c,1,8,a
child,21770,22680,910,Argentina,A05,f,1,9,a
father,22610,23290,680,Argentina,A05,c,1,10,a
father,25490,26290,800,Argentina,A05,c,1,11,i
father,31890,34110,2220,Argentina,A05,c,1,12,a
mother,34890,36280,1390,Argentina,A05,c,1,13,q
father,36160,40540,4380,Argentina,A05,c,1,14,a
mother,40200,40870,670,Argentina,A05,c,1,15,a
father,46490,47440,950,Argentina,A05,m,2,1,a
father,56270,59740,3470,Argentina,A05,c,3,1,a
child,60860,61600,740,Argentina,A05,f,3,2,a
father,61650,62290,640,Argentina,A05,c,3,3,a
child,64290,67460,3170,Argentina,A05,f,3,4,a
father,67590,68560,970,Argentina,A05,c,3,5,q
child,79040,81020,1980,Argentina,A05,f,4,1,a
child,85300,85880,580,Argentina,A05,f,4,2,a
father,85340,85780,440,Argentina,A05,c,4,3,q
child,104480,105980,1500,Argentina,A05,m,4,4,a
mother,106290,106900,610,Argentina,A05,c,4,5,q
mother,110080,110720,640,Argentina,A05,c,4,6,q
father,111290,112290,1000,Argentina,A05,c,4,7,q
mother,122130,122900,770,Argentina,A05,c,5,1,a
mother,126460,127510,1050,Argentina,A05,c,5,2,i
mother,129710,130220,510,Argentina,A05,c,5,3,i
father,138670,139160,490,Argentina,A05,c,6,1,a
child,138730,139220,490,Argentina,A05,f,6,2,q
father,145760,147400,1640,Argentina,A05,c,6,3,a
father,167130,168270,1140,Argentina,A05,b,8,1,q
child,167900,168700,800,Argentina,A05,b,9,1,a
mother,169570,170900,1330,Argentina,A05,c,9,2,q
father,169890,170690,800,Argentina,A05,c,9,3,q
father,172690,173420,730,Argentina,A05,c,9,4,i
mother,173790,174370,580,Argentina,A05,c,9,5,i
father,181000,182100,1100,Argentina,A05,m,10,1,q
mother,328730,329500,770,Argentina,A05,c,11,1,a
mother,332370,333330,960,Argentina,A05,c,11,2,q
child,339490,340550,1060,Argentina,A05,b,11,3,a
mother,340340,341430,1090,Argentina,A05,c,11,4,a
father,342170,344560,2390,Argentina,A05,m,12,1,a
mother,348890,349500,610,Argentina,A05,f,12,2,q
father,350820,352500,1680,Argentina,A05,m,12,3,a
mother,354980,356210,1230,Argentina,A05,f,12,4,a
mother,357130,358690,1560,Argentina,A05,f,13,1,q
mother,366800,367380,580,Argentina,A05,f,13,2,q
father,367110,367980,870,Argentina,A05,m,13,3,a
mother,368060,368970,910,Argentina,A05,f,13,4,q
father,370490,372320,1830,Argentina,A05,m,13,5,a
father,374580,376140,1560,Argentina,A05,m,13,6,a
mother,377230,380500,3270,Argentina,A05,f,13,7,a
father,386840,388450,1610,Argentina,A05,m,13,8,a
mother,388730,389220,490,Argentina,A05,f,13,9,a
father,390150,391540,1390,Argentina,A05,m,13,10,a
mother,392820,396670,3850,Argentina,A05,f,13,11,a
child,361370,362320,950,Argentina,A05,b,14,1,a
mother,362310,363900,1590,Argentina,A05,f,14,2,a
child,397940,399100,1160,Argentina,A05,b,14,3,a
father,399110,399770,660,Argentina,A05,c,14,4,a
mother,403450,405120,1670,Argentina,A05,c,14,5,a
father,404840,405680,840,Argentina,A05,m,15,1,q
mother,406410,409370,2960,Argentina,A05,f,15,2,a
mother,412980,413570,590,Argentina,A05,f,15,3,a
father,413850,414590,740,Argentina,A05,m,15,4,a
mother,430330,431820,1490,Argentina,A05,f,16,1,i
child,432390,433630,1240,Argentina,A05,b,17,1,q
mother,434080,435480,1400,Argentina,A05,c,17,2,a
mother,437850,440080,2230,Argentina,A05,c,17,3,a
father,454070,455270,1200,Argentina,A05,m,18,1,q
mother,455690,456290,600,Argentina,A05,f,18,2,q
father,456630,457220,590,Argentina,A05,m,18,3,q
mother,458440,459190,750,Argentina,A05,f,18,4,a
father,462360,465980,3620,Argentina,A05,m,18,5,a
father,466620,469550,2930,Argentina,A05,q,18,6,a
mother,470310,471010,700,Argentina,A05,f,18,7,a
mother,476570,478200,1630,Argentina,A05,c,19,1,i
mother,491610,492680,1070,Argentina,A05,o,20,1,a
child,500030,501280,1250,Argentina,A05,f,21,1,q
mother,501800,502390,590,Argentina,A05,c,21,2,q
child,503260,504710,1450,Argentina,A05,m,21,3,q
mother,504610,505320,710,Argentina,A05,c,21,4,q
father,504680,505560,880,Argentina,A05,c,21,5,q
father,511010,511520,510,Argentina,A05,b,21,6,a
mother,524230,526170,1940,Argentina,A05,f,22,1,a
mother,532060,532840,780,Argentina,A05,f,22,2,a
father,532620,535410,2790,Argentina,A05,c,23,1,a
father,558700,559880,1180,Argentina,A05,c,24,1,i
father,564470,567210,2740,Argentina,A05,c,25,1,q
child,567750,568790,1040,Argentina,A05,f,25,2,a
father,571820,573870,2050,Argentina,A05,m,25,3,a
father,314390,315070,680,Argentina,A05,m,30,1,q
silence,3290,3840,550,Argentina,A05,NA,NA,NA,NA
silence,4740,9390,4650,Argentina,A05,NA,NA,NA,NA
silence,10100,12600,2500,Argentina,A05,NA,NA,NA,NA
silence,15350,17980,2630,Argentina,A05,NA,NA,NA,NA
silence,18960,19420,460,Argentina,A05,NA,NA,NA,NA
child_gesture,19600,21140,1540,Argentina,A05,NA,NA,NA,NA
child_gesture,21510,23028,1518,Argentina,A05,NA,NA,NA,NA
silence,23290,25490,2200,Argentina,A05,NA,NA,NA,NA
silence,26290,31890,5600,Argentina,A05,NA,NA,NA,NA
silence,34110,34890,780,Argentina,A05,NA,NA,NA,NA
silence,40870,46490,5620,Argentina,A05,NA,NA,NA,NA
silence,47440,56270,8830,Argentina,A05,NA,NA,NA,NA
father_gesture,59111,60272,1161,Argentina,A05,NA,NA,NA,NA
silence,59740,60860,1120,Argentina,A05,NA,NA,NA,NA
silence,61600,61650,50,Argentina,A05,NA,NA,NA,NA
silence,62290,64290,2000,Argentina,A05,NA,NA,NA,NA
silence,67460,67590,130,Argentina,A05,NA,NA,NA,NA
silence,68560,79040,10480,Argentina,A05,NA,NA,NA,NA
silence,81020,85300,4280,Argentina,A05,NA,NA,NA,NA
silence,85880,104480,18600,Argentina,A05,NA,NA,NA,NA
silence,105980,106290,310,Argentina,A05,NA,NA,NA,NA
silence,106900,110080,3180,Argentina,A05,NA,NA,NA,NA
silence,110720,111290,570,Argentina,A05,NA,NA,NA,NA
silence,112290,122130,9840,Argentina,A05,NA,NA,NA,NA
silence,122900,126460,3560,Argentina,A05,NA,NA,NA,NA
silence,127510,129710,2200,Argentina,A05,NA,NA,NA,NA
silence,130220,138670,8450,Argentina,A05,NA,NA,NA,NA
silence,139220,145760,6540,Argentina,A05,NA,NA,NA,NA
father_gesture,146108,146630,522,Argentina,A05,NA,NA,NA,NA
father_gesture,146730,147410,680,Argentina,A05,NA,NA,NA,NA
silence,147400,167130,19730,Argentina,A05,NA,NA,NA,NA
child_gesture,167891,169037,1146,Argentina,A05,NA,NA,NA,NA
silence,168700,169570,870,Argentina,A05,NA,NA,NA,NA
silence,170900,172690,1790,Argentina,A05,NA,NA,NA,NA
silence,173420,173790,370,Argentina,A05,NA,NA,NA,NA
silence,174370,181000,6630,Argentina,A05,NA,NA,NA,NA
silence,182100,314390,132290,Argentina,A05,NA,NA,NA,NA
silence,315070,328730,13660,Argentina,A05,NA,NA,NA,NA
silence,329500,332370,2870,Argentina,A05,NA,NA,NA,NA
silence,333330,339490,6160,Argentina,A05,NA,NA,NA,NA
silence,341430,342170,740,Argentina,A05,NA,NA,NA,NA
silence,344560,348890,4330,Argentina,A05,NA,NA,NA,NA
silence,349500,350820,1320,Argentina,A05,NA,NA,NA,NA
silence,352500,354980,2480,Argentina,A05,NA,NA,NA,NA
silence,356210,357130,920,Argentina,A05,NA,NA,NA,NA
silence,358690,361370,2680,Argentina,A05,NA,NA,NA,NA
silence,363900,366800,2900,Argentina,A05,NA,NA,NA,NA
silence,367980,368060,80,Argentina,A05,NA,NA,NA,NA
silence,368970,370490,1520,Argentina,A05,NA,NA,NA,NA
silence,372320,374580,2260,Argentina,A05,NA,NA,NA,NA
silence,376140,377230,1090,Argentina,A05,NA,NA,NA,NA
silence,380500,386840,6340,Argentina,A05,NA,NA,NA,NA
silence,388450,388730,280,Argentina,A05,NA,NA,NA,NA
silence,389220,390150,930,Argentina,A05,NA,NA,NA,NA
silence,391540,392820,1280,Argentina,A05,NA,NA,NA,NA
silence,396670,397940,1270,Argentina,A05,NA,NA,NA,NA
silence,399100,399110,10,Argentina,A05,NA,NA,NA,NA
silence,399770,403450,3680,Argentina,A05,NA,NA,NA,NA
silence,405680,406410,730,Argentina,A05,NA,NA,NA,NA
silence,409370,412980,3610,Argentina,A05,NA,NA,NA,NA
silence,413570,413850,280,Argentina,A05,NA,NA,NA,NA
silence,414590,430330,15740,Argentina,A05,NA,NA,NA,NA
silence,431820,432390,570,Argentina,A05,NA,NA,NA,NA
silence,433630,434080,450,Argentina,A05,NA,NA,NA,NA
mother_gesture,433745,434853,1108,Argentina,A05,NA,NA,NA,NA
silence,435480,437850,2370,Argentina,A05,NA,NA,NA,NA
silence,440080,454070,13990,Argentina,A05,NA,NA,NA,NA
silence,455270,455690,420,Argentina,A05,NA,NA,NA,NA
silence,456290,456630,340,Argentina,A05,NA,NA,NA,NA
silence,457220,458440,1220,Argentina,A05,NA,NA,NA,NA
silence,459190,462360,3170,Argentina,A05,NA,NA,NA,NA
father_gesture,464790,466081,1291,Argentina,A05,NA,NA,NA,NA
silence,465980,466620,640,Argentina,A05,NA,NA,NA,NA
silence,469550,470310,760,Argentina,A05,NA,NA,NA,NA
silence,471010,476570,5560,Argentina,A05,NA,NA,NA,NA
silence,478200,491610,13410,Argentina,A05,NA,NA,NA,NA
silence,492680,500030,7350,Argentina,A05,NA,NA,NA,NA
silence,501280,501800,520,Argentina,A05,NA,NA,NA,NA
silence,502390,503260,870,Argentina,A05,NA,NA,NA,NA
silence,505560,511010,5450,Argentina,A05,NA,NA,NA,NA
silence,511520,524230,12710,Argentina,A05,NA,NA,NA,NA
silence,526170,532060,5890,Argentina,A05,NA,NA,NA,NA
father_gesture,532711,535412,2701,Argentina,A05,NA,NA,NA,NA
silence,535410,558700,23290,Argentina,A05,NA,NA,NA,NA
silence,559880,564470,4590,Argentina,A05,NA,NA,NA,NA
silence,567210,567750,540,Argentina,A05,NA,NA,NA,NA
child_gesture,568341,569625,1284,Argentina,A05,NA,NA,NA,NA
silence,568790,571820,3030,Argentina,A05,NA,NA,NA,NA
child,10,3430,3420,Argentina,A06,m,1,1,a
father,3340,5580,2240,Argentina,A06,c,1,2,i
child,3470,5950,2480,Argentina,A06,b,2,1,a
mother,6440,7230,790,Argentina,A06,c,2,2,q
child,7600,11140,3540,Argentina,A06,m,2,3,a
mother,11140,11840,700,Argentina,A06,c,2,4,a
child,11860,13450,1590,Argentina,A06,b,2,5,a
father,13410,14450,1040,Argentina,A06,c,2,6,a
mother,13620,14280,660,Argentina,A06,c,2,7,a
child,14530,19490,4960,Argentina,A06,m,2,8,a
mother,15620,16210,590,Argentina,A06,c,2,9,a
father,19780,20500,720,Argentina,A06,c,2,10,a
mother,20050,20550,500,Argentina,A06,c,2,11,a
child,20820,22860,2040,Argentina,A06,m,2,12,a
mother,24060,24720,660,Argentina,A06,c,2,13,a
child,24130,25670,1540,Argentina,A06,m,2,14,q
mother,25780,29700,3920,Argentina,A06,c,2,15,a
child,29860,30910,1050,Argentina,A06,m,2,16,a
mother,31120,31830,710,Argentina,A06,c,2,17,a
child,32440,33610,1170,Argentina,A06,m,2,18,a
mother,33720,34440,720,Argentina,A06,c,2,19,a
child,34680,36070,1390,Argentina,A06,m,2,20,a
mother,36210,36910,700,Argentina,A06,c,2,21,a
child,36940,38500,1560,Argentina,A06,m,2,22,a
mother,38650,40120,1470,Argentina,A06,c,2,23,a
child,40300,41230,930,Argentina,A06,m,2,24,q
mother,41420,42000,580,Argentina,A06,c,2,25,a
child,42610,45430,2820,Argentina,A06,m,2,26,a
mother,45600,49590,3990,Argentina,A06,c,2,27,a
child,49780,52300,2520,Argentina,A06,m,2,28,a
mother,52090,52690,600,Argentina,A06,c,2,29,a
father,52170,53120,950,Argentina,A06,c,2,30,a
child,53190,54660,1470,Argentina,A06,m,2,31,a
mother,54810,55490,680,Argentina,A06,c,2,32,a
child,56200,57790,1590,Argentina,A06,m,2,33,a
mother,57820,61670,3850,Argentina,A06,c,2,34,a
child,61010,63460,2450,Argentina,A06,m,2,35,q
mother,63910,65920,2010,Argentina,A06,c,2,36,a
child,66050,67950,1900,Argentina,A06,m,2,37,a
mother,67450,68360,910,Argentina,A06,c,2,38,a
child,68790,71460,2670,Argentina,A06,m,2,39,a
father,58780,59350,570,Argentina,A06,c,3,1,i
mother,69480,77830,8350,Argentina,A06,c,4,1,a
child,77530,81890,4360,Argentina,A06,m,4,2,a
mother,81760,83770,2010,Argentina,A06,c,4,3,a
father,83890,84450,560,Argentina,A06,c,4,4,a
child,83930,86770,2840,Argentina,A06,m,4,5,a
mother,86710,87340,630,Argentina,A06,c,4,6,a
father,87160,87870,710,Argentina,A06,c,4,7,a
mother,92770,93970,1200,Argentina,A06,c,4,8,a
father,95740,97110,1370,Argentina,A06,c,4,9,q
mother,97120,97670,550,Argentina,A06,f,4,10,a
father,100300,100770,470,Argentina,A06,c,4,11,a
mother,101190,105030,3840,Argentina,A06,c,4,12,q
father,106740,107680,940,Argentina,A06,c,4,13,a
mother,108480,109020,540,Argentina,A06,b,4,14,a
child,109150,110580,1430,Argentina,A06,f,4,15,a
mother,110590,117150,6560,Argentina,A06,c,4,16,q
father,110810,112220,1410,Argentina,A06,c,4,17,a
father,116700,119930,3230,Argentina,A06,c,4,18,a
child,117200,120120,2920,Argentina,A06,f,4,19,a
mother,118640,119890,1250,Argentina,A06,c,4,20,a
child,122400,123980,1580,Argentina,A06,f,4,21,a
father,124420,126060,1640,Argentina,A06,c,4,22,a
child,126950,128560,1610,Argentina,A06,f,4,23,q
mother,128860,129490,630,Argentina,A06,c,4,24,a
father,129250,130180,930,Argentina,A06,m,4,25,a
mother,130600,132640,2040,Argentina,A06,c,4,26,a
father,133330,134030,700,Argentina,A06,c,4,27,a
mother,135340,138590,3250,Argentina,A06,c,4,28,a
child,142410,143940,1530,Argentina,A06,f,4,29,a
father,144590,147790,3200,Argentina,A06,c,4,30,i
child,148500,151390,2890,Argentina,A06,f,4,31,a
mother,150390,155210,4820,Argentina,A06,c,4,32,a
father,152070,152610,540,Argentina,A06,c,4,33,a
child,152720,153390,670,Argentina,A06,b,4,34,a
father,153960,154590,630,Argentina,A06,c,4,35,i
child,155010,155920,910,Argentina,A06,m,4,36,a
mother,156040,156980,940,Argentina,A06,c,4,37,i
mother,159180,167890,8710,Argentina,A06,c,4,38,a
child,165880,172390,6510,Argentina,A06,m,4,39,a
mother,169810,171020,1210,Argentina,A06,c,4,40,a
mother,173100,173900,800,Argentina,A06,c,4,41,a
child,88190,92730,4540,Argentina,A06,m,5,1,q
child,174440,187970,13530,Argentina,A06,m,6,1,q
mother,177520,178210,690,Argentina,A06,c,6,2,a
mother,184730,185520,790,Argentina,A06,c,6,3,a
mother,189020,189840,820,Argentina,A06,c,6,4,q
child,190880,192140,1260,Argentina,A06,m,6,5,a
mother,192190,193360,1170,Argentina,A06,c,6,6,a
child,194340,195590,1250,Argentina,A06,m,6,7,a
mother,195920,196550,630,Argentina,A06,c,6,8,a
child,197020,201550,4530,Argentina,A06,m,6,9,a
mother,201700,204820,3120,Argentina,A06,c,6,10,a
child,205070,207000,1930,Argentina,A06,m,6,11,a
mother,207060,207610,550,Argentina,A06,c,6,12,a
child,207540,211540,4000,Argentina,A06,m,6,13,a
mother,210910,212860,1950,Argentina,A06,c,6,14,a
father,213310,216960,3650,Argentina,A06,c,7,1,q
mother,217330,221290,3960,Argentina,A06,c,7,2,q
child,218120,223200,5080,Argentina,A06,m,7,3,a
mother,223380,224340,960,Argentina,A06,c,7,4,q
child,223610,229580,5970,Argentina,A06,m,7,5,a
mother,229530,231190,1660,Argentina,A06,c,7,6,a
father,230710,231390,680,Argentina,A06,b,7,7,a
child,230880,231350,470,Argentina,A06,m,7,8,a
mother,232160,233070,910,Argentina,A06,c,7,9,q
father,232230,240350,8120,Argentina,A06,b,7,10,a
child,240860,245080,4220,Argentina,A06,f,7,11,a
mother,244990,245610,620,Argentina,A06,c,7,12,a
father,245410,246110,700,Argentina,A06,c,7,13,a
child,246060,246680,620,Argentina,A06,f,7,14,a
mother,246850,247410,560,Argentina,A06,c,7,15,a
father,247430,248750,1320,Argentina,A06,c,7,16,q
child,249630,250050,420,Argentina,A06,f,7,17,a
father,250120,251070,950,Argentina,A06,c,7,18,a
child,251110,254610,3500,Argentina,A06,f,7,19,a
father,253660,255790,2130,Argentina,A06,c,7,20,a
child,255940,256860,920,Argentina,A06,f,7,21,i
father,257030,257930,900,Argentina,A06,c,7,22,a
child,258190,260450,2260,Argentina,A06,f,7,23,a
father,260780,261400,620,Argentina,A06,c,7,24,a
child,261940,269290,7350,Argentina,A06,m,7,25,a
mother,263610,264200,590,Argentina,A06,c,7,26,a
mother,269090,270280,1190,Argentina,A06,c,7,27,a
child,270850,272850,2000,Argentina,A06,m,7,28,a
child,274980,275610,630,Argentina,A06,b,7,29,a
mother,274820,276750,1930,Argentina,A06,c,8,1,i
child,276860,280230,3370,Argentina,A06,m,9,1,a
mother,278930,279310,380,Argentina,A06,c,9,2,a
child,284030,285340,1310,Argentina,A06,m,9,3,a
mother,282030,286500,4470,Argentina,A06,c,10,1,q
mother,286630,288310,1680,Argentina,A06,c,10,2,a
child,288210,289440,1230,Argentina,A06,m,10,3,a
father,290620,291590,970,Argentina,A06,c,10,4,a
child,291830,292700,870,Argentina,A06,m,11,1,a
mother,292740,293320,580,Argentina,A06,c,11,2,q
child,293330,298840,5510,Argentina,A06,m,11,3,a
mother,298670,301800,3130,Argentina,A06,c,11,4,q
child,301060,304870,3810,Argentina,A06,m,11,5,i
mother,304720,306010,1290,Argentina,A06,c,11,6,q
child,306300,310220,3920,Argentina,A06,m,11,7,a
mother,310580,311320,740,Argentina,A06,c,11,8,q
child,311810,313650,1840,Argentina,A06,m,11,9,a
mother,313720,316330,2610,Argentina,A06,c,11,10,a
child,315450,316610,1160,Argentina,A06,m,11,11,a
mother,316610,320070,3460,Argentina,A06,c,11,12,i
father,319570,320620,1050,Argentina,A06,c,11,13,i
child,320680,321460,780,Argentina,A06,b,11,14,a
father,321530,322360,830,Argentina,A06,c,11,15,a
child,322450,324360,1910,Argentina,A06,b,11,16,q
mother,324210,327560,3350,Argentina,A06,c,11,17,a
child,328190,333030,4840,Argentina,A06,b,11,18,a
child,336560,338100,1540,Argentina,A06,b,12,1,a
mother,335440,339780,4340,Argentina,A06,f,13,1,a
father,338350,339910,1560,Argentina,A06,c,14,1,a
child,340920,341440,520,Argentina,A06,f,14,2,a
child,343490,344330,840,Argentina,A06,f,14,3,a
father,344350,345600,1250,Argentina,A06,c,14,4,a
child,345330,351370,6040,Argentina,A06,m,15,1,a
father,352770,355000,2230,Argentina,A06,c,15,2,a
child,356510,357160,650,Argentina,A06,f,15,3,q
father,357180,358190,1010,Argentina,A06,c,15,4,a
child,358970,360350,1380,Argentina,A06,f,15,5,a
father,360330,363980,3650,Argentina,A06,c,15,6,a
child,362720,365850,3130,Argentina,A06,f,16,1,a
mother,364900,366820,1920,Argentina,A06,c,16,2,a
father,365340,368340,3000,Argentina,A06,c,16,3,i
child,369430,370780,1350,Argentina,A06,f,16,4,a
father,371050,375270,4220,Argentina,A06,c,16,5,q
child,373300,376590,3290,Argentina,A06,f,16,6,a
mother,376000,377210,1210,Argentina,A06,b,16,7,a
father,376540,381520,4980,Argentina,A06,c,16,8,a
mother,379290,381390,2100,Argentina,A06,c,16,9,a
child,380690,381840,1150,Argentina,A06,f,16,10,a
father,381920,383260,1340,Argentina,A06,c,16,11,a
mother,383220,384230,1010,Argentina,A06,c,16,12,q
child,383420,384020,600,Argentina,A06,b,16,13,a
father,384810,387430,2620,Argentina,A06,m,16,14,a
mother,384850,386130,1280,Argentina,A06,c,16,15,q
child,384990,385480,490,Argentina,A06,m,16,16,a
child,387870,388470,600,Argentina,A06,m,16,17,a
father,388640,391460,2820,Argentina,A06,c,16,18,a
child,393430,394410,980,Argentina,A06,f,16,19,a
father,395010,396670,1660,Argentina,A06,c,16,20,a
child,397000,400710,3710,Argentina,A06,b,16,21,a
mother,399610,402260,2650,Argentina,A06,c,16,22,q
child,402360,405140,2780,Argentina,A06,b,16,23,a
father,403940,405130,1190,Argentina,A06,c,16,24,a
mother,386940,388730,1790,Argentina,A06,f,17,1,a
child,407760,412310,4550,Argentina,A06,b,18,1,a
mother,411610,413890,2280,Argentina,A06,c,18,2,a
father,411740,413090,1350,Argentina,A06,c,18,3,a
child,414200,416320,2120,Argentina,A06,f,18,4,a
mother,416270,416720,450,Argentina,A06,c,18,5,a
father,417000,417580,580,Argentina,A06,c,18,6,a
child,417670,424180,6510,Argentina,A06,f,19,1,q
father,420610,421400,790,Argentina,A06,c,19,2,a
mother,424410,425060,650,Argentina,A06,c,19,3,a
father,425590,428090,2500,Argentina,A06,c,19,4,a
child,426160,427220,1060,Argentina,A06,f,19,5,q
mother,428110,432310,4200,Argentina,A06,c,19,6,a
child,432860,434290,1430,Argentina,A06,m,19,7,a
mother,434460,435210,750,Argentina,A06,c,19,8,a
child,436160,440860,4700,Argentina,A06,b,19,9,a
mother,440970,443440,2470,Argentina,A06,c,19,10,a
father,441250,443170,1920,Argentina,A06,c,19,11,a
child,445310,446410,1100,Argentina,A06,m,20,1,a
mother,447930,449280,1350,Argentina,A06,c,20,2,a
child,449440,451300,1860,Argentina,A06,m,20,3,a
father,451270,453230,1960,Argentina,A06,c,20,4,a
mother,451450,454450,3000,Argentina,A06,c,20,5,a
child,454520,455450,930,Argentina,A06,m,20,6,a
mother,455740,457610,1870,Argentina,A06,c,20,7,a
child,456530,459963,3433,Argentina,A06,m,20,8,a
mother,460030,461870,1840,Argentina,A06,c,20,9,q
child,461950,462640,690,Argentina,A06,m,20,10,a
father,463520,464370,850,Argentina,A06,b,20,11,a
child,464520,465420,900,Argentina,A06,b,20,12,a
child,467080,468250,1170,Argentina,A06,b,21,1,a
mother,468770,469300,530,Argentina,A06,c,21,2,a
father,469180,470840,1660,Argentina,A06,c,21,3,a
mother,470050,472610,2560,Argentina,A06,c,21,4,q
child,472030,475000,2970,Argentina,A06,m,21,5,a
mother,475090,475800,710,Argentina,A06,c,21,6,q
child,475900,480150,4250,Argentina,A06,m,21,7,a
mother,477710,478610,900,Argentina,A06,c,21,8,a
father,478350,478970,620,Argentina,A06,c,21,9,a
mother,480050,483860,3810,Argentina,A06,c,21,10,a
child,484680,485380,700,Argentina,A06,m,21,11,a
mother,485360,485990,630,Argentina,A06,c,21,12,q
father,485650,486620,970,Argentina,A06,c,21,13,a
child,488270,490230,1960,Argentina,A06,m,21,14,a
mother,490260,492360,2100,Argentina,A06,c,21,15,q
father,490780,491550,770,Argentina,A06,c,21,16,a
child,492930,494850,1920,Argentina,A06,m,21,17,a
mother,494950,495670,720,Argentina,A06,c,21,18,q
child,496070,497740,1670,Argentina,A06,m,21,19,a
mother,498060,499450,1390,Argentina,A06,c,21,20,q
child,499890,501750,1860,Argentina,A06,b,21,21,a
father,500410,500900,490,Argentina,A06,c,21,22,a
mother,502220,506220,4000,Argentina,A06,c,21,23,a
father,504670,506050,1380,Argentina,A06,b,21,24,a
child,506710,508050,1340,Argentina,A06,m,21,25,a
mother,508440,510190,1750,Argentina,A06,c,21,26,a
child,509700,511480,1780,Argentina,A06,m,21,27,a
father,510880,516180,5300,Argentina,A06,c,21,28,a
child,515610,517110,1500,Argentina,A06,f,21,29,a
mother,517250,517920,670,Argentina,A06,c,21,30,a
father,517310,519650,2340,Argentina,A06,c,21,31,a
mother,519630,520230,600,Argentina,A06,b,21,32,a
child,520660,522340,1680,Argentina,A06,m,21,33,a
mother,522370,523470,1100,Argentina,A06,c,21,34,a
child,524110,526180,2070,Argentina,A06,m,21,35,a
mother,526390,527210,820,Argentina,A06,c,21,36,a
father,526290,528610,2320,Argentina,A06,c,22,1,q
child,528700,530720,2020,Argentina,A06,f,22,2,a
father,531170,535700,4530,Argentina,A06,c,22,3,a
child,533140,534330,1190,Argentina,A06,f,22,4,a
mother,535310,539600,4290,Argentina,A06,c,22,5,a
father,537680,540280,2600,Argentina,A06,c,22,6,a
child,540470,541850,1380,Argentina,A06,f,22,7,a
mother,542520,543050,530,Argentina,A06,c,22,8,a
father,542970,546280,3310,Argentina,A06,c,22,9,a
child,543120,547230,4110,Argentina,A06,f,22,10,a
father,547750,548410,660,Argentina,A06,c,22,11,a
child,548120,549070,950,Argentina,A06,f,22,12,a
father,549330,549830,500,Argentina,A06,c,22,13,a
child,550510,552570,2060,Argentina,A06,m,22,14,a
mother,552500,553130,630,Argentina,A06,c,22,15,q
child,553010,553860,850,Argentina,A06,m,22,16,a
mother,554400,555090,690,Argentina,A06,c,22,17,a
child,554830,556480,1650,Argentina,A06,m,22,18,a
mother,556870,558350,1480,Argentina,A06,c,22,19,a
child,559400,561160,1760,Argentina,A06,m,22,20,a
mother,561410,566980,5570,Argentina,A06,c,22,21,a
child,567330,569610,2280,Argentina,A06,m,22,22,a
mother,568800,572230,3430,Argentina,A06,c,22,23,a
child,571420,576250,4830,Argentina,A06,m,22,24,a
mother,573030,577270,4240,Argentina,A06,c,22,25,a
child,577900,579310,1410,Argentina,A06,m,22,26,a
father,579470,584470,5000,Argentina,A06,c,22,27,a
child,584820,585850,1030,Argentina,A06,b,22,28,a
mother,586090,586690,600,Argentina,A06,c,22,29,a
father,586540,588070,1530,Argentina,A06,c,22,30,a
child,586860,590760,3900,Argentina,A06,b,22,31,a
father,590780,592950,2170,Argentina,A06,c,22,32,a
child,592440,598880,6440,Argentina,A06,m,22,33,a
mother,550430,550930,500,Argentina,A06,o,23,1,a
child_gesture,3690,6207,2517,Argentina,A06,NA,NA,NA,NA
silence,5950,6440,490,Argentina,A06,NA,NA,NA,NA
silence,7230,7600,370,Argentina,A06,NA,NA,NA,NA
child_gesture,10691,11729,1038,Argentina,A06,NA,NA,NA,NA
silence,11840,11860,20,Argentina,A06,NA,NA,NA,NA
child_gesture,12227,13082,855,Argentina,A06,NA,NA,NA,NA
silence,14450,14530,80,Argentina,A06,NA,NA,NA,NA
silence,19490,19780,290,Argentina,A06,NA,NA,NA,NA
silence,20550,20820,270,Argentina,A06,NA,NA,NA,NA
child_gesture,21600,23413,1813,Argentina,A06,NA,NA,NA,NA
silence,22860,24060,1200,Argentina,A06,NA,NA,NA,NA
child_gesture,24669,25573,904,Argentina,A06,NA,NA,NA,NA
silence,25670,25780,110,Argentina,A06,NA,NA,NA,NA
mother_gesture,26473,30638,4165,Argentina,A06,NA,NA,NA,NA
silence,29700,29860,160,Argentina,A06,NA,NA,NA,NA
silence,30910,31120,210,Argentina,A06,NA,NA,NA,NA
mother_gesture,31711,32394,683,Argentina,A06,NA,NA,NA,NA
silence,31830,32440,610,Argentina,A06,NA,NA,NA,NA
silence,33610,33720,110,Argentina,A06,NA,NA,NA,NA
mother_gesture,34127,34823,696,Argentina,A06,NA,NA,NA,NA
silence,34440,34680,240,Argentina,A06,NA,NA,NA,NA
silence,36070,36210,140,Argentina,A06,NA,NA,NA,NA
mother_gesture,36635,37399,764,Argentina,A06,NA,NA,NA,NA
silence,36910,36940,30,Argentina,A06,NA,NA,NA,NA
silence,38500,38650,150,Argentina,A06,NA,NA,NA,NA
mother_gesture,39552,40297,745,Argentina,A06,NA,NA,NA,NA
silence,40120,40300,180,Argentina,A06,NA,NA,NA,NA
silence,41230,41420,190,Argentina,A06,NA,NA,NA,NA
silence,42000,42610,610,Argentina,A06,NA,NA,NA,NA
child_gesture,44680,45746,1066,Argentina,A06,NA,NA,NA,NA
silence,45430,45600,170,Argentina,A06,NA,NA,NA,NA
silence,49590,49780,190,Argentina,A06,NA,NA,NA,NA
silence,53120,53190,70,Argentina,A06,NA,NA,NA,NA
silence,54660,54810,150,Argentina,A06,NA,NA,NA,NA
silence,55490,56200,710,Argentina,A06,NA,NA,NA,NA
silence,57790,57820,30,Argentina,A06,NA,NA,NA,NA
silence,63460,63910,450,Argentina,A06,NA,NA,NA,NA
silence,65920,66050,130,Argentina,A06,NA,NA,NA,NA
silence,68360,68790,430,Argentina,A06,NA,NA,NA,NA
mother_gesture,70930,72400,1470,Argentina,A06,NA,NA,NA,NA
silence,83770,83890,120,Argentina,A06,NA,NA,NA,NA
silence,87870,88190,320,Argentina,A06,NA,NA,NA,NA
child_gesture,89576,91250,1674,Argentina,A06,NA,NA,NA,NA
child_gesture,91810,92660,850,Argentina,A06,NA,NA,NA,NA
silence,92730,92770,40,Argentina,A06,NA,NA,NA,NA
silence,93970,95740,1770,Argentina,A06,NA,NA,NA,NA
silence,97110,97120,10,Argentina,A06,NA,NA,NA,NA
silence,97670,100300,2630,Argentina,A06,NA,NA,NA,NA
silence,100770,101190,420,Argentina,A06,NA,NA,NA,NA
silence,105030,106740,1710,Argentina,A06,NA,NA,NA,NA
silence,107680,108480,800,Argentina,A06,NA,NA,NA,NA
silence,109020,109150,130,Argentina,A06,NA,NA,NA,NA
silence,110580,110590,10,Argentina,A06,NA,NA,NA,NA
mother_gesture,114456,115642,1186,Argentina,A06,NA,NA,NA,NA
silence,120120,122400,2280,Argentina,A06,NA,NA,NA,NA
silence,123980,124420,440,Argentina,A06,NA,NA,NA,NA
silence,126060,126950,890,Argentina,A06,NA,NA,NA,NA
silence,128560,128860,300,Argentina,A06,NA,NA,NA,NA
silence,130180,130600,420,Argentina,A06,NA,NA,NA,NA
mother_gesture,132066,132897,831,Argentina,A06,NA,NA,NA,NA
silence,132640,133330,690,Argentina,A06,NA,NA,NA,NA
father_gesture,132772,134113,1341,Argentina,A06,NA,NA,NA,NA
silence,134030,135340,1310,Argentina,A06,NA,NA,NA,NA
silence,138590,142410,3820,Argentina,A06,NA,NA,NA,NA
child_gesture,142898,144470,1572,Argentina,A06,NA,NA,NA,NA
silence,143940,144590,650,Argentina,A06,NA,NA,NA,NA
father_gesture,146150,147818,1668,Argentina,A06,NA,NA,NA,NA
silence,147790,148500,710,Argentina,A06,NA,NA,NA,NA
silence,155920,156040,120,Argentina,A06,NA,NA,NA,NA
silence,156980,159180,2200,Argentina,A06,NA,NA,NA,NA
mother_gesture,159484,163945,4461,Argentina,A06,NA,NA,NA,NA
silence,172390,173100,710,Argentina,A06,NA,NA,NA,NA
silence,173900,174440,540,Argentina,A06,NA,NA,NA,NA
child_gesture,174782,176276,1494,Argentina,A06,NA,NA,NA,NA
child_gesture,179269,182935,3666,Argentina,A06,NA,NA,NA,NA
child_gesture,183340,184930,1590,Argentina,A06,NA,NA,NA,NA
child_gesture,187088,188135,1047,Argentina,A06,NA,NA,NA,NA
silence,187970,189020,1050,Argentina,A06,NA,NA,NA,NA
silence,189840,190880,1040,Argentina,A06,NA,NA,NA,NA
child_gesture,191700,192905,1205,Argentina,A06,NA,NA,NA,NA
silence,192140,192190,50,Argentina,A06,NA,NA,NA,NA
silence,193360,194340,980,Argentina,A06,NA,NA,NA,NA
child_gesture,194790,196197,1407,Argentina,A06,NA,NA,NA,NA
silence,195590,195920,330,Argentina,A06,NA,NA,NA,NA
silence,196550,197020,470,Argentina,A06,NA,NA,NA,NA
child_gesture,199700,200860,1160,Argentina,A06,NA,NA,NA,NA
child_gesture,201030,201840,810,Argentina,A06,NA,NA,NA,NA
silence,201550,201700,150,Argentina,A06,NA,NA,NA,NA
mother_gesture,202660,205474,2814,Argentina,A06,NA,NA,NA,NA
silence,204820,205070,250,Argentina,A06,NA,NA,NA,NA
silence,207000,207060,60,Argentina,A06,NA,NA,NA,NA
child_gesture,207624,210850,3226,Argentina,A06,NA,NA,NA,NA
silence,212860,213310,450,Argentina,A06,NA,NA,NA,NA
silence,216960,217330,370,Argentina,A06,NA,NA,NA,NA
silence,223200,223380,180,Argentina,A06,NA,NA,NA,NA
silence,231390,232160,770,Argentina,A06,NA,NA,NA,NA
father_gesture,232949,234503,1554,Argentina,A06,NA,NA,NA,NA
father_gesture,235637,237358,1721,Argentina,A06,NA,NA,NA,NA
father_gesture,238029,240991,2962,Argentina,A06,NA,NA,NA,NA
silence,240350,240860,510,Argentina,A06,NA,NA,NA,NA
child_gesture,241593,242449,856,Argentina,A06,NA,NA,NA,NA
child_gesture,242620,244055,1435,Argentina,A06,NA,NA,NA,NA
silence,246680,246850,170,Argentina,A06,NA,NA,NA,NA
silence,247410,247430,20,Argentina,A06,NA,NA,NA,NA
silence,248750,249630,880,Argentina,A06,NA,NA,NA,NA
silence,250050,250120,70,Argentina,A06,NA,NA,NA,NA
child_gesture,250830,252140,1310,Argentina,A06,NA,NA,NA,NA
silence,251070,251110,40,Argentina,A06,NA,NA,NA,NA
silence,255790,255940,150,Argentina,A06,NA,NA,NA,NA
silence,256860,257030,170,Argentina,A06,NA,NA,NA,NA
silence,257930,258190,260,Argentina,A06,NA,NA,NA,NA
child_gesture,259039,260573,1534,Argentina,A06,NA,NA,NA,NA
silence,260450,260780,330,Argentina,A06,NA,NA,NA,NA
silence,261400,261940,540,Argentina,A06,NA,NA,NA,NA
silence,270280,270850,570,Argentina,A06,NA,NA,NA,NA
silence,272850,274820,1970,Argentina,A06,NA,NA,NA,NA
silence,276750,276860,110,Argentina,A06,NA,NA,NA,NA
silence,280230,282030,1800,Argentina,A06,NA,NA,NA,NA
mother_gesture,281418,283821,2403,Argentina,A06,NA,NA,NA,NA
silence,286500,286630,130,Argentina,A06,NA,NA,NA,NA
silence,289440,290620,1180,Argentina,A06,NA,NA,NA,NA
silence,291590,291830,240,Argentina,A06,NA,NA,NA,NA
silence,292700,292740,40,Argentina,A06,NA,NA,NA,NA
silence,293320,293330,10,Argentina,A06,NA,NA,NA,NA
child_gesture,295030,296350,1320,Argentina,A06,NA,NA,NA,NA
child_gesture,297410,299290,1880,Argentina,A06,NA,NA,NA,NA
silence,306010,306300,290,Argentina,A06,NA,NA,NA,NA
silence,310220,310580,360,Argentina,A06,NA,NA,NA,NA
silence,311320,311810,490,Argentina,A06,NA,NA,NA,NA
silence,313650,313720,70,Argentina,A06,NA,NA,NA,NA
child_gesture,316100,317360,1260,Argentina,A06,NA,NA,NA,NA
mother_gesture,319610,320590,980,Argentina,A06,NA,NA,NA,NA
silence,320620,320680,60,Argentina,A06,NA,NA,NA,NA
silence,321460,321530,70,Argentina,A06,NA,NA,NA,NA
silence,322360,322450,90,Argentina,A06,NA,NA,NA,NA
silence,327560,328190,630,Argentina,A06,NA,NA,NA,NA
silence,333030,335440,2410,Argentina,A06,NA,NA,NA,NA
silence,339910,340920,1010,Argentina,A06,NA,NA,NA,NA
silence,341440,343490,2050,Argentina,A06,NA,NA,NA,NA
child_gesture,343240,344660,1420,Argentina,A06,NA,NA,NA,NA
silence,344330,344350,20,Argentina,A06,NA,NA,NA,NA
silence,351370,352770,1400,Argentina,A06,NA,NA,NA,NA
silence,355000,356510,1510,Argentina,A06,NA,NA,NA,NA
silence,357160,357180,20,Argentina,A06,NA,NA,NA,NA
silence,358190,358970,780,Argentina,A06,NA,NA,NA,NA
father_gesture,365836,366997,1161,Argentina,A06,NA,NA,NA,NA
father_gesture,367607,369009,1402,Argentina,A06,NA,NA,NA,NA
silence,368340,369430,1090,Argentina,A06,NA,NA,NA,NA
silence,370780,371050,270,Argentina,A06,NA,NA,NA,NA
father_gesture,376774,377740,966,Argentina,A06,NA,NA,NA,NA
father_gesture,381580,382950,1370,Argentina,A06,NA,NA,NA,NA
silence,381840,381920,80,Argentina,A06,NA,NA,NA,NA
silence,384230,384810,580,Argentina,A06,NA,NA,NA,NA
silence,391460,393430,1970,Argentina,A06,NA,NA,NA,NA
silence,394410,395010,600,Argentina,A06,NA,NA,NA,NA
father_gesture,395720,396610,890,Argentina,A06,NA,NA,NA,NA
silence,396670,397000,330,Argentina,A06,NA,NA,NA,NA
silence,402260,402360,100,Argentina,A06,NA,NA,NA,NA
silence,405140,407760,2620,Argentina,A06,NA,NA,NA,NA
silence,413890,414200,310,Argentina,A06,NA,NA,NA,NA
silence,416720,417000,280,Argentina,A06,NA,NA,NA,NA
silence,417580,417670,90,Argentina,A06,NA,NA,NA,NA
silence,424180,424410,230,Argentina,A06,NA,NA,NA,NA
silence,425060,425590,530,Argentina,A06,NA,NA,NA,NA
silence,428090,428110,20,Argentina,A06,NA,NA,NA,NA
mother_gesture,430514,432124,1610,Argentina,A06,NA,NA,NA,NA
silence,432310,432860,550,Argentina,A06,NA,NA,NA,NA
silence,434290,434460,170,Argentina,A06,NA,NA,NA,NA
silence,435210,436160,950,Argentina,A06,NA,NA,NA,NA
silence,440860,440970,110,Argentina,A06,NA,NA,NA,NA
silence,443440,445310,1870,Argentina,A06,NA,NA,NA,NA
silence,446410,447930,1520,Argentina,A06,NA,NA,NA,NA
silence,449280,449440,160,Argentina,A06,NA,NA,NA,NA
silence,454450,454520,70,Argentina,A06,NA,NA,NA,NA
silence,455450,455740,290,Argentina,A06,NA,NA,NA,NA
silence,459963,460030,67,Argentina,A06,NA,NA,NA,NA
silence,461870,461950,80,Argentina,A06,NA,NA,NA,NA
silence,462640,463520,880,Argentina,A06,NA,NA,NA,NA
silence,464370,464520,150,Argentina,A06,NA,NA,NA,NA
silence,465420,467080,1660,Argentina,A06,NA,NA,NA,NA
child_gesture,467393,468430,1037,Argentina,A06,NA,NA,NA,NA
silence,468250,468770,520,Argentina,A06,NA,NA,NA,NA
mother_gesture,470538,471524,986,Argentina,A06,NA,NA,NA,NA
child_gesture,473223,476396,3173,Argentina,A06,NA,NA,NA,NA
silence,475000,475090,90,Argentina,A06,NA,NA,NA,NA
silence,475800,475900,100,Argentina,A06,NA,NA,NA,NA
child_gesture,479048,480336,1288,Argentina,A06,NA,NA,NA,NA
silence,483860,484680,820,Argentina,A06,NA,NA,NA,NA
silence,486620,488270,1650,Argentina,A06,NA,NA,NA,NA
child_gesture,489065,490328,1263,Argentina,A06,NA,NA,NA,NA
silence,490230,490260,30,Argentina,A06,NA,NA,NA,NA
silence,492360,492930,570,Argentina,A06,NA,NA,NA,NA
child_gesture,493290,494980,1690,Argentina,A06,NA,NA,NA,NA
silence,494850,494950,100,Argentina,A06,NA,NA,NA,NA
silence,495670,496070,400,Argentina,A06,NA,NA,NA,NA
child_gesture,496839,497855,1016,Argentina,A06,NA,NA,NA,NA
silence,497740,498060,320,Argentina,A06,NA,NA,NA,NA
silence,499450,499890,440,Argentina,A06,NA,NA,NA,NA
silence,501750,502220,470,Argentina,A06,NA,NA,NA,NA
mother_gesture,504004,504738,734,Argentina,A06,NA,NA,NA,NA
mother_gesture,506119,506910,791,Argentina,A06,NA,NA,NA,NA
silence,506220,506710,490,Argentina,A06,NA,NA,NA,NA
silence,508050,508440,390,Argentina,A06,NA,NA,NA,NA
child_gesture,509967,510944,977,Argentina,A06,NA,NA,NA,NA
father_gesture,513253,513984,731,Argentina,A06,NA,NA,NA,NA
father_gesture,514367,515149,782,Argentina,A06,NA,NA,NA,NA
silence,517110,517250,140,Argentina,A06,NA,NA,NA,NA
father_gesture,518023,519022,999,Argentina,A06,NA,NA,NA,NA
silence,520230,520660,430,Argentina,A06,NA,NA,NA,NA
child_gesture,520915,522476,1561,Argentina,A06,NA,NA,NA,NA
silence,522340,522370,30,Argentina,A06,NA,NA,NA,NA
silence,523470,524110,640,Argentina,A06,NA,NA,NA,NA
silence,526180,526290,110,Argentina,A06,NA,NA,NA,NA
silence,528610,528700,90,Argentina,A06,NA,NA,NA,NA
child_gesture,528874,532233,3359,Argentina,A06,NA,NA,NA,NA
silence,530720,531170,450,Argentina,A06,NA,NA,NA,NA
child_gesture,533040,534490,1450,Argentina,A06,NA,NA,NA,NA
mother_gesture,538506,539644,1138,Argentina,A06,NA,NA,NA,NA
silence,540280,540470,190,Argentina,A06,NA,NA,NA,NA
silence,541850,542520,670,Argentina,A06,NA,NA,NA,NA
child_gesture,542545,543913,1368,Argentina,A06,NA,NA,NA,NA
silence,547230,547750,520,Argentina,A06,NA,NA,NA,NA
silence,549070,549330,260,Argentina,A06,NA,NA,NA,NA
silence,549830,550430,600,Argentina,A06,NA,NA,NA,NA
silence,553860,554400,540,Argentina,A06,NA,NA,NA,NA
silence,556480,556870,390,Argentina,A06,NA,NA,NA,NA
silence,558350,559400,1050,Argentina,A06,NA,NA,NA,NA
silence,561160,561410,250,Argentina,A06,NA,NA,NA,NA
mother_gesture,561728,567492,5764,Argentina,A06,NA,NA,NA,NA
silence,566980,567330,350,Argentina,A06,NA,NA,NA,NA
mother_gesture,569428,572056,2628,Argentina,A06,NA,NA,NA,NA
child_gesture,574666,576554,1888,Argentina,A06,NA,NA,NA,NA
silence,577270,577900,630,Argentina,A06,NA,NA,NA,NA
silence,579310,579470,160,Argentina,A06,NA,NA,NA,NA
father_gesture,581414,583461,2047,Argentina,A06,NA,NA,NA,NA
silence,584470,584820,350,Argentina,A06,NA,NA,NA,NA
silence,585850,586090,240,Argentina,A06,NA,NA,NA,NA
silence,590760,590780,20,Argentina,A06,NA,NA,NA,NA
silence,598880,599460,580,Argentina,A06,NA,NA,NA,NA
mother,7115,9155,2040,Argentina,A07,f,1,1,q
mother,11675,14455,2780,Argentina,A07,b,2,1,a
father,14405,15045,640,Argentina,A07,m,2,2,a
mother,17645,19525,1880,Argentina,A07,f,2,3,a
child,17485,18935,1450,Argentina,A07,o,3,1,a
child,20645,21155,510,Argentina,A07,m,4,1,a
mother,21385,26355,4970,Argentina,A07,c,4,2,q
child,26385,26833,448,Argentina,A07,m,4,3,q
mother,26925,28335,1410,Argentina,A07,c,4,4,q
child,28505,29015,510,Argentina,A07,m,4,5,a
mother,29675,30515,840,Argentina,A07,c,4,6,q
child,30775,31295,520,Argentina,A07,m,4,7,a
mother,32625,34295,1670,Argentina,A07,f,5,1,a
father,34215,34685,470,Argentina,A07,m,5,2,a
mother,40845,44245,3400,Argentina,A07,f,6,1,q
father,44905,45365,460,Argentina,A07,m,6,2,q
child,42135,43125,990,Argentina,A07,b,7,1,q
child,45715,46225,510,Argentina,A07,b,7,2,a
mother,81825,88035,6210,Argentina,A07,f,8,1,a
father,91005,96105,5100,Argentina,A07,m,8,2,a
mother,97155,99455,2300,Argentina,A07,f,8,3,a
mother,101795,104085,2290,Argentina,A07,c,8,4,q
child,104075,104545,470,Argentina,A07,m,8,5,a
mother,104555,105145,590,Argentina,A07,c,8,6,a
child,105785,107425,1640,Argentina,A07,m,9,1,a
mother,107885,109945,2060,Argentina,A07,c,9,2,a
child,109725,110755,1030,Argentina,A07,m,9,3,i
mother,110695,112345,1650,Argentina,A07,c,9,4,q
child,112465,112825,360,Argentina,A07,m,9,5,a
mother,113505,115025,1520,Argentina,A07,c,9,6,q
child,115365,118645,3280,Argentina,A07,m,9,7,a
mother,118475,121215,2740,Argentina,A07,c,9,8,i
mother,123535,126685,3150,Argentina,A07,c,10,1,q
child,126975,127475,500,Argentina,A07,m,10,2,a
mother,128425,131365,2940,Argentina,A07,c,10,3,q
child,131725,133595,1870,Argentina,A07,m,10,4,q
mother,134105,135745,1640,Argentina,A07,c,10,5,a
child,139395,141465,2070,Argentina,A07,m,10,6,a
mother,140965,146045,5080,Argentina,A07,c,10,7,a
child,144405,145515,1110,Argentina,A07,m,10,8,a
father,146875,147325,450,Argentina,A07,m,11,1,a
father,149855,152895,3040,Argentina,A07,m,11,2,a
mother,152685,153855,1170,Argentina,A07,f,11,3,q
father,154385,155815,1430,Argentina,A07,m,11,4,a
mother,156265,157465,1200,Argentina,A07,f,11,5,a
father,157035,160015,2980,Argentina,A07,m,11,6,a
father,165615,177555,11940,Argentina,A07,m,11,7,a
mother,173425,174045,620,Argentina,A07,f,11,8,a
father,179365,180615,1250,Argentina,A07,b,11,9,a
child,182495,183015,520,Argentina,A07,f,11,10,q
father,182985,183515,530,Argentina,A07,c,11,11,a
mother,185375,188365,2990,Argentina,A07,f,11,12,a
father,187105,189135,2030,Argentina,A07,m,11,13,a
father,192495,193895,1400,Argentina,A07,m,11,14,a
mother,196855,197665,810,Argentina,A07,m,11,15,a
mother,199795,201255,1460,Argentina,A07,m,11,16,a
father,199945,202085,2140,Argentina,A07,m,11,17,a
mother,204655,209385,4730,Argentina,A07,f,11,18,a
father,209935,210615,680,Argentina,A07,m,11,19,a
mother,210815,212605,1790,Argentina,A07,f,11,20,a
father,214155,214955,800,Argentina,A07,m,11,21,a
mother,214585,217915,3330,Argentina,A07,f,11,22,q
child,161335,167545,6210,Argentina,A07,o,12,1,a
mother,183755,184535,780,Argentina,A07,f,13,1,a
mother,227645,232725,5080,Argentina,A07,f,14,1,q
father,233715,235385,1670,Argentina,A07,m,14,2,a
mother,236425,244365,7940,Argentina,A07,f,14,3,a
father,244205,245465,1260,Argentina,A07,m,14,4,a
mother,247175,249375,2200,Argentina,A07,f,14,5,a
father,247925,248605,680,Argentina,A07,m,14,6,a
mother,250645,252235,1590,Argentina,A07,f,14,7,a
mother,256575,258975,2400,Argentina,A07,f,14,8,a
child,256435,259115,2680,Argentina,A07,m,15,1,q
mother,259335,262715,3380,Argentina,A07,c,15,2,a
child,263205,264275,1070,Argentina,A07,m,15,3,q
mother,264055,265405,1350,Argentina,A07,c,15,4,q
child,265605,267735,2130,Argentina,A07,m,15,5,a
mother,267725,269135,1410,Argentina,A07,c,15,6,q
child,269025,272645,3620,Argentina,A07,m,15,7,a
mother,270725,274065,3340,Argentina,A07,c,15,8,a
child,274315,276945,2630,Argentina,A07,m,15,9,a
mother,277475,285515,8040,Argentina,A07,f,16,1,a
father,285645,287085,1440,Argentina,A07,m,16,2,q
mother,286505,287505,1000,Argentina,A07,f,16,3,a
father,287965,289635,1670,Argentina,A07,m,16,4,q
father,293535,296155,2620,Argentina,A07,m,16,5,q
mother,295525,299525,4000,Argentina,A07,f,16,6,a
mother,301765,303395,1630,Argentina,A07,f,16,7,a
mother,306225,310035,3810,Argentina,A07,f,16,8,a
mother,312525,314555,2030,Argentina,A07,f,16,9,a
mother,317805,319605,1800,Argentina,A07,f,16,10,a
mother,325585,329715,4130,Argentina,A07,f,16,11,a
mother,330995,339455,8460,Argentina,A07,f,16,12,a
father,339955,340915,960,Argentina,A07,m,16,13,q
mother,342055,349445,7390,Argentina,A07,f,16,14,a
mother,353005,356145,3140,Argentina,A07,f,16,15,q
father,356195,356685,490,Argentina,A07,m,16,16,a
mother,357545,361585,4040,Argentina,A07,f,16,17,a
mother,369645,371935,2290,Argentina,A07,f,16,18,a
father,372885,373465,580,Argentina,A07,m,16,19,a
child,328855,333355,4500,Argentina,A07,m,17,1,q
child,348905,354215,5310,Argentina,A07,m,18,1,a
child,356635,359855,3220,Argentina,A07,b,18,2,a
mother,361715,365565,3850,Argentina,A07,c,18,3,i
child,371315,375435,4120,Argentina,A07,m,18,4,a
mother,377105,380565,3460,Argentina,A07,c,18,5,i
mother,382665,385955,3290,Argentina,A07,c,18,6,a
mother,391215,391935,720,Argentina,A07,c,18,7,a
mother,393825,395925,2100,Argentina,A07,f,19,1,a
mother,398035,398915,880,Argentina,A07,f,19,2,a
father,402755,403415,660,Argentina,A07,m,19,3,a
mother,405195,405695,500,Argentina,A07,f,19,4,a
mother,408195,409625,1430,Argentina,A07,f,19,5,a
mother,412635,422285,9650,Argentina,A07,f,19,6,a
father,420605,421245,640,Argentina,A07,m,19,7,a
mother,425795,428985,3190,Argentina,A07,f,19,8,a
mother,432175,433025,850,Argentina,A07,f,19,9,a
mother,438435,440945,2510,Argentina,A07,f,19,10,a
father,440085,443395,3310,Argentina,A07,m,19,11,q
mother,442095,445835,3740,Argentina,A07,f,19,12,a
mother,448805,449835,1030,Argentina,A07,f,19,13,a
child,439325,443975,4650,Argentina,A07,b,20,1,a
child,448035,449545,1510,Argentina,A07,b,20,2,a
child,451825,456985,5160,Argentina,A07,m,20,3,a
mother,458435,462565,4130,Argentina,A07,c,20,4,i
mother,468095,469715,1620,Argentina,A07,f,22,1,q
father,470235,470775,540,Argentina,A07,m,22,2,q
mother,471935,484235,12300,Argentina,A07,f,22,3,a
father,486475,488195,1720,Argentina,A07,m,22,4,q
mother,488505,490595,2090,Argentina,A07,f,22,5,a
child,484855,489235,4380,Argentina,A07,b,23,1,a
mother,504165,513682,9517,Argentina,A07,f,24,1,q
father,516025,516505,480,Argentina,A07,m,24,2,a
mother,516365,527865,11500,Argentina,A07,f,24,3,a
child,522765,526265,3500,Argentina,A07,m,24,4,q
mother,530035,531495,1460,Argentina,A07,f,24,5,a
mother,535515,544715,9200,Argentina,A07,f,24,6,a
mother,548795,551025,2230,Argentina,A07,f,24,7,a
mother,546735,548515,1780,Argentina,A07,f,25,1,q
child,550515,554175,3660,Argentina,A07,m,26,1,a
mother,553365,557145,3780,Argentina,A07,c,26,2,i
child,556765,558085,1320,Argentina,A07,m,26,3,a
mother,559595,563045,3450,Argentina,A07,c,26,4,a
child,565075,566695,1620,Argentina,A07,b,27,1,a
mother,569255,570985,1730,Argentina,A07,c,28,1,i
child,571895,573395,1500,Argentina,A07,m,28,2,a
mother,577685,582735,5050,Argentina,A07,c,29,1,a
child,581645,582765,1120,Argentina,A07,m,30,1,a
mother,583105,584095,990,Argentina,A07,c,30,2,a
child,585445,586315,870,Argentina,A07,m,30,3,a
mother,586225,587785,1560,Argentina,A07,f,31,1,q
father,587775,590715,2940,Argentina,A07,m,31,2,a
mother,591555,592385,830,Argentina,A07,f,31,3,a
father,594625,597395,2770,Argentina,A07,c,32,1,a
child,598035,599965,1930,Argentina,A07,b,32,2,a
mother,47415,50985,3570,Argentina,A07,f,40,1,a
father,50565,52565,2000,Argentina,A07,m,40,2,a
mother,52165,53685,1520,Argentina,A07,f,40,3,a
father,64605,67265,2660,Argentina,A07,m,41,1,a
mother,69205,76115,6910,Argentina,A07,f,41,2,a
father,75925,79435,3510,Argentina,A07,m,41,3,a
silence,9155,11675,2520,Argentina,A07,NA,NA,NA,NA
mother_gesture,12337,14405,2068,Argentina,A07,NA,NA,NA,NA
silence,15045,17485,2440,Argentina,A07,NA,NA,NA,NA
silence,19525,20645,1120,Argentina,A07,NA,NA,NA,NA
silence,21155,21385,230,Argentina,A07,NA,NA,NA,NA
silence,26355,26385,30,Argentina,A07,NA,NA,NA,NA
silence,26833,26925,92,Argentina,A07,NA,NA,NA,NA
silence,28335,28505,170,Argentina,A07,NA,NA,NA,NA
silence,29015,29675,660,Argentina,A07,NA,NA,NA,NA
silence,30515,30775,260,Argentina,A07,NA,NA,NA,NA
silence,31295,32625,1330,Argentina,A07,NA,NA,NA,NA
silence,34685,40845,6160,Argentina,A07,NA,NA,NA,NA
silence,44245,44905,660,Argentina,A07,NA,NA,NA,NA
silence,45365,45715,350,Argentina,A07,NA,NA,NA,NA
silence,46225,47415,1190,Argentina,A07,NA,NA,NA,NA
silence,53685,64605,10920,Argentina,A07,NA,NA,NA,NA
silence,67265,69205,1940,Argentina,A07,NA,NA,NA,NA
silence,79435,81825,2390,Argentina,A07,NA,NA,NA,NA
silence,88035,91005,2970,Argentina,A07,NA,NA,NA,NA
silence,96105,97155,1050,Argentina,A07,NA,NA,NA,NA
silence,99455,101795,2340,Argentina,A07,NA,NA,NA,NA
silence,104545,104555,10,Argentina,A07,NA,NA,NA,NA
silence,105145,105785,640,Argentina,A07,NA,NA,NA,NA
silence,107425,107885,460,Argentina,A07,NA,NA,NA,NA
silence,112345,112465,120,Argentina,A07,NA,NA,NA,NA
silence,112825,113505,680,Argentina,A07,NA,NA,NA,NA
silence,115025,115365,340,Argentina,A07,NA,NA,NA,NA
child_gesture,115615,116527,912,Argentina,A07,NA,NA,NA,NA
child_gesture,116685,117429,744,Argentina,A07,NA,NA,NA,NA
silence,121215,123535,2320,Argentina,A07,NA,NA,NA,NA
silence,126685,126975,290,Argentina,A07,NA,NA,NA,NA
silence,127475,128425,950,Argentina,A07,NA,NA,NA,NA
silence,131365,131725,360,Argentina,A07,NA,NA,NA,NA
silence,133595,134105,510,Argentina,A07,NA,NA,NA,NA
silence,135745,139395,3650,Argentina,A07,NA,NA,NA,NA
silence,146045,146875,830,Argentina,A07,NA,NA,NA,NA
silence,147325,149855,2530,Argentina,A07,NA,NA,NA,NA
father_gesture,150980,151894,914,Argentina,A07,NA,NA,NA,NA
silence,153855,154385,530,Argentina,A07,NA,NA,NA,NA
silence,155815,156265,450,Argentina,A07,NA,NA,NA,NA
silence,160015,161335,1320,Argentina,A07,NA,NA,NA,NA
father_gesture,168636,169416,780,Argentina,A07,NA,NA,NA,NA
father_gesture,170691,173071,2380,Argentina,A07,NA,NA,NA,NA
father_gesture,174673,176972,2299,Argentina,A07,NA,NA,NA,NA
silence,177555,179365,1810,Argentina,A07,NA,NA,NA,NA
silence,180615,182495,1880,Argentina,A07,NA,NA,NA,NA
silence,183515,183755,240,Argentina,A07,NA,NA,NA,NA
silence,184535,185375,840,Argentina,A07,NA,NA,NA,NA
silence,189135,192495,3360,Argentina,A07,NA,NA,NA,NA
silence,193895,196855,2960,Argentina,A07,NA,NA,NA,NA
silence,197665,199795,2130,Argentina,A07,NA,NA,NA,NA
silence,202085,204655,2570,Argentina,A07,NA,NA,NA,NA
silence,209385,209935,550,Argentina,A07,NA,NA,NA,NA
silence,210615,210815,200,Argentina,A07,NA,NA,NA,NA
silence,212605,214155,1550,Argentina,A07,NA,NA,NA,NA
silence,217915,227645,9730,Argentina,A07,NA,NA,NA,NA
silence,232725,233715,990,Argentina,A07,NA,NA,NA,NA
silence,235385,236425,1040,Argentina,A07,NA,NA,NA,NA
mother_gesture,238990,241435,2445,Argentina,A07,NA,NA,NA,NA
silence,245465,247175,1710,Argentina,A07,NA,NA,NA,NA
silence,249375,250645,1270,Argentina,A07,NA,NA,NA,NA
silence,252235,256435,4200,Argentina,A07,NA,NA,NA,NA
silence,259115,259335,220,Argentina,A07,NA,NA,NA,NA
silence,262715,263205,490,Argentina,A07,NA,NA,NA,NA
silence,265405,265605,200,Argentina,A07,NA,NA,NA,NA
mother_gesture,272665,273572,907,Argentina,A07,NA,NA,NA,NA
silence,274065,274315,250,Argentina,A07,NA,NA,NA,NA
silence,276945,277475,530,Argentina,A07,NA,NA,NA,NA
silence,285515,285645,130,Argentina,A07,NA,NA,NA,NA
silence,287505,287965,460,Argentina,A07,NA,NA,NA,NA
silence,289635,293535,3900,Argentina,A07,NA,NA,NA,NA
silence,299525,301765,2240,Argentina,A07,NA,NA,NA,NA
silence,303395,306225,2830,Argentina,A07,NA,NA,NA,NA
silence,310035,312525,2490,Argentina,A07,NA,NA,NA,NA
silence,314555,317805,3250,Argentina,A07,NA,NA,NA,NA
silence,319605,325585,5980,Argentina,A07,NA,NA,NA,NA
silence,339455,339955,500,Argentina,A07,NA,NA,NA,NA
silence,340915,342055,1140,Argentina,A07,NA,NA,NA,NA
silence,356145,356195,50,Argentina,A07,NA,NA,NA,NA
silence,361585,361715,130,Argentina,A07,NA,NA,NA,NA
silence,365565,369645,4080,Argentina,A07,NA,NA,NA,NA
silence,375435,377105,1670,Argentina,A07,NA,NA,NA,NA
mother_gesture,378272,379036,764,Argentina,A07,NA,NA,NA,NA
silence,380565,382665,2100,Argentina,A07,NA,NA,NA,NA
mother_gesture,384850,386063,1213,Argentina,A07,NA,NA,NA,NA
silence,385955,391215,5260,Argentina,A07,NA,NA,NA,NA
silence,391935,393825,1890,Argentina,A07,NA,NA,NA,NA
silence,395925,398035,2110,Argentina,A07,NA,NA,NA,NA
silence,398915,402755,3840,Argentina,A07,NA,NA,NA,NA
silence,403415,405195,1780,Argentina,A07,NA,NA,NA,NA
silence,405695,408195,2500,Argentina,A07,NA,NA,NA,NA
silence,409625,412635,3010,Argentina,A07,NA,NA,NA,NA
silence,422285,425795,3510,Argentina,A07,NA,NA,NA,NA
silence,428985,432175,3190,Argentina,A07,NA,NA,NA,NA
silence,433025,438435,5410,Argentina,A07,NA,NA,NA,NA
silence,445835,448035,2200,Argentina,A07,NA,NA,NA,NA
silence,449835,451825,1990,Argentina,A07,NA,NA,NA,NA
silence,456985,458435,1450,Argentina,A07,NA,NA,NA,NA
silence,462565,468095,5530,Argentina,A07,NA,NA,NA,NA
silence,469715,470235,520,Argentina,A07,NA,NA,NA,NA
silence,470775,471935,1160,Argentina,A07,NA,NA,NA,NA
silence,484235,484855,620,Argentina,A07,NA,NA,NA,NA
silence,490595,504165,13570,Argentina,A07,NA,NA,NA,NA
silence,513682,516025,2343,Argentina,A07,NA,NA,NA,NA
mother_gesture,517859,519577,1718,Argentina,A07,NA,NA,NA,NA
mother_gesture,521262,522286,1024,Argentina,A07,NA,NA,NA,NA
silence,527865,530035,2170,Argentina,A07,NA,NA,NA,NA
silence,531495,535515,4020,Argentina,A07,NA,NA,NA,NA
mother_gesture,542589,543364,775,Argentina,A07,NA,NA,NA,NA
mother_gesture,543980,544925,945,Argentina,A07,NA,NA,NA,NA
silence,544715,546735,2020,Argentina,A07,NA,NA,NA,NA
silence,548515,548795,280,Argentina,A07,NA,NA,NA,NA
mother_gesture,554375,555251,876,Argentina,A07,NA,NA,NA,NA
silence,558085,559595,1510,Argentina,A07,NA,NA,NA,NA
silence,563045,565075,2030,Argentina,A07,NA,NA,NA,NA
silence,566695,569255,2560,Argentina,A07,NA,NA,NA,NA
silence,570985,571895,910,Argentina,A07,NA,NA,NA,NA
silence,573395,577685,4290,Argentina,A07,NA,NA,NA,NA
silence,582765,583105,340,Argentina,A07,NA,NA,NA,NA
silence,584095,585445,1350,Argentina,A07,NA,NA,NA,NA
silence,590715,591555,840,Argentina,A07,NA,NA,NA,NA
silence,592385,594625,2240,Argentina,A07,NA,NA,NA,NA
silence,597395,598035,640,Argentina,A07,NA,NA,NA,NA
mother,630,3890,3260,Argentina,A08,f,1,1,a
father,2400,3880,1480,Argentina,A08,c,2,1,q
father,4150,6660,2510,Argentina,A08,m,3,1,a
mother,6130,9600,3470,Argentina,A08,f,3,2,a
father,7150,10060,2910,Argentina,A08,m,3,3,a
mother,11480,12190,710,Argentina,A08,f,4,1,a
mother,15190,21650,6460,Argentina,A08,f,4,2,a
father,19840,22600,2760,Argentina,A08,m,4,3,q
mother,22960,25450,2490,Argentina,A08,f,4,4,a
father,25340,25950,610,Argentina,A08,m,4,5,q
mother,26190,27790,1600,Argentina,A08,f,4,6,a
father,27610,30950,3340,Argentina,A08,m,4,7,a
mother,28870,37700,8830,Argentina,A08,f,4,8,q
father,31820,37110,5290,Argentina,A08,m,4,9,a
father,41410,50300,8890,Argentina,A08,m,4,10,a
mother,41430,42690,1260,Argentina,A08,f,4,11,a
mother,50030,55800,5770,Argentina,A08,f,4,12,a
father,55200,56070,870,Argentina,A08,m,4,13,a
mother,56430,59610,3180,Argentina,A08,f,4,14,a
father,63400,64040,640,Argentina,A08,m,4,15,q
mother,64640,68650,4010,Argentina,A08,f,4,16,a
father,72900,74270,1370,Argentina,A08,m,4,17,q
mother,74390,75970,1580,Argentina,A08,f,4,18,a
mother,72050,73200,1150,Argentina,A08,c,6,1,i
mother,77990,78600,610,Argentina,A08,f,7,1,a
father,80230,80630,400,Argentina,A08,m,7,2,q
mother,80580,81150,570,Argentina,A08,f,7,3,i
father,82080,82630,550,Argentina,A08,m,7,4,a
mother,83140,84390,1250,Argentina,A08,f,7,5,a
father,86840,88220,1380,Argentina,A08,m,8,1,a
mother,92660,94100,1440,Argentina,A08,f,8,2,a
father,96010,100390,4380,Argentina,A08,c,9,1,q
mother,101910,102550,640,Argentina,A08,c,9,2,q
father,104090,104700,610,Argentina,A08,c,9,3,q
mother,106730,107890,1160,Argentina,A08,c,9,4,q
mother,110970,111780,810,Argentina,A08,f,9,5,a
father,111770,112360,590,Argentina,A08,m,9,6,a
father,120430,120960,530,Argentina,A08,b,9,7,a
child,122550,123180,630,Argentina,A08,o,10,1,a
mother,127020,128260,1240,Argentina,A08,c,10,2,a
mother,133360,136830,3470,Argentina,A08,c,11,1,a
mother,139160,140840,1680,Argentina,A08,f,11,2,a
mother,146690,149320,2630,Argentina,A08,c,11,3,a
father,149920,153250,3330,Argentina,A08,m,12,1,a
mother,155390,164580,9190,Argentina,A08,f,12,2,a
mother,167020,169830,2810,Argentina,A08,f,13,1,q
father,170290,171670,1380,Argentina,A08,m,13,2,a
mother,171700,172900,1200,Argentina,A08,f,13,3,a
mother,179320,180330,1010,Argentina,A08,o,14,1,a
father,183450,196710,13260,Argentina,A08,m,15,1,a
mother,192820,193430,610,Argentina,A08,f,15,2,a
mother,196740,198920,2180,Argentina,A08,f,15,3,a
father,198880,200150,1270,Argentina,A08,m,15,4,a
father,202930,204010,1080,Argentina,A08,m,15,5,a
mother,205610,206140,530,Argentina,A08,f,15,6,a
mother,209250,210270,1020,Argentina,A08,f,15,7,a
mother,214690,220050,5360,Argentina,A08,f,16,1,a
father,217530,218380,850,Argentina,A08,m,16,2,a
mother,229240,230340,1100,Argentina,A08,f,17,1,a
father,231670,235000,3330,Argentina,A08,m,17,2,a
mother,234990,235500,510,Argentina,A08,f,17,3,a
father,237080,239250,2170,Argentina,A08,c,18,1,i
child,239660,241530,1870,Argentina,A08,f,18,2,a
mother,239920,243630,3710,Argentina,A08,c,18,3,q
father,242220,243110,890,Argentina,A08,c,18,4,i
child,244230,245230,1000,Argentina,A08,m,18,5,a
mother,253130,254290,1160,Argentina,A08,f,19,1,a
mother,256830,257760,930,Argentina,A08,f,20,1,a
father,258110,258800,690,Argentina,A08,m,20,2,a
mother,260730,261610,880,Argentina,A08,f,20,3,a
mother,266000,268560,2560,Argentina,A08,f,20,4,a
mother,278110,282680,4570,Argentina,A08,f,21,1,a
father,294360,297950,3590,Argentina,A08,m,22,1,a
mother,297750,300080,2330,Argentina,A08,f,22,2,a
mother,302460,303780,1320,Argentina,A08,f,22,3,a
mother,325680,326690,1010,Argentina,A08,f,23,1,a
father,327100,328230,1130,Argentina,A08,m,23,2,q
mother,328670,339650,10980,Argentina,A08,f,23,3,a
mother,343270,348820,5550,Argentina,A08,c,24,1,q
child,348990,349470,480,Argentina,A08,m,24,2,a
mother,349460,350040,580,Argentina,A08,c,24,3,q
mother,359900,361070,1170,Argentina,A08,c,24,4,q
child,360760,361410,650,Argentina,A08,m,24,5,a
mother,361390,363520,2130,Argentina,A08,f,24,6,a
father,364130,364870,740,Argentina,A08,c,24,7,a
mother,364870,366630,1760,Argentina,A08,c,24,8,q
child,366160,366720,560,Argentina,A08,m,24,9,a
mother,366800,367390,590,Argentina,A08,f,24,10,a
mother,370830,373260,2430,Argentina,A08,f,24,11,a
child,373330,375070,1740,Argentina,A08,b,24,12,a
mother,374440,377520,3080,Argentina,A08,c,24,13,a
child,376580,378150,1570,Argentina,A08,b,24,14,a
father,378550,379270,720,Argentina,A08,c,24,15,a
child,381200,383020,1820,Argentina,A08,b,24,16,a
mother,381810,383300,1490,Argentina,A08,c,24,17,a
child,384180,385560,1380,Argentina,A08,b,24,18,a
mother,384210,386310,2100,Argentina,A08,c,24,19,i
child,393400,395040,1640,Argentina,A08,b,24,20,a
mother,394380,395180,800,Argentina,A08,c,24,21,q
child,397100,398220,1120,Argentina,A08,b,24,22,a
child,353330,353990,660,Argentina,A08,b,25,1,a
mother,354190,355840,1650,Argentina,A08,c,25,2,q
mother,387730,392610,4880,Argentina,A08,f,26,1,q
father,393460,393900,440,Argentina,A08,m,26,2,a
mother,396130,397390,1260,Argentina,A08,f,26,3,a
mother,408010,411630,3620,Argentina,A08,f,27,1,q
father,410980,420000,9020,Argentina,A08,m,27,2,q
father,422180,425390,3210,Argentina,A08,m,27,3,a
mother,425510,427350,1840,Argentina,A08,f,27,4,a
father,426970,427780,810,Argentina,A08,m,27,5,q
mother,427910,430100,2190,Argentina,A08,f,27,6,a
father,430170,431380,1210,Argentina,A08,m,27,7,a
mother,433500,436590,3090,Argentina,A08,f,27,8,i
mother,440960,442790,1830,Argentina,A08,f,27,9,a
father,443370,444130,760,Argentina,A08,m,27,10,q
mother,444360,468580,24220,Argentina,A08,f,27,11,a
father,465020,468790,3770,Argentina,A08,m,27,12,q
mother,468648,469095,447,Argentina,A08,f,27,13,a
father,469180,470160,980,Argentina,A08,m,27,14,a
father,473480,474460,980,Argentina,A08,m,27,15,q
mother,475460,476460,1000,Argentina,A08,f,27,16,a
father,476790,478240,1450,Argentina,A08,m,27,17,a
mother,477090,492510,15420,Argentina,A08,f,27,18,a
father,481690,482450,760,Argentina,A08,m,27,19,q
father,484590,485920,1330,Argentina,A08,m,27,20,q
father,492840,494520,1680,Argentina,A08,m,27,21,a
child,416760,418680,1920,Argentina,A08,b,28,1,a
child,431360,436830,5470,Argentina,A08,b,29,1,a
father,491360,492740,1380,Argentina,A08,m,30,1,q
mother,494510,495590,1080,Argentina,A08,f,31,1,a
mother,495610,501010,5400,Argentina,A08,c,32,1,a
mother,504020,509700,5680,Argentina,A08,c,32,2,q
child,516210,516900,690,Argentina,A08,b,32,3,a
mother,518200,530670,12470,Argentina,A08,c,32,4,a
child,522730,523300,570,Argentina,A08,m,32,5,a
mother,535740,551410,15670,Argentina,A08,c,32,6,i
child,549850,553100,3250,Argentina,A08,m,32,7,a
mother,556670,564950,8280,Argentina,A08,c,32,8,a
mother,569730,570680,950,Argentina,A08,c,32,9,i
mother,571650,573880,2230,Argentina,A08,f,32,10,a
mother,512140,513060,920,Argentina,A08,f,33,1,a
father,573810,575300,1490,Argentina,A08,m,34,1,a
father,579380,580050,670,Argentina,A08,m,34,2,a
mother,580230,580930,700,Argentina,A08,f,34,3,a
mother,583360,586130,2770,Argentina,A08,f,35,1,a
father,586140,588890,2750,Argentina,A08,m,35,2,a
mother,588540,589840,1300,Argentina,A08,f,35,3,a
father,591570,593460,1890,Argentina,A08,m,35,4,a
father,593509,596097,2588,Argentina,A08,m,36,1,i
mother,594770,598200,3430,Argentina,A08,f,36,2,a
silence,3890,4150,260,Argentina,A08,NA,NA,NA,NA
father_gesture,4670,5913,1243,Argentina,A08,NA,NA,NA,NA
silence,10060,11480,1420,Argentina,A08,NA,NA,NA,NA
silence,12190,15190,3000,Argentina,A08,NA,NA,NA,NA
mother_gesture,15860,17060,1200,Argentina,A08,NA,NA,NA,NA
mother_gesture,17199,18574,1375,Argentina,A08,NA,NA,NA,NA
silence,22600,22960,360,Argentina,A08,NA,NA,NA,NA
silence,25950,26190,240,Argentina,A08,NA,NA,NA,NA
silence,37700,41410,3710,Argentina,A08,NA,NA,NA,NA
silence,56070,56430,360,Argentina,A08,NA,NA,NA,NA
mother_gesture,57500,58640,1140,Argentina,A08,NA,NA,NA,NA
mother_gesture,58887,60544,1657,Argentina,A08,NA,NA,NA,NA
silence,59610,63400,3790,Argentina,A08,NA,NA,NA,NA
silence,64040,64640,600,Argentina,A08,NA,NA,NA,NA
mother_gesture,64150,65500,1350,Argentina,A08,NA,NA,NA,NA
mother_gesture,66417,67355,938,Argentina,A08,NA,NA,NA,NA
silence,68650,72050,3400,Argentina,A08,NA,NA,NA,NA
silence,74270,74390,120,Argentina,A08,NA,NA,NA,NA
silence,75970,77990,2020,Argentina,A08,NA,NA,NA,NA
silence,78600,80230,1630,Argentina,A08,NA,NA,NA,NA
silence,81150,82080,930,Argentina,A08,NA,NA,NA,NA
silence,82630,83140,510,Argentina,A08,NA,NA,NA,NA
silence,84390,86840,2450,Argentina,A08,NA,NA,NA,NA
silence,88220,92660,4440,Argentina,A08,NA,NA,NA,NA
silence,94100,96010,1910,Argentina,A08,NA,NA,NA,NA
silence,100390,101910,1520,Argentina,A08,NA,NA,NA,NA
silence,102550,104090,1540,Argentina,A08,NA,NA,NA,NA
silence,104700,106730,2030,Argentina,A08,NA,NA,NA,NA
silence,107890,110970,3080,Argentina,A08,NA,NA,NA,NA
silence,112360,120430,8070,Argentina,A08,NA,NA,NA,NA
silence,120960,122550,1590,Argentina,A08,NA,NA,NA,NA
silence,123180,127020,3840,Argentina,A08,NA,NA,NA,NA
silence,128260,133360,5100,Argentina,A08,NA,NA,NA,NA
silence,136830,139160,2330,Argentina,A08,NA,NA,NA,NA
silence,140840,146690,5850,Argentina,A08,NA,NA,NA,NA
silence,149320,149920,600,Argentina,A08,NA,NA,NA,NA
silence,153250,155390,2140,Argentina,A08,NA,NA,NA,NA
silence,164580,167020,2440,Argentina,A08,NA,NA,NA,NA
silence,169830,170290,460,Argentina,A08,NA,NA,NA,NA
silence,171670,171700,30,Argentina,A08,NA,NA,NA,NA
mother_gesture,171804,172673,869,Argentina,A08,NA,NA,NA,NA
silence,172900,179320,6420,Argentina,A08,NA,NA,NA,NA
silence,180330,183450,3120,Argentina,A08,NA,NA,NA,NA
silence,196710,196740,30,Argentina,A08,NA,NA,NA,NA
silence,200150,202930,2780,Argentina,A08,NA,NA,NA,NA
silence,204010,205610,1600,Argentina,A08,NA,NA,NA,NA
silence,206140,209250,3110,Argentina,A08,NA,NA,NA,NA
silence,210270,214690,4420,Argentina,A08,NA,NA,NA,NA
silence,220050,229240,9190,Argentina,A08,NA,NA,NA,NA
mother_gesture,228927,230123,1196,Argentina,A08,NA,NA,NA,NA
silence,230340,231670,1330,Argentina,A08,NA,NA,NA,NA
silence,235500,237080,1580,Argentina,A08,NA,NA,NA,NA
silence,239250,239660,410,Argentina,A08,NA,NA,NA,NA
silence,243630,244230,600,Argentina,A08,NA,NA,NA,NA
silence,245230,253130,7900,Argentina,A08,NA,NA,NA,NA
silence,254290,256830,2540,Argentina,A08,NA,NA,NA,NA
silence,257760,258110,350,Argentina,A08,NA,NA,NA,NA
silence,258800,260730,1930,Argentina,A08,NA,NA,NA,NA
silence,261610,266000,4390,Argentina,A08,NA,NA,NA,NA
silence,268560,278110,9550,Argentina,A08,NA,NA,NA,NA
mother_gesture,281005,282081,1076,Argentina,A08,NA,NA,NA,NA
silence,282680,294360,11680,Argentina,A08,NA,NA,NA,NA
silence,300080,302460,2380,Argentina,A08,NA,NA,NA,NA
silence,303780,325680,21900,Argentina,A08,NA,NA,NA,NA
mother_gesture,325878,327175,1297,Argentina,A08,NA,NA,NA,NA
silence,326690,327100,410,Argentina,A08,NA,NA,NA,NA
silence,328230,328670,440,Argentina,A08,NA,NA,NA,NA
mother_gesture,334162,336954,2792,Argentina,A08,NA,NA,NA,NA
silence,339650,343270,3620,Argentina,A08,NA,NA,NA,NA
silence,348820,348990,170,Argentina,A08,NA,NA,NA,NA
silence,350040,353330,3290,Argentina,A08,NA,NA,NA,NA
silence,353990,354190,200,Argentina,A08,NA,NA,NA,NA
silence,355840,359900,4060,Argentina,A08,NA,NA,NA,NA
silence,363520,364130,610,Argentina,A08,NA,NA,NA,NA
silence,366720,366800,80,Argentina,A08,NA,NA,NA,NA
silence,367390,370830,3440,Argentina,A08,NA,NA,NA,NA
silence,373260,373330,70,Argentina,A08,NA,NA,NA,NA
silence,378150,378550,400,Argentina,A08,NA,NA,NA,NA
silence,379270,381200,1930,Argentina,A08,NA,NA,NA,NA
silence,383300,384180,880,Argentina,A08,NA,NA,NA,NA
silence,386310,387730,1420,Argentina,A08,NA,NA,NA,NA
mother_gesture,387737,391841,4104,Argentina,A08,NA,NA,NA,NA
silence,392610,393400,790,Argentina,A08,NA,NA,NA,NA
silence,395180,396130,950,Argentina,A08,NA,NA,NA,NA
silence,398220,408010,9790,Argentina,A08,NA,NA,NA,NA
silence,420000,422180,2180,Argentina,A08,NA,NA,NA,NA
silence,425390,425510,120,Argentina,A08,NA,NA,NA,NA
silence,427780,427910,130,Argentina,A08,NA,NA,NA,NA
mother_gesture,428226,429490,1264,Argentina,A08,NA,NA,NA,NA
silence,430100,430170,70,Argentina,A08,NA,NA,NA,NA
mother_gesture,430420,431340,920,Argentina,A08,NA,NA,NA,NA
silence,436830,440960,4130,Argentina,A08,NA,NA,NA,NA
mother_gesture,440890,442330,1440,Argentina,A08,NA,NA,NA,NA
silence,442790,443370,580,Argentina,A08,NA,NA,NA,NA
silence,444130,444360,230,Argentina,A08,NA,NA,NA,NA
mother_gesture,465040,466360,1320,Argentina,A08,NA,NA,NA,NA
mother_gesture,466510,467060,550,Argentina,A08,NA,NA,NA,NA
mother_gesture,467620,468471,851,Argentina,A08,NA,NA,NA,NA
silence,469095,469180,85,Argentina,A08,NA,NA,NA,NA
silence,470160,473480,3320,Argentina,A08,NA,NA,NA,NA
silence,474460,475460,1000,Argentina,A08,NA,NA,NA,NA
silence,476460,476790,330,Argentina,A08,NA,NA,NA,NA
mother_gesture,477190,479341,2151,Argentina,A08,NA,NA,NA,NA
father_gesture,481550,483439,1889,Argentina,A08,NA,NA,NA,NA
mother_gesture,487070,488180,1110,Argentina,A08,NA,NA,NA,NA
silence,492740,492840,100,Argentina,A08,NA,NA,NA,NA
silence,495590,495610,20,Argentina,A08,NA,NA,NA,NA
mother_gesture,496781,500014,3233,Argentina,A08,NA,NA,NA,NA
silence,501010,504020,3010,Argentina,A08,NA,NA,NA,NA
silence,509700,512140,2440,Argentina,A08,NA,NA,NA,NA
silence,513060,516210,3150,Argentina,A08,NA,NA,NA,NA
silence,516900,518200,1300,Argentina,A08,NA,NA,NA,NA
silence,530670,535740,5070,Argentina,A08,NA,NA,NA,NA
silence,553100,556670,3570,Argentina,A08,NA,NA,NA,NA
mother_gesture,562740,563550,810,Argentina,A08,NA,NA,NA,NA
mother_gesture,563740,564630,890,Argentina,A08,NA,NA,NA,NA
silence,564950,569730,4780,Argentina,A08,NA,NA,NA,NA
silence,570680,571650,970,Argentina,A08,NA,NA,NA,NA
silence,575300,579380,4080,Argentina,A08,NA,NA,NA,NA
silence,580050,580230,180,Argentina,A08,NA,NA,NA,NA
silence,580930,583360,2430,Argentina,A08,NA,NA,NA,NA
silence,586130,586140,10,Argentina,A08,NA,NA,NA,NA
silence,589840,591570,1730,Argentina,A08,NA,NA,NA,NA
silence,593460,593509,49,Argentina,A08,NA,NA,NA,NA
silence,598200,599310,1110,Argentina,A08,NA,NA,NA,NA
child,850,6380,5530,Argentina,A09,b,2,1,a
father,4150,4670,520,Argentina,A09,c,2,2,q
mother,7320,8510,1190,Argentina,A09,c,2,3,i
father,8060,9370,1310,Argentina,A09,b,2,4,a
child,9200,9910,710,Argentina,A09,m,2,5,a
father,11820,13050,1230,Argentina,A09,m,2,6,a
child,15490,17900,2410,Argentina,A09,m,2,7,a
mother,15810,20970,5160,Argentina,A09,c,2,8,q
child,21040,23580,2540,Argentina,A09,m,2,9,a
mother,22760,23380,620,Argentina,A09,c,2,10,a
child,25150,28740,3590,Argentina,A09,m,2,11,a
mother,28910,33430,4520,Argentina,A09,c,2,12,a
father,28980,29640,660,Argentina,A09,c,2,13,a
mother,34230,35000,770,Argentina,A09,f,3,1,q
mother,38230,39730,1500,Argentina,A09,f,3,2,a
child,37410,39120,1710,Argentina,A09,b,4,1,a
mother,39890,43250,3360,Argentina,A09,c,4,2,q
child,44240,49210,4970,Argentina,A09,m,4,3,a
father,44720,45460,740,Argentina,A09,c,4,4,q
mother,49390,50060,670,Argentina,A09,c,4,5,a
child,53460,54160,700,Argentina,A09,b,4,6,a
mother,58720,65430,6710,Argentina,A09,f,5,1,a
father,66990,72110,5120,Argentina,A09,m,5,2,a
mother,71530,74680,3150,Argentina,A09,f,5,3,a
father,75420,78490,3070,Argentina,A09,m,5,4,a
mother,81990,83230,1240,Argentina,A09,f,5,5,a
child,64700,66420,1720,Argentina,A09,f,6,1,a
child,82220,83250,1030,Argentina,A09,f,7,1,a
child,83590,95744,12154,Argentina,A09,b,7,2,a
father,95020,96660,1640,Argentina,A09,c,7,3,q
mother,98410,99130,720,Argentina,A09,c,7,4,a
child,99230,100610,1380,Argentina,A09,b,7,5,a
mother,83290,84030,740,Argentina,A09,b,8,1,a
mother,100120,101140,1020,Argentina,A09,c,9,1,q
mother,104740,106840,2100,Argentina,A09,b,10,1,a
child,106210,108040,1830,Argentina,A09,f,11,1,q
father,108850,109410,560,Argentina,A09,c,11,2,a
mother,110200,112270,2070,Argentina,A09,c,11,3,a
child,111990,113790,1800,Argentina,A09,m,11,4,a
mother,116100,117370,1270,Argentina,A09,f,12,1,a
father,117840,118590,750,Argentina,A09,m,12,2,a
child,119250,121310,2060,Argentina,A09,f,13,1,a
father,121450,123630,2180,Argentina,A09,c,13,2,a
mother,123880,124380,500,Argentina,A09,f,13,3,q
father,125580,131290,5710,Argentina,A09,c,13,4,a
mother,127030,128770,1740,Argentina,A09,f,13,5,a
father,134020,135710,1690,Argentina,A09,c,13,6,q
child,135780,136920,1140,Argentina,A09,f,13,7,a
mother,136740,137580,840,Argentina,A09,c,13,8,a
father,136970,137590,620,Argentina,A09,c,13,9,a
mother,141660,142640,980,Argentina,A09,c,13,10,a
father,143140,146120,2980,Argentina,A09,c,13,11,i
mother,147180,149230,2050,Argentina,A09,c,14,1,q
child,148920,155090,6170,Argentina,A09,m,14,2,a
mother,154760,155800,1040,Argentina,A09,c,14,3,q
father,155370,158410,3040,Argentina,A09,c,14,4,a
child,159720,162000,2280,Argentina,A09,b,14,5,a
father,162050,166990,4940,Argentina,A09,c,14,6,a
mother,162150,162930,780,Argentina,A09,c,14,7,a
father,169220,170030,810,Argentina,A09,c,14,8,a
child,169440,172880,3440,Argentina,A09,b,14,9,a
father,172730,177280,4550,Argentina,A09,c,14,10,a
mother,174060,180500,6440,Argentina,A09,c,14,11,a
father,180340,182990,2650,Argentina,A09,b,14,12,a
child,185170,186990,1820,Argentina,A09,b,14,13,a
mother,187580,188150,570,Argentina,A09,c,14,14,a
mother,158400,159990,1590,Argentina,A09,c,15,1,i
mother,190650,192620,1970,Argentina,A09,c,16,1,q
child,192780,194110,1330,Argentina,A09,m,16,2,a
mother,194090,195670,1580,Argentina,A09,c,16,3,a
mother,198300,199580,1280,Argentina,A09,c,16,4,a
father,199340,200410,1070,Argentina,A09,m,17,1,q
mother,200440,202410,1970,Argentina,A09,f,17,2,a
father,203610,204130,520,Argentina,A09,m,17,3,q
mother,206130,207770,1640,Argentina,A09,f,17,4,a
mother,209220,214090,4870,Argentina,A09,f,18,1,a
child,214110,216000,1890,Argentina,A09,m,18,2,a
father,214860,215900,1040,Argentina,A09,m,18,3,a
mother,218270,221470,3200,Argentina,A09,c,18,4,a
child,225040,225650,610,Argentina,A09,b,18,5,a
father,228430,229220,790,Argentina,A09,c,18,6,a
child,232920,234080,1160,Argentina,A09,f,18,7,q
child,234220,237720,3500,Argentina,A09,f,18,8,a
father,237740,239150,1410,Argentina,A09,c,18,9,q
child,239410,241550,2140,Argentina,A09,f,18,10,a
father,242050,242650,600,Argentina,A09,c,18,11,a
child,242700,245750,3050,Argentina,A09,f,18,12,a
father,234100,235770,1670,Argentina,A09,c,19,1,a
mother,246890,250480,3590,Argentina,A09,c,20,1,q
father,252030,255050,3020,Argentina,A09,c,20,2,q
child,254320,254820,500,Argentina,A09,f,20,3,a
mother,255090,256640,1550,Argentina,A09,c,20,4,i
father,256500,260740,4240,Argentina,A09,c,20,5,q
mother,259480,262050,2570,Argentina,A09,c,20,6,q
child,261580,262610,1030,Argentina,A09,b,20,7,a
father,262330,266080,3750,Argentina,A09,c,20,8,i
mother,268230,268940,710,Argentina,A09,c,20,9,q
father,268850,276090,7240,Argentina,A09,c,20,10,a
child,276310,276900,590,Argentina,A09,b,20,11,a
father,277450,279530,2080,Argentina,A09,m,20,12,a
mother,278320,279140,820,Argentina,A09,c,20,13,a
child,279990,281990,2000,Argentina,A09,m,21,1,a
mother,282490,283090,600,Argentina,A09,c,21,2,a
father,282670,283400,730,Argentina,A09,c,21,3,q
child,283220,285020,1800,Argentina,A09,m,21,4,a
mother,284880,285800,920,Argentina,A09,c,21,5,q
father,286240,293410,7170,Argentina,A09,c,21,6,a
child,286260,286680,420,Argentina,A09,m,21,7,a
mother,288710,290900,2190,Argentina,A09,c,21,8,q
child,292070,296390,4320,Argentina,A09,b,21,9,a
mother,296510,299330,2820,Argentina,A09,c,21,10,i
father,297360,299840,2480,Argentina,A09,c,21,11,i
child,300090,302420,2330,Argentina,A09,m,21,12,a
mother,302920,303460,540,Argentina,A09,c,21,13,q
father,309680,310960,1280,Argentina,A09,c,21,14,a
mother,313200,315380,2180,Argentina,A09,c,21,15,a
father,313560,319520,5960,Argentina,A09,c,21,16,a
child,318910,325510,6600,Argentina,A09,m,21,17,a
mother,325050,326230,1180,Argentina,A09,c,21,18,a
mother,328610,329750,1140,Argentina,A09,c,21,19,q
child,329930,335750,5820,Argentina,A09,c,21,20,a
mother,334600,335760,1160,Argentina,A09,c,21,21,a
father,335320,337660,2340,Argentina,A09,c,21,22,a
child,337550,338730,1180,Argentina,A09,f,21,23,a
father,338600,340610,2010,Argentina,A09,c,21,24,a
mother,339990,341060,1070,Argentina,A09,c,21,25,a
child,345940,347840,1900,Argentina,A09,f,21,26,a
father,347660,351170,3510,Argentina,A09,c,21,27,a
child,352580,353160,580,Argentina,A09,f,21,28,a
mother,353180,355510,2330,Argentina,A09,c,21,29,q
father,355060,356160,1100,Argentina,A09,m,21,30,a
child,355610,359160,3550,Argentina,A09,b,22,1,a
mother,359020,361180,2160,Argentina,A09,c,22,2,a
mother,361820,363320,1500,Argentina,A09,c,22,3,q
child,364100,366830,2730,Argentina,A09,m,22,4,a
mother,364440,367960,3520,Argentina,A09,c,22,5,i
child,367410,369600,2190,Argentina,A09,m,22,6,a
mother,369650,374070,4420,Argentina,A09,c,22,7,a
child,371640,373010,1370,Argentina,A09,m,22,8,a
father,373620,377510,3890,Argentina,A09,c,22,9,a
child,374280,377470,3190,Argentina,A09,m,22,10,i
father,378280,379260,980,Argentina,A09,c,22,11,a
mother,380770,383240,2470,Argentina,A09,c,22,12,a
child,380830,382210,1380,Argentina,A09,b,22,13,a
father,383560,384640,1080,Argentina,A09,c,22,14,a
child,383990,386300,2310,Argentina,A09,m,22,15,a
mother,385600,389190,3590,Argentina,A09,f,22,16,a
mother,390250,393380,3130,Argentina,A09,c,22,17,a
father,360580,362440,1860,Argentina,A09,m,23,1,a
child,393950,397470,3520,Argentina,A09,m,23,2,a
mother,396100,397000,900,Argentina,A09,c,23,3,q
father,366240,366810,570,Argentina,A09,o,24,1,a
father,397860,402080,4220,Argentina,A09,o,24,2,a
mother,413130,418010,4880,Argentina,A09,c,25,1,q
mother,423630,424470,840,Argentina,A09,c,25,2,q
mother,431350,432570,1220,Argentina,A09,c,25,3,a
child,433550,434900,1350,Argentina,A09,m,25,4,a
mother,434270,436010,1740,Argentina,A09,c,25,5,q
mother,437010,440000,2990,Argentina,A09,c,25,6,a
child,438390,440520,2130,Argentina,A09,m,25,7,a
father,444390,448240,3850,Argentina,A09,c,25,8,a
mother,447660,454890,7230,Argentina,A09,b,25,9,a
child,453710,454740,1030,Argentina,A09,f,25,10,a
father,457720,458490,770,Argentina,A09,c,25,11,a
child,458000,462100,4100,Argentina,A09,f,25,12,a
father,459150,459680,530,Argentina,A09,c,25,13,i
mother,461970,464510,2540,Argentina,A09,c,25,14,a
father,463810,465810,2000,Argentina,A09,c,25,15,q
mother,466470,470120,3650,Argentina,A09,c,25,16,a
father,467630,468840,1210,Argentina,A09,c,25,17,a
mother,475250,477990,2740,Argentina,A09,c,25,18,a
father,469950,473340,3390,Argentina,A09,m,26,1,a
father,478520,480110,1590,Argentina,A09,m,26,2,a
mother,483670,484680,1010,Argentina,A09,c,27,1,q
child,484650,485150,500,Argentina,A09,m,27,2,a
mother,486980,487900,920,Argentina,A09,c,28,1,i
mother,490550,493480,2930,Argentina,A09,c,28,2,i
mother,494660,495940,1280,Argentina,A09,c,28,3,i
father,491130,498230,7100,Argentina,A09,m,29,1,a
child,492110,494540,2430,Argentina,A09,m,30,1,a
child,497370,499710,2340,Argentina,A09,m,30,2,a
mother,502090,503060,970,Argentina,A09,c,30,3,a
child,502950,509350,6400,Argentina,A09,m,30,4,a
mother,504820,507840,3020,Argentina,A09,c,30,5,q
child,511290,511820,530,Argentina,A09,m,30,6,a
mother,499370,500090,720,Argentina,A09,f,31,1,q
father,500400,507810,7410,Argentina,A09,m,31,2,a
mother,508840,509910,1070,Argentina,A09,f,32,1,a
father,509950,513750,3800,Argentina,A09,m,32,2,a
child,513390,516910,3520,Argentina,A09,m,33,1,a
mother,515120,516700,1580,Argentina,A09,c,33,2,i
child,518990,520710,1720,Argentina,A09,m,33,3,a
mother,521010,527290,6280,Argentina,A09,c,33,4,a
child,524270,524780,510,Argentina,A09,m,33,5,a
child,527330,532140,4810,Argentina,A09,m,33,6,a
mother,532230,544490,12260,Argentina,A09,c,33,7,a
father,532360,533160,800,Argentina,A09,b,33,8,a
father,535660,536970,1310,Argentina,A09,m,33,9,a
child,543350,543890,540,Argentina,A09,m,33,10,a
child,545580,547020,1440,Argentina,A09,m,33,11,i
mother,546130,552280,6150,Argentina,A09,c,33,12,a
father,552390,559800,7410,Argentina,A09,c,33,13,a
child,557330,559000,1670,Argentina,A09,b,33,14,a
child,562040,565090,3050,Argentina,A09,m,33,15,i
mother,564640,565590,950,Argentina,A09,c,33,16,q
child,566140,567370,1230,Argentina,A09,m,33,17,i
father,567090,568190,1100,Argentina,A09,m,33,18,a
child,569380,572330,2950,Argentina,A09,m,33,19,a
father,570020,571410,1390,Argentina,A09,m,33,20,a
mother,571530,572320,790,Argentina,A09,c,33,21,a
father,572830,575320,2490,Argentina,A09,c,33,22,a
mother,572870,573970,1100,Argentina,A09,c,33,23,a
child,572920,573580,660,Argentina,A09,m,33,24,a
mother,576450,577270,820,Argentina,A09,c,33,25,q
mother,577870,578530,660,Argentina,A09,c,33,26,a
child,578060,596304,18244,Argentina,A09,m,33,27,q
father,526370,527900,1530,Argentina,A09,m,34,1,a
mother,566820,569270,2450,Argentina,A09,f,35,1,a
father,577470,578730,1260,Argentina,A09,m,36,1,q
mother,583640,584660,1020,Argentina,A09,f,36,2,a
mother,586830,594020,7190,Argentina,A09,f,36,3,a
silence,6380,7320,940,Argentina,A09,NA,NA,NA,NA
silence,9910,11820,1910,Argentina,A09,NA,NA,NA,NA
father_gesture,11686,13431,1745,Argentina,A09,NA,NA,NA,NA
silence,13050,15490,2440,Argentina,A09,NA,NA,NA,NA
mother_gesture,15860,17060,1200,Argentina,A09,NA,NA,NA,NA
mother_gesture,19900,20836,936,Argentina,A09,NA,NA,NA,NA
silence,20970,21040,70,Argentina,A09,NA,NA,NA,NA
silence,23580,25150,1570,Argentina,A09,NA,NA,NA,NA
silence,28740,28910,170,Argentina,A09,NA,NA,NA,NA
silence,33430,34230,800,Argentina,A09,NA,NA,NA,NA
silence,35000,37410,2410,Argentina,A09,NA,NA,NA,NA
silence,39730,39890,160,Argentina,A09,NA,NA,NA,NA
silence,43250,44240,990,Argentina,A09,NA,NA,NA,NA
silence,49210,49390,180,Argentina,A09,NA,NA,NA,NA
silence,50060,53460,3400,Argentina,A09,NA,NA,NA,NA
silence,54160,58720,4560,Argentina,A09,NA,NA,NA,NA
silence,66420,66990,570,Argentina,A09,NA,NA,NA,NA
mother_gesture,72086,75116,3030,Argentina,A09,NA,NA,NA,NA
silence,74680,75420,740,Argentina,A09,NA,NA,NA,NA
silence,78490,81990,3500,Argentina,A09,NA,NA,NA,NA
silence,83250,83290,40,Argentina,A09,NA,NA,NA,NA
silence,96660,98410,1750,Argentina,A09,NA,NA,NA,NA
silence,99130,99230,100,Argentina,A09,NA,NA,NA,NA
silence,101140,104740,3600,Argentina,A09,NA,NA,NA,NA
silence,108040,108850,810,Argentina,A09,NA,NA,NA,NA
silence,109410,110200,790,Argentina,A09,NA,NA,NA,NA
silence,113790,116100,2310,Argentina,A09,NA,NA,NA,NA
silence,117370,117840,470,Argentina,A09,NA,NA,NA,NA
silence,118590,119250,660,Argentina,A09,NA,NA,NA,NA
silence,121310,121450,140,Argentina,A09,NA,NA,NA,NA
silence,123630,123880,250,Argentina,A09,NA,NA,NA,NA
silence,124380,125580,1200,Argentina,A09,NA,NA,NA,NA
silence,131290,134020,2730,Argentina,A09,NA,NA,NA,NA
silence,135710,135780,70,Argentina,A09,NA,NA,NA,NA
silence,137590,141660,4070,Argentina,A09,NA,NA,NA,NA
silence,142640,143140,500,Argentina,A09,NA,NA,NA,NA
silence,146120,147180,1060,Argentina,A09,NA,NA,NA,NA
child_gesture,148820,150050,1230,Argentina,A09,NA,NA,NA,NA
child_gesture,150825,151965,1140,Argentina,A09,NA,NA,NA,NA
silence,162000,162050,50,Argentina,A09,NA,NA,NA,NA
silence,166990,169220,2230,Argentina,A09,NA,NA,NA,NA
silence,182990,185170,2180,Argentina,A09,NA,NA,NA,NA
silence,186990,187580,590,Argentina,A09,NA,NA,NA,NA
silence,188150,190650,2500,Argentina,A09,NA,NA,NA,NA
silence,192620,192780,160,Argentina,A09,NA,NA,NA,NA
silence,195670,198300,2630,Argentina,A09,NA,NA,NA,NA
silence,200410,200440,30,Argentina,A09,NA,NA,NA,NA
silence,202410,203610,1200,Argentina,A09,NA,NA,NA,NA
silence,204130,206130,2000,Argentina,A09,NA,NA,NA,NA
mother_gesture,206990,208090,1100,Argentina,A09,NA,NA,NA,NA
silence,207770,209220,1450,Argentina,A09,NA,NA,NA,NA
silence,214090,214110,20,Argentina,A09,NA,NA,NA,NA
father_gesture,214229,215040,811,Argentina,A09,NA,NA,NA,NA
father_gesture,215518,216478,960,Argentina,A09,NA,NA,NA,NA
silence,216000,218270,2270,Argentina,A09,NA,NA,NA,NA
silence,221470,225040,3570,Argentina,A09,NA,NA,NA,NA
silence,225650,228430,2780,Argentina,A09,NA,NA,NA,NA
silence,229220,232920,3700,Argentina,A09,NA,NA,NA,NA
silence,234080,234100,20,Argentina,A09,NA,NA,NA,NA
silence,237720,237740,20,Argentina,A09,NA,NA,NA,NA
silence,239150,239410,260,Argentina,A09,NA,NA,NA,NA
silence,241550,242050,500,Argentina,A09,NA,NA,NA,NA
silence,242650,242700,50,Argentina,A09,NA,NA,NA,NA
silence,245750,246890,1140,Argentina,A09,NA,NA,NA,NA
silence,250480,252030,1550,Argentina,A09,NA,NA,NA,NA
silence,255050,255090,40,Argentina,A09,NA,NA,NA,NA
father_gesture,259682,260947,1265,Argentina,A09,NA,NA,NA,NA
mother_gesture,260310,261480,1170,Argentina,A09,NA,NA,NA,NA
father_gesture,261898,263462,1564,Argentina,A09,NA,NA,NA,NA
silence,266080,268230,2150,Argentina,A09,NA,NA,NA,NA
father_gesture,274236,275764,1528,Argentina,A09,NA,NA,NA,NA
child_gesture,275860,276970,1110,Argentina,A09,NA,NA,NA,NA
silence,276090,276310,220,Argentina,A09,NA,NA,NA,NA
silence,276900,277450,550,Argentina,A09,NA,NA,NA,NA
father_gesture,278010,279439,1429,Argentina,A09,NA,NA,NA,NA
silence,279530,279990,460,Argentina,A09,NA,NA,NA,NA
silence,281990,282490,500,Argentina,A09,NA,NA,NA,NA
silence,285800,286240,440,Argentina,A09,NA,NA,NA,NA
silence,296390,296510,120,Argentina,A09,NA,NA,NA,NA
silence,299840,300090,250,Argentina,A09,NA,NA,NA,NA
child_gesture,301129,303438,2309,Argentina,A09,NA,NA,NA,NA
silence,302420,302920,500,Argentina,A09,NA,NA,NA,NA
silence,303460,309680,6220,Argentina,A09,NA,NA,NA,NA
mother_gesture,305740,306460,720,Argentina,A09,NA,NA,NA,NA
mother_gesture,306550,307390,840,Argentina,A09,NA,NA,NA,NA
mother_gesture,307510,308350,840,Argentina,A09,NA,NA,NA,NA
mother_gesture,308410,309260,850,Argentina,A09,NA,NA,NA,NA
silence,310960,313200,2240,Argentina,A09,NA,NA,NA,NA
mother_gesture,312579,313268,689,Argentina,A09,NA,NA,NA,NA
silence,326230,328610,2380,Argentina,A09,NA,NA,NA,NA
silence,329750,329930,180,Argentina,A09,NA,NA,NA,NA
silence,341060,345940,4880,Argentina,A09,NA,NA,NA,NA
silence,351170,352580,1410,Argentina,A09,NA,NA,NA,NA
silence,353160,353180,20,Argentina,A09,NA,NA,NA,NA
silence,363320,364100,780,Argentina,A09,NA,NA,NA,NA
silence,369600,369650,50,Argentina,A09,NA,NA,NA,NA
silence,377510,378280,770,Argentina,A09,NA,NA,NA,NA
silence,379260,380770,1510,Argentina,A09,NA,NA,NA,NA
mother_gesture,382900,384940,2040,Argentina,A09,NA,NA,NA,NA
silence,383240,383560,320,Argentina,A09,NA,NA,NA,NA
silence,389190,390250,1060,Argentina,A09,NA,NA,NA,NA
silence,393380,393950,570,Argentina,A09,NA,NA,NA,NA
silence,397470,397860,390,Argentina,A09,NA,NA,NA,NA
silence,402080,413130,11050,Argentina,A09,NA,NA,NA,NA
silence,418010,423630,5620,Argentina,A09,NA,NA,NA,NA
silence,424470,431350,6880,Argentina,A09,NA,NA,NA,NA
silence,432570,433550,980,Argentina,A09,NA,NA,NA,NA
silence,436010,437010,1000,Argentina,A09,NA,NA,NA,NA
silence,440520,444390,3870,Argentina,A09,NA,NA,NA,NA
silence,454890,457720,2830,Argentina,A09,NA,NA,NA,NA
silence,465810,466470,660,Argentina,A09,NA,NA,NA,NA
father_gesture,471212,472127,915,Argentina,A09,NA,NA,NA,NA
father_gesture,472149,474258,2109,Argentina,A09,NA,NA,NA,NA
silence,473340,475250,1910,Argentina,A09,NA,NA,NA,NA
silence,477990,478520,530,Argentina,A09,NA,NA,NA,NA
silence,480110,483670,3560,Argentina,A09,NA,NA,NA,NA
silence,485150,486980,1830,Argentina,A09,NA,NA,NA,NA
silence,487900,490550,2650,Argentina,A09,NA,NA,NA,NA
silence,500090,500400,310,Argentina,A09,NA,NA,NA,NA
silence,509910,509950,40,Argentina,A09,NA,NA,NA,NA
father_gesture,511420,512430,1010,Argentina,A09,NA,NA,NA,NA
silence,516910,518990,2080,Argentina,A09,NA,NA,NA,NA
silence,520710,521010,300,Argentina,A09,NA,NA,NA,NA
silence,532140,532230,90,Argentina,A09,NA,NA,NA,NA
silence,544490,545580,1090,Argentina,A09,NA,NA,NA,NA
silence,552280,552390,110,Argentina,A09,NA,NA,NA,NA
silence,559800,562040,2240,Argentina,A09,NA,NA,NA,NA
child_gesture,561378,563344,1966,Argentina,A09,NA,NA,NA,NA
child_gesture,564014,565237,1223,Argentina,A09,NA,NA,NA,NA
silence,565590,566140,550,Argentina,A09,NA,NA,NA,NA
child_gesture,566645,567884,1239,Argentina,A09,NA,NA,NA,NA
silence,569270,569380,110,Argentina,A09,NA,NA,NA,NA
child_gesture,569890,571400,1510,Argentina,A09,NA,NA,NA,NA
silence,572330,572830,500,Argentina,A09,NA,NA,NA,NA
silence,575320,576450,1130,Argentina,A09,NA,NA,NA,NA
silence,577270,577470,200,Argentina,A09,NA,NA,NA,NA
mother_gesture,588520,589919,1399,Argentina,A09,NA,NA,NA,NA
mother_gesture,590885,593044,2159,Argentina,A09,NA,NA,NA,NA
mother_gesture,597160,598710,1550,Argentina,A09,NA,NA,NA,NA
father,830,1500,670,Argentina,A10,b,1,1,a
child,3800,5010,1210,Argentina,A10,m,2,1,a
mother,5010,5960,950,Argentina,A10,c,2,2,q
child,6110,7930,1820,Argentina,A10,m,2,3,a
mother,7960,8680,720,Argentina,A10,c,2,4,a
child,8880,10700,1820,Argentina,A10,m,2,5,a
mother,10670,13310,2640,Argentina,A10,c,2,6,q
mother,16030,16890,860,Argentina,A10,c,2,7,q
child,17000,19530,2530,Argentina,A10,m,2,8,a
child,24440,25500,1060,Argentina,A10,m,3,1,a
mother,30630,31500,870,Argentina,A10,c,3,2,a
child,31870,33100,1230,Argentina,A10,m,3,3,a
mother,33150,34620,1470,Argentina,A10,c,3,4,q
child,35180,36010,830,Argentina,A10,m,3,5,a
mother,38730,41890,3160,Argentina,A10,f,4,1,a
father,42810,43360,550,Argentina,A10,m,4,2,a
child,41970,49720,7750,Argentina,A10,b,5,1,a
mother,49920,50970,1050,Argentina,A10,c,5,2,q
child,50660,51260,600,Argentina,A10,b,5,3,a
mother,51660,53460,1800,Argentina,A10,c,5,4,q
mother,56200,58590,2390,Argentina,A10,c,5,5,a
child,58290,59270,980,Argentina,A10,b,5,6,a
mother,59150,59720,570,Argentina,A10,c,5,7,a
father,59690,60670,980,Argentina,A10,b,5,8,a
father,54990,55860,870,Argentina,A10,o,6,1,a
mother,62900,63650,750,Argentina,A10,f,7,1,q
father,68860,70390,1530,Argentina,A10,m,7,2,a
mother,70940,74360,3420,Argentina,A10,f,7,3,a
father,86050,88740,2690,Argentina,A10,m,8,1,a
mother,88710,92810,4100,Argentina,A10,f,8,2,a
father,93700,97710,4010,Argentina,A10,m,8,3,a
mother,97070,100320,3250,Argentina,A10,f,8,4,a
child,92230,101710,9480,Argentina,A10,b,9,1,a
child,102220,104820,2600,Argentina,A10,m,10,1,a
mother,104910,110340,5430,Argentina,A10,c,10,2,q
child,111360,112570,1210,Argentina,A10,m,10,3,a
mother,112510,119460,6950,Argentina,A10,c,10,4,a
child,120000,120420,420,Argentina,A10,m,10,5,a
mother,120620,123920,3300,Argentina,A10,c,10,6,q
child,124000,124470,470,Argentina,A10,m,10,7,a
mother,124490,127800,3310,Argentina,A10,c,10,8,a
child,129920,135870,5950,Argentina,A10,m,10,9,a
mother,135980,137510,1530,Argentina,A10,c,10,10,q
child,137560,138130,570,Argentina,A10,m,10,11,a
mother,138240,139150,910,Argentina,A10,c,10,12,a
child,140190,141480,1290,Argentina,A10,m,10,13,a
mother,141400,142500,1100,Argentina,A10,c,10,14,a
father,144950,146210,1260,Argentina,A10,m,11,1,q
child,146280,147550,1270,Argentina,A10,f,11,2,a
mother,146870,149550,2680,Argentina,A10,f,11,3,a
mother,158260,162760,4500,Argentina,A10,f,11,4,a
mother,167810,169390,1580,Argentina,A10,f,11,5,a
mother,173710,174450,740,Argentina,A10,f,11,6,a
child,149050,152070,3020,Argentina,A10,m,12,1,q
mother,153300,156220,2920,Argentina,A10,c,12,2,a
child,159000,160290,1290,Argentina,A10,m,12,3,q
mother,165050,165750,700,Argentina,A10,c,12,4,a
father,173930,176210,2280,Argentina,A10,c,13,1,a
mother,174600,175380,780,Argentina,A10,c,13,2,a
mother,179690,184970,5280,Argentina,A10,c,13,3,a
child,183860,188140,4280,Argentina,A10,b,13,4,a
mother,186990,187540,550,Argentina,A10,c,13,5,a
father,187310,192200,4890,Argentina,A10,c,13,6,q
child,192500,193130,630,Argentina,A10,f,13,7,a
father,193640,197540,3900,Argentina,A10,c,13,8,a
mother,198460,199510,1050,Argentina,A10,c,14,1,i
child,199630,200150,520,Argentina,A10,m,14,2,a
mother,200800,201980,1180,Argentina,A10,c,14,3,a
child,201970,202940,970,Argentina,A10,m,14,4,a
mother,202910,204420,1510,Argentina,A10,c,14,5,a
child,204140,205840,1700,Argentina,A10,m,14,6,a
mother,205780,206610,830,Argentina,A10,c,14,7,a
child,206670,208700,2030,Argentina,A10,m,14,8,a
mother,209160,210390,1230,Argentina,A10,c,14,9,q
father,210420,211290,870,Argentina,A10,m,14,10,a
child,211260,211750,490,Argentina,A10,m,14,11,a
mother,211510,212870,1360,Argentina,A10,c,14,12,q
child,212920,213620,700,Argentina,A10,m,14,13,a
mother,218240,219720,1480,Argentina,A10,f,15,1,q
father,220120,222570,2450,Argentina,A10,m,15,2,a
mother,222390,222950,560,Argentina,A10,f,15,3,a
mother,227840,232300,4460,Argentina,A10,c,16,1,i
child,233930,234720,790,Argentina,A10,m,16,2,a
mother,234740,236560,1820,Argentina,A10,c,16,3,a
child,237310,242570,5260,Argentina,A10,m,16,4,a
mother,243310,244080,770,Argentina,A10,c,16,5,q
child,244660,248700,4040,Argentina,A10,m,16,6,a
mother,248930,249870,940,Argentina,A10,c,16,7,q
child,249990,251680,1690,Argentina,A10,m,16,8,a
mother,252260,254030,1770,Argentina,A10,c,16,9,a
child,254180,255110,930,Argentina,A10,m,16,10,a
mother,255420,257860,2440,Argentina,A10,c,16,11,q
father,258130,259640,1510,Argentina,A10,b,16,12,a
child,259120,259860,740,Argentina,A10,b,16,13,a
mother,260750,261350,600,Argentina,A10,c,16,14,i
mother,271320,272620,1300,Argentina,A10,c,16,15,a
child,261450,265660,4210,Argentina,A10,f,17,1,q
mother,266900,269800,2900,Argentina,A10,c,17,2,q
child,272530,274450,1920,Argentina,A10,b,18,1,a
mother,277990,279490,1500,Argentina,A10,f,19,1,a
mother,282520,283690,1170,Argentina,A10,f,19,2,a
child,285840,288710,2870,Argentina,A10,f,20,1,a
father,288710,289500,790,Argentina,A10,c,20,2,a
child,290010,290920,910,Argentina,A10,f,20,3,a
mother,291340,300600,9260,Argentina,A10,f,21,1,q
mother,309380,313660,4280,Argentina,A10,f,21,2,a
father,315040,315680,640,Argentina,A10,m,21,3,a
mother,316990,319670,2680,Argentina,A10,f,21,4,a
father,320300,322150,1850,Argentina,A10,m,21,5,q
mother,322120,323600,1480,Argentina,A10,f,21,6,a
father,331810,332240,430,Argentina,A10,m,21,7,q
mother,333060,334450,1390,Argentina,A10,f,21,8,a
child,295880,302040,6160,Argentina,A10,b,22,1,a
child,308000,308870,870,Argentina,A10,f,22,2,a
child,311120,312880,1760,Argentina,A10,f,22,3,a
child,328070,329370,1300,Argentina,A10,f,23,1,a
mother,332130,332990,860,Argentina,A10,c,24,1,q
child,334590,338300,3710,Argentina,A10,m,24,2,a
mother,337630,338480,850,Argentina,A10,c,24,3,a
child,338680,339550,870,Argentina,A10,m,24,4,a
child,341540,343440,1900,Argentina,A10,m,24,5,a
mother,343550,344810,1260,Argentina,A10,c,24,6,a
child,345060,346110,1050,Argentina,A10,m,24,7,a
mother,345930,347770,1840,Argentina,A10,c,24,8,q
child,347890,348390,500,Argentina,A10,m,24,9,a
mother,349380,357950,8570,Argentina,A10,c,24,10,a
child,358620,362550,3930,Argentina,A10,m,24,11,a
mother,361180,367640,6460,Argentina,A10,c,24,12,a
child,366430,369470,3040,Argentina,A10,m,24,13,a
father,339780,341220,1440,Argentina,A10,m,25,1,q
mother,341540,342120,580,Argentina,A10,f,25,2,a
mother,369710,371930,2220,Argentina,A10,c,25,3,a
father,371190,371990,800,Argentina,A10,c,25,4,a
mother,374300,375640,1340,Argentina,A10,c,25,5,a
child,376160,376970,810,Argentina,A10,m,25,6,a
mother,377060,378280,1220,Argentina,A10,c,25,7,a
child,378320,380080,1760,Argentina,A10,m,25,8,a
mother,380010,381040,1030,Argentina,A10,c,25,9,q
child,381130,381760,630,Argentina,A10,m,25,10,a
father,382070,383310,1240,Argentina,A10,m,26,1,a
mother,383440,385220,1780,Argentina,A10,f,26,2,a
mother,389180,390140,960,Argentina,A10,f,26,3,a
father,390020,397190,7170,Argentina,A10,m,26,4,a
mother,397370,398030,660,Argentina,A10,f,26,5,a
child,387180,387870,690,Argentina,A10,b,27,1,a
child,397270,398070,800,Argentina,A10,m,27,2,a
mother,398820,399500,680,Argentina,A10,c,27,3,a
child,400210,403700,3490,Argentina,A10,m,27,4,a
mother,402650,404500,1850,Argentina,A10,c,27,5,a
child,406630,407260,630,Argentina,A10,m,27,6,a
mother,407520,408060,540,Argentina,A10,c,27,7,a
child,408110,411620,3510,Argentina,A10,m,27,8,a
mother,412800,414100,1300,Argentina,A10,c,27,9,a
mother,416200,425070,8870,Argentina,A10,c,27,10,q
mother,428900,429920,1020,Argentina,A10,c,27,11,q
child,430150,430900,750,Argentina,A10,m,27,12,a
mother,430980,431510,530,Argentina,A10,c,27,13,q
child,431630,433150,1520,Argentina,A10,b,27,14,a
mother,433540,434380,840,Argentina,A10,c,27,15,a
father,434350,436770,2420,Argentina,A10,m,28,1,a
mother,436520,458470,21950,Argentina,A10,f,28,2,a
father,462040,463670,1630,Argentina,A10,m,28,3,a
mother,463970,464610,640,Argentina,A10,f,28,4,a
mother,466620,469490,2870,Argentina,A10,f,28,5,q
father,469500,470010,510,Argentina,A10,m,28,6,a
mother,481400,483470,2070,Argentina,A10,f,28,7,a
father,495200,498720,3520,Argentina,A10,m,28,8,a
mother,498760,502410,3650,Argentina,A10,f,28,9,a
father,507390,514200,6810,Argentina,A10,m,28,10,a
child,454880,455500,620,Argentina,A10,o,29,1,a
child,459100,461590,2490,Argentina,A10,o,29,2,a
child,465130,466370,1240,Argentina,A10,o,29,3,a
child,474330,476270,1940,Argentina,A10,b,30,1,a
child,504110,506570,2460,Argentina,A10,m,31,1,a
mother,507260,508910,1650,Argentina,A10,c,31,2,i
mother,515050,519360,4310,Argentina,A10,c,31,3,a
child,520430,523280,2850,Argentina,A10,m,31,4,a
mother,523410,526690,3280,Argentina,A10,c,31,5,a
child,524470,535180,10710,Argentina,A10,b,32,1,a
father,531290,532570,1280,Argentina,A10,m,33,1,a
mother,532870,535140,2270,Argentina,A10,f,33,2,a
mother,537590,538160,570,Argentina,A10,f,33,3,q
father,538460,553260,14800,Argentina,A10,m,33,4,a
mother,552310,553980,1670,Argentina,A10,f,33,5,a
mother,557510,570970,13460,Argentina,A10,f,33,6,a
child,536610,537120,510,Argentina,A10,o,34,1,a
child,544630,549130,4500,Argentina,A10,m,35,1,a
child,553460,555430,1970,Argentina,A10,b,35,2,a
child,560180,560920,740,Argentina,A10,m,35,3,a
child,566050,569010,2960,Argentina,A10,m,35,4,a
father,568200,571510,3310,Argentina,A10,m,35,5,a
mother,572190,572890,700,Argentina,A10,f,35,6,a
child,571600,576640,5040,Argentina,A10,m,36,1,a
mother,577370,584420,7050,Argentina,A10,m,36,2,a
mother,589250,596580,7330,Argentina,A10,c,36,3,a
child,592430,593290,860,Argentina,A10,m,36,4,q
father,584470,590570,6100,Argentina,A10,m,37,1,a
father,595190,597860,2670,Argentina,A10,m,37,2,a
silence,1500,3800,2300,Argentina,A10,NA,NA,NA,NA
silence,5960,6110,150,Argentina,A10,NA,NA,NA,NA
child_gesture,6626,7920,1294,Argentina,A10,NA,NA,NA,NA
silence,7930,7960,30,Argentina,A10,NA,NA,NA,NA
silence,8680,8880,200,Argentina,A10,NA,NA,NA,NA
child_gesture,9200,10256,1056,Argentina,A10,NA,NA,NA,NA
silence,13310,16030,2720,Argentina,A10,NA,NA,NA,NA
silence,16890,17000,110,Argentina,A10,NA,NA,NA,NA
silence,19530,24440,4910,Argentina,A10,NA,NA,NA,NA
silence,25500,30630,5130,Argentina,A10,NA,NA,NA,NA
silence,31500,31870,370,Argentina,A10,NA,NA,NA,NA
silence,33100,33150,50,Argentina,A10,NA,NA,NA,NA
silence,34620,35180,560,Argentina,A10,NA,NA,NA,NA
silence,36010,38730,2720,Argentina,A10,NA,NA,NA,NA
silence,41890,41970,80,Argentina,A10,NA,NA,NA,NA
silence,49720,49920,200,Argentina,A10,NA,NA,NA,NA
silence,51260,51660,400,Argentina,A10,NA,NA,NA,NA
silence,53460,54990,1530,Argentina,A10,NA,NA,NA,NA
silence,55860,56200,340,Argentina,A10,NA,NA,NA,NA
silence,60670,62900,2230,Argentina,A10,NA,NA,NA,NA
silence,63650,68860,5210,Argentina,A10,NA,NA,NA,NA
silence,70390,70940,550,Argentina,A10,NA,NA,NA,NA
silence,74360,86050,11690,Argentina,A10,NA,NA,NA,NA
silence,101710,102220,510,Argentina,A10,NA,NA,NA,NA
child_gesture,102511,104879,2368,Argentina,A10,NA,NA,NA,NA
silence,104820,104910,90,Argentina,A10,NA,NA,NA,NA
mother_gesture,109560,110490,930,Argentina,A10,NA,NA,NA,NA
silence,110340,111360,1020,Argentina,A10,NA,NA,NA,NA
child_gesture,117770,119396,1626,Argentina,A10,NA,NA,NA,NA
silence,119460,120000,540,Argentina,A10,NA,NA,NA,NA
silence,120420,120620,200,Argentina,A10,NA,NA,NA,NA
silence,123920,124000,80,Argentina,A10,NA,NA,NA,NA
silence,124470,124490,20,Argentina,A10,NA,NA,NA,NA
silence,127800,129920,2120,Argentina,A10,NA,NA,NA,NA
child_gesture,130261,132430,2169,Argentina,A10,NA,NA,NA,NA
child_gesture,133470,135860,2390,Argentina,A10,NA,NA,NA,NA
silence,135870,135980,110,Argentina,A10,NA,NA,NA,NA
mother_gesture,136384,137692,1308,Argentina,A10,NA,NA,NA,NA
silence,137510,137560,50,Argentina,A10,NA,NA,NA,NA
silence,138130,138240,110,Argentina,A10,NA,NA,NA,NA
silence,139150,140190,1040,Argentina,A10,NA,NA,NA,NA
silence,142500,144950,2450,Argentina,A10,NA,NA,NA,NA
silence,146210,146280,70,Argentina,A10,NA,NA,NA,NA
child_gesture,148184,149855,1671,Argentina,A10,NA,NA,NA,NA
child_gesture,151000,153010,2010,Argentina,A10,NA,NA,NA,NA
silence,152070,153300,1230,Argentina,A10,NA,NA,NA,NA
silence,156220,158260,2040,Argentina,A10,NA,NA,NA,NA
silence,162760,165050,2290,Argentina,A10,NA,NA,NA,NA
silence,165750,167810,2060,Argentina,A10,NA,NA,NA,NA
silence,169390,173710,4320,Argentina,A10,NA,NA,NA,NA
silence,176210,179690,3480,Argentina,A10,NA,NA,NA,NA
child_gesture,186114,187641,1527,Argentina,A10,NA,NA,NA,NA
silence,192200,192500,300,Argentina,A10,NA,NA,NA,NA
silence,193130,193640,510,Argentina,A10,NA,NA,NA,NA
silence,197540,198460,920,Argentina,A10,NA,NA,NA,NA
silence,199510,199630,120,Argentina,A10,NA,NA,NA,NA
silence,200150,200800,650,Argentina,A10,NA,NA,NA,NA
mother_gesture,203200,203990,790,Argentina,A10,NA,NA,NA,NA
silence,206610,206670,60,Argentina,A10,NA,NA,NA,NA
silence,208700,209160,460,Argentina,A10,NA,NA,NA,NA
silence,210390,210420,30,Argentina,A10,NA,NA,NA,NA
silence,212870,212920,50,Argentina,A10,NA,NA,NA,NA
silence,213620,218240,4620,Argentina,A10,NA,NA,NA,NA
silence,219720,220120,400,Argentina,A10,NA,NA,NA,NA
silence,222950,227840,4890,Argentina,A10,NA,NA,NA,NA
silence,232300,233930,1630,Argentina,A10,NA,NA,NA,NA
silence,234720,234740,20,Argentina,A10,NA,NA,NA,NA
silence,236560,237310,750,Argentina,A10,NA,NA,NA,NA
silence,242570,243310,740,Argentina,A10,NA,NA,NA,NA
silence,244080,244660,580,Argentina,A10,NA,NA,NA,NA
silence,248700,248930,230,Argentina,A10,NA,NA,NA,NA
silence,249870,249990,120,Argentina,A10,NA,NA,NA,NA
silence,251680,252260,580,Argentina,A10,NA,NA,NA,NA
silence,254030,254180,150,Argentina,A10,NA,NA,NA,NA
silence,255110,255420,310,Argentina,A10,NA,NA,NA,NA
silence,257860,258130,270,Argentina,A10,NA,NA,NA,NA
silence,259860,260750,890,Argentina,A10,NA,NA,NA,NA
silence,261350,261450,100,Argentina,A10,NA,NA,NA,NA
silence,265660,266900,1240,Argentina,A10,NA,NA,NA,NA
silence,269800,271320,1520,Argentina,A10,NA,NA,NA,NA
silence,274450,277990,3540,Argentina,A10,NA,NA,NA,NA
silence,279490,282520,3030,Argentina,A10,NA,NA,NA,NA
silence,283690,285840,2150,Argentina,A10,NA,NA,NA,NA
silence,289500,290010,510,Argentina,A10,NA,NA,NA,NA
silence,290920,291340,420,Argentina,A10,NA,NA,NA,NA
silence,302040,308000,5960,Argentina,A10,NA,NA,NA,NA
silence,308870,309380,510,Argentina,A10,NA,NA,NA,NA
silence,313660,315040,1380,Argentina,A10,NA,NA,NA,NA
silence,315680,316990,1310,Argentina,A10,NA,NA,NA,NA
silence,319670,320300,630,Argentina,A10,NA,NA,NA,NA
silence,323600,328070,4470,Argentina,A10,NA,NA,NA,NA
silence,329370,331810,2440,Argentina,A10,NA,NA,NA,NA
silence,332990,333060,70,Argentina,A10,NA,NA,NA,NA
silence,334450,334590,140,Argentina,A10,NA,NA,NA,NA
child_gesture,337150,338210,1060,Argentina,A10,NA,NA,NA,NA
mother_gesture,337260,338767,1507,Argentina,A10,NA,NA,NA,NA
silence,338480,338680,200,Argentina,A10,NA,NA,NA,NA
silence,339550,339780,230,Argentina,A10,NA,NA,NA,NA
silence,341220,341540,320,Argentina,A10,NA,NA,NA,NA
silence,343440,343550,110,Argentina,A10,NA,NA,NA,NA
silence,344810,345060,250,Argentina,A10,NA,NA,NA,NA
silence,347770,347890,120,Argentina,A10,NA,NA,NA,NA
silence,348390,349380,990,Argentina,A10,NA,NA,NA,NA
silence,357950,358620,670,Argentina,A10,NA,NA,NA,NA
silence,369470,369710,240,Argentina,A10,NA,NA,NA,NA
silence,371990,374300,2310,Argentina,A10,NA,NA,NA,NA
silence,375640,376160,520,Argentina,A10,NA,NA,NA,NA
silence,376970,377060,90,Argentina,A10,NA,NA,NA,NA
silence,378280,378320,40,Argentina,A10,NA,NA,NA,NA
silence,381040,381130,90,Argentina,A10,NA,NA,NA,NA
silence,381760,382070,310,Argentina,A10,NA,NA,NA,NA
silence,383310,383440,130,Argentina,A10,NA,NA,NA,NA
silence,385220,387180,1960,Argentina,A10,NA,NA,NA,NA
silence,387870,389180,1310,Argentina,A10,NA,NA,NA,NA
silence,397190,397270,80,Argentina,A10,NA,NA,NA,NA
silence,398070,398820,750,Argentina,A10,NA,NA,NA,NA
silence,399500,400210,710,Argentina,A10,NA,NA,NA,NA
silence,404500,406630,2130,Argentina,A10,NA,NA,NA,NA
silence,407260,407520,260,Argentina,A10,NA,NA,NA,NA
silence,408060,408110,50,Argentina,A10,NA,NA,NA,NA
silence,411620,412800,1180,Argentina,A10,NA,NA,NA,NA
silence,414100,416200,2100,Argentina,A10,NA,NA,NA,NA
silence,425070,428900,3830,Argentina,A10,NA,NA,NA,NA
silence,429920,430150,230,Argentina,A10,NA,NA,NA,NA
silence,430900,430980,80,Argentina,A10,NA,NA,NA,NA
silence,431510,431630,120,Argentina,A10,NA,NA,NA,NA
silence,433150,433540,390,Argentina,A10,NA,NA,NA,NA
mother_gesture,445577,447589,2012,Argentina,A10,NA,NA,NA,NA
silence,458470,459100,630,Argentina,A10,NA,NA,NA,NA
silence,461590,462040,450,Argentina,A10,NA,NA,NA,NA
silence,463670,463970,300,Argentina,A10,NA,NA,NA,NA
silence,464610,465130,520,Argentina,A10,NA,NA,NA,NA
silence,466370,466620,250,Argentina,A10,NA,NA,NA,NA
silence,469490,469500,10,Argentina,A10,NA,NA,NA,NA
silence,470010,474330,4320,Argentina,A10,NA,NA,NA,NA
silence,476270,481400,5130,Argentina,A10,NA,NA,NA,NA
silence,483470,495200,11730,Argentina,A10,NA,NA,NA,NA
silence,498720,498760,40,Argentina,A10,NA,NA,NA,NA
silence,502410,504110,1700,Argentina,A10,NA,NA,NA,NA
silence,506570,507260,690,Argentina,A10,NA,NA,NA,NA
mother_gesture,507215,509085,1870,Argentina,A10,NA,NA,NA,NA
silence,514200,515050,850,Argentina,A10,NA,NA,NA,NA
silence,519360,520430,1070,Argentina,A10,NA,NA,NA,NA
silence,523280,523410,130,Argentina,A10,NA,NA,NA,NA
silence,535180,536610,1430,Argentina,A10,NA,NA,NA,NA
silence,537120,537590,470,Argentina,A10,NA,NA,NA,NA
silence,538160,538460,300,Argentina,A10,NA,NA,NA,NA
silence,555430,557510,2080,Argentina,A10,NA,NA,NA,NA
silence,571510,571600,90,Argentina,A10,NA,NA,NA,NA
silence,576640,577370,730,Argentina,A10,NA,NA,NA,NA
mother_gesture,579180,580762,1582,Argentina,A10,NA,NA,NA,NA
mother_gesture,583650,584460,810,Argentina,A10,NA,NA,NA,NA
silence,584420,584470,50,Argentina,A10,NA,NA,NA,NA
mother_gesture,591271,594792,3521,Argentina,A10,NA,NA,NA,NA
child_gesture,592200,593390,1190,Argentina,A10,NA,NA,NA,NA
silence,597860,598540,680,Argentina,A10,NA,NA,NA,NA
father,9410,16660,7250,Argentina,A11,c,2,1,a
child,22388,22947,559,Argentina,A11,f,2,2,a
mother,28983,29720,737,Argentina,A11,c,3,1,q
child,30685,31769,1084,Argentina,A11,m,3,2,a
mother,32010,33250,1240,Argentina,A11,c,3,3,i
child,34030,35090,1060,Argentina,A11,m,3,4,i
mother,35710,39423,3713,Argentina,A11,c,3,5,q
child,40471,42042,1571,Argentina,A11,m,3,6,a
mother,42140,42920,780,Argentina,A11,c,3,7,q
child,43007,44161,1154,Argentina,A11,m,3,8,a
mother,44080,45410,1330,Argentina,A11,c,3,9,q
child,46530,47721,1191,Argentina,A11,m,3,10,a
mother,47940,48720,780,Argentina,A11,c,3,11,q
child,49007,50304,1297,Argentina,A11,m,3,12,a
mother,50790,51810,1020,Argentina,A11,c,3,13,q
child,51804,53292,1488,Argentina,A11,m,3,14,i
mother,52850,53720,870,Argentina,A11,c,3,15,q
child,53888,56792,2904,Argentina,A11,m,3,16,a
mother,56040,57140,1100,Argentina,A11,c,3,17,i
father,56320,56980,660,Argentina,A11,c,3,18,i
child,58019,60257,2238,Argentina,A11,f,3,19,a
father,61240,63440,2200,Argentina,A11,c,3,20,a
mother,63380,65000,1620,Argentina,A11,c,3,21,q
mother,67490,68820,1330,Argentina,A11,c,3,22,q
child,69495,71983,2488,Argentina,A11,m,3,23,a
mother,72220,74150,1930,Argentina,A11,c,3,24,q
child,74328,75340,1012,Argentina,A11,m,3,25,a
mother,75620,76750,1130,Argentina,A11,c,3,26,q
child,78138,79400,1262,Argentina,A11,m,3,27,a
father,78880,82370,3490,Argentina,A11,b,3,28,i
mother,89920,93490,3570,Argentina,A11,c,3,29,q
child,100316,101316,1000,Argentina,A11,m,3,30,a
child,102602,103376,774,Argentina,A11,m,3,31,a
mother,103290,104820,1530,Argentina,A11,c,3,32,a
child,104804,105745,941,Argentina,A11,m,3,33,a
mother,105580,106460,880,Argentina,A11,c,3,34,q
child,112626,114519,1893,Argentina,A11,b,3,35,a
mother,84450,85750,1300,Argentina,A11,c,6,1,NA
mother,97850,99880,2030,Argentina,A11,f,8,1,a
mother,101320,102840,1520,Argentina,A11,f,8,2,q
mother,112340,118790,6450,Argentina,A11,f,9,1,a
mother,135620,137050,1430,Argentina,A11,c,11,1,q
mother,141060,141750,690,Argentina,A11,c,11,2,a
mother,150290,151600,1310,Argentina,A11,f,12,1,a
father,151980,152550,570,Argentina,A11,m,12,2,a
father,165090,165710,620,Argentina,A11,c,13,1,q
mother,189860,190930,1070,Argentina,A11,f,14,1,a
mother,198640,199430,790,Argentina,A11,c,15,1,q
child,200019,202530,2511,Argentina,A11,m,15,2,a
father,202530,203250,720,Argentina,A11,b,15,3,q
mother,203220,204550,1330,Argentina,A11,c,15,4,q
mother,206970,208480,1510,Argentina,A11,f,15,5,a
father,210930,212520,1590,Argentina,A11,m,15,6,a
mother,216050,216850,800,Argentina,A11,f,15,7,a
mother,219410,221410,2000,Argentina,A11,c,16,1,a
child,223150,225923,2773,Argentina,A11,m,16,2,a
mother,225700,226470,770,Argentina,A11,c,16,3,a
child,226828,228161,1333,Argentina,A11,m,16,4,a
mother,242240,245400,3160,Argentina,A11,f,17,1,a
mother,277150,277880,730,Argentina,A11,f,18,1,q
father,278590,279170,580,Argentina,A11,m,18,2,a
mother,279940,280390,450,Argentina,A11,f,18,3,a
mother,294810,296550,1740,Argentina,A11,f,19,1,a
father,299160,300650,1490,Argentina,A11,m,19,2,q
mother,300920,301890,970,Argentina,A11,f,19,3,a
mother,305460,308040,2580,Argentina,A11,f,19,4,q
father,308510,311300,2790,Argentina,A11,m,19,5,a
mother,311440,313120,1680,Argentina,A11,f,19,6,a
father,314170,315580,1410,Argentina,A11,m,19,7,a
father,319360,320220,860,Argentina,A11,m,19,8,q
mother,321950,326900,4950,Argentina,A11,f,19,9,a
father,327210,328490,1280,Argentina,A11,m,19,10,a
mother,329400,331300,1900,Argentina,A11,f,19,11,q
father,331270,331790,520,Argentina,A11,m,19,12,q
mother,331800,332400,600,Argentina,A11,f,19,13,q
father,332530,333560,1030,Argentina,A11,m,19,14,a
mother,337130,340120,2990,Argentina,A11,f,19,15,a
mother,343120,344250,1130,Argentina,A11,f,19,16,a
father,344890,345850,960,Argentina,A11,m,19,17,q
mother,345920,346410,490,Argentina,A11,f,19,18,a
mother,348760,349970,1210,Argentina,A11,f,19,19,a
mother,352450,358450,6000,Argentina,A11,f,19,20,a
father,360440,361010,570,Argentina,A11,m,19,21,a
mother,302420,303740,1320,Argentina,A11,f,20,1,q
child,367245,368031,786,Argentina,A11,b,20,2,a
mother,368160,368950,790,Argentina,A11,c,20,3,a
father,368430,371530,3100,Argentina,A11,c,20,4,q
child,372304,373507,1203,Argentina,A11,b,20,5,a
mother,374300,374890,590,Argentina,A11,c,20,6,q
mother,375210,376230,1020,Argentina,A11,c,21,1,i
father,385950,387840,1890,Argentina,A11,c,22,1,q
father,394900,395760,860,Argentina,A11,c,23,1,q
child,396483,398757,2274,Argentina,A11,f,23,2,a
father,397590,398350,760,Argentina,A11,c,23,3,q
child,402935,404090,1155,Argentina,A11,f,23,4,a
father,444300,446170,1870,Argentina,A11,c,23,5,i
father,449190,450430,1240,Argentina,A11,c,23,6,q
mother,479630,480770,1140,Argentina,A11,f,24,1,a
father,484460,485320,860,Argentina,A11,m,24,2,q
mother,486610,488940,2330,Argentina,A11,f,24,3,a
father,481100,481880,780,Argentina,A11,c,25,1,q
father,492270,493090,820,Argentina,A11,m,26,1,q
mother,493870,494720,850,Argentina,A11,f,26,2,a
father,494740,496000,1260,Argentina,A11,m,26,3,a
mother,496320,497580,1260,Argentina,A11,f,26,4,a
mother,503570,505290,1720,Argentina,A11,c,27,1,a
child,505626,508852,3226,Argentina,A11,m,27,2,a
mother,508780,509550,770,Argentina,A11,c,27,3,q
mother,511580,512290,710,Argentina,A11,c,27,4,q
child,513709,514923,1214,Argentina,A11,b,27,5,a
mother,516080,517870,1790,Argentina,A11,c,27,6,q
child,518804,520245,1441,Argentina,A11,m,27,7,a
father,520130,522110,1980,Argentina,A11,c,27,8,i
mother,524670,527210,2540,Argentina,A11,c,27,9,a
mother,529460,530880,1420,Argentina,A11,c,27,10,i
mother,537330,539390,2060,Argentina,A11,c,27,11,a
father,542160,543410,1250,Argentina,A11,m,27,12,a
child,542495,545233,2738,Argentina,A11,m,27,13,a
mother,543480,546710,3230,Argentina,A11,c,27,14,a
mother,549930,551550,1620,Argentina,A11,c,27,15,q
mother,553930,554640,710,Argentina,A11,c,27,16,q
mother,560490,561620,1130,Argentina,A11,c,27,17,q
child,567078,568245,1167,Argentina,A11,m,27,18,a
mother,568030,569040,1010,Argentina,A11,c,27,19,a
child,571566,572316,750,Argentina,A11,m,27,20,a
mother,571830,572620,790,Argentina,A11,c,27,21,a
child,573161,574531,1370,Argentina,A11,m,27,22,a
mother,574240,576330,2090,Argentina,A11,c,27,23,a
father,575660,576320,660,Argentina,A11,c,27,24,q
father,590680,593130,2450,Argentina,A11,c,31,1,i
mother,594610,595700,1090,Argentina,A11,c,31,2,q
child,595911,596947,1036,Argentina,A11,m,31,3,a
mother,596790,597400,610,Argentina,A11,c,31,4,a
silence,2490,9410,6920,Argentina,A11,NA,NA,NA,NA
silence,16660,22388,5728,Argentina,A11,NA,NA,NA,NA
silence,22947,28983,6036,Argentina,A11,NA,NA,NA,NA
silence,29720,30685,965,Argentina,A11,NA,NA,NA,NA
silence,31769,32010,241,Argentina,A11,NA,NA,NA,NA
silence,33250,34030,780,Argentina,A11,NA,NA,NA,NA
silence,35090,35710,620,Argentina,A11,NA,NA,NA,NA
mother_gesture,35740,37449,1709,Argentina,A11,NA,NA,NA,NA
silence,39423,40471,1048,Argentina,A11,NA,NA,NA,NA
silence,42042,42140,98,Argentina,A11,NA,NA,NA,NA
silence,42920,43007,87,Argentina,A11,NA,NA,NA,NA
silence,45410,46530,1120,Argentina,A11,NA,NA,NA,NA
silence,47721,47940,219,Argentina,A11,NA,NA,NA,NA
silence,48720,49007,287,Argentina,A11,NA,NA,NA,NA
silence,50304,50790,486,Argentina,A11,NA,NA,NA,NA
silence,53720,53888,168,Argentina,A11,NA,NA,NA,NA
silence,57140,58019,879,Argentina,A11,NA,NA,NA,NA
silence,60257,61240,983,Argentina,A11,NA,NA,NA,NA
silence,65000,67490,2490,Argentina,A11,NA,NA,NA,NA
silence,68820,69495,675,Argentina,A11,NA,NA,NA,NA
silence,71983,72220,237,Argentina,A11,NA,NA,NA,NA
silence,74150,74328,178,Argentina,A11,NA,NA,NA,NA
silence,75340,75620,280,Argentina,A11,NA,NA,NA,NA
silence,76750,78138,1388,Argentina,A11,NA,NA,NA,NA
silence,82370,84450,2080,Argentina,A11,NA,NA,NA,NA
silence,85750,89920,4170,Argentina,A11,NA,NA,NA,NA
silence,93490,97850,4360,Argentina,A11,NA,NA,NA,NA
silence,99880,100316,436,Argentina,A11,NA,NA,NA,NA
silence,101316,101320,4,Argentina,A11,NA,NA,NA,NA
silence,106460,112340,5880,Argentina,A11,NA,NA,NA,NA
silence,118790,135620,16830,Argentina,A11,NA,NA,NA,NA
silence,137050,141060,4010,Argentina,A11,NA,NA,NA,NA
silence,141750,150290,8540,Argentina,A11,NA,NA,NA,NA
silence,151600,151980,380,Argentina,A11,NA,NA,NA,NA
silence,152550,165090,12540,Argentina,A11,NA,NA,NA,NA
silence,165710,189860,24150,Argentina,A11,NA,NA,NA,NA
silence,190930,198640,7710,Argentina,A11,NA,NA,NA,NA
silence,199430,200019,589,Argentina,A11,NA,NA,NA,NA
silence,204550,206970,2420,Argentina,A11,NA,NA,NA,NA
mother_gesture,207459,208769,1310,Argentina,A11,NA,NA,NA,NA
silence,208480,210930,2450,Argentina,A11,NA,NA,NA,NA
silence,212520,216050,3530,Argentina,A11,NA,NA,NA,NA
silence,216850,219410,2560,Argentina,A11,NA,NA,NA,NA
silence,221410,223150,1740,Argentina,A11,NA,NA,NA,NA
silence,226470,226828,358,Argentina,A11,NA,NA,NA,NA
silence,228161,242240,14079,Argentina,A11,NA,NA,NA,NA
silence,245400,277150,31750,Argentina,A11,NA,NA,NA,NA
silence,277880,278590,710,Argentina,A11,NA,NA,NA,NA
silence,279170,279940,770,Argentina,A11,NA,NA,NA,NA
silence,280390,294810,14420,Argentina,A11,NA,NA,NA,NA
silence,296550,299160,2610,Argentina,A11,NA,NA,NA,NA
silence,300650,300920,270,Argentina,A11,NA,NA,NA,NA
silence,301890,302420,530,Argentina,A11,NA,NA,NA,NA
mother_gesture,302470,303870,1400,Argentina,A11,NA,NA,NA,NA
silence,303740,305460,1720,Argentina,A11,NA,NA,NA,NA
silence,308040,308510,470,Argentina,A11,NA,NA,NA,NA
silence,311300,311440,140,Argentina,A11,NA,NA,NA,NA
silence,313120,314170,1050,Argentina,A11,NA,NA,NA,NA
silence,315580,319360,3780,Argentina,A11,NA,NA,NA,NA
silence,320220,321950,1730,Argentina,A11,NA,NA,NA,NA
silence,326900,327210,310,Argentina,A11,NA,NA,NA,NA
silence,328490,329400,910,Argentina,A11,NA,NA,NA,NA
silence,331790,331800,10,Argentina,A11,NA,NA,NA,NA
silence,332400,332530,130,Argentina,A11,NA,NA,NA,NA
silence,333560,337130,3570,Argentina,A11,NA,NA,NA,NA
silence,340120,343120,3000,Argentina,A11,NA,NA,NA,NA
silence,344250,344890,640,Argentina,A11,NA,NA,NA,NA
silence,345850,345920,70,Argentina,A11,NA,NA,NA,NA
silence,346410,348760,2350,Argentina,A11,NA,NA,NA,NA
silence,349970,352450,2480,Argentina,A11,NA,NA,NA,NA
silence,358450,360440,1990,Argentina,A11,NA,NA,NA,NA
silence,361010,367245,6235,Argentina,A11,NA,NA,NA,NA
silence,368031,368160,129,Argentina,A11,NA,NA,NA,NA
silence,371530,372304,774,Argentina,A11,NA,NA,NA,NA
silence,373507,374300,793,Argentina,A11,NA,NA,NA,NA
silence,374890,375210,320,Argentina,A11,NA,NA,NA,NA
silence,376230,385950,9720,Argentina,A11,NA,NA,NA,NA
silence,387840,394900,7060,Argentina,A11,NA,NA,NA,NA
silence,395760,396483,723,Argentina,A11,NA,NA,NA,NA
silence,398757,402935,4178,Argentina,A11,NA,NA,NA,NA
silence,404090,444300,40210,Argentina,A11,NA,NA,NA,NA
father_gesture,445720,446904,1184,Argentina,A11,NA,NA,NA,NA
silence,446170,449190,3020,Argentina,A11,NA,NA,NA,NA
silence,450430,479630,29200,Argentina,A11,NA,NA,NA,NA
silence,480770,481100,330,Argentina,A11,NA,NA,NA,NA
silence,481880,484460,2580,Argentina,A11,NA,NA,NA,NA
silence,485320,486610,1290,Argentina,A11,NA,NA,NA,NA
silence,488940,492270,3330,Argentina,A11,NA,NA,NA,NA
silence,493090,493870,780,Argentina,A11,NA,NA,NA,NA
silence,494720,494740,20,Argentina,A11,NA,NA,NA,NA
silence,496000,496320,320,Argentina,A11,NA,NA,NA,NA
silence,497580,503570,5990,Argentina,A11,NA,NA,NA,NA
silence,505290,505626,336,Argentina,A11,NA,NA,NA,NA
silence,509550,511580,2030,Argentina,A11,NA,NA,NA,NA
silence,512290,513709,1419,Argentina,A11,NA,NA,NA,NA
silence,514923,516080,1157,Argentina,A11,NA,NA,NA,NA
silence,517870,518804,934,Argentina,A11,NA,NA,NA,NA
silence,522110,524670,2560,Argentina,A11,NA,NA,NA,NA
silence,527210,529460,2250,Argentina,A11,NA,NA,NA,NA
silence,530880,537330,6450,Argentina,A11,NA,NA,NA,NA
silence,539390,542160,2770,Argentina,A11,NA,NA,NA,NA
silence,546710,549930,3220,Argentina,A11,NA,NA,NA,NA
silence,551550,553930,2380,Argentina,A11,NA,NA,NA,NA
silence,554640,560490,5850,Argentina,A11,NA,NA,NA,NA
silence,561620,567078,5458,Argentina,A11,NA,NA,NA,NA
child_gesture,566745,568271,1526,Argentina,A11,NA,NA,NA,NA
silence,569040,571566,2526,Argentina,A11,NA,NA,NA,NA
silence,572620,573161,541,Argentina,A11,NA,NA,NA,NA
silence,576330,590680,14350,Argentina,A11,NA,NA,NA,NA
silence,593130,594610,1480,Argentina,A11,NA,NA,NA,NA
silence,595700,595911,211,Argentina,A11,NA,NA,NA,NA
child,6376,7310,934,Argentina,A12,m,1,1,a
mother,9501,10310,809,Argentina,A12,c,1,2,a
child,12935,16052,3117,Argentina,A12,m,2,1,a
mother,15427,16927,1500,Argentina,A12,c,2,2,i
father,17270,18480,1210,Argentina,A12,c,2,3,i
father,20854,21692,838,Argentina,A12,m,3,1,q
mother,25067,26148,1081,Argentina,A12,f,3,2,a
father,28251,28950,699,Argentina,A12,c,3,3,q
mother,29883,30641,758,Argentina,A12,f,3,4,a
child,32280,32935,655,Argentina,A12,b,3,5,a
mother,40148,41097,949,Argentina,A12,c,3,6,a
father,42545,43766,1221,Argentina,A12,m,4,1,q
mother,51626,52420,794,Argentina,A12,f,4,2,a
father,53317,54310,993,Argentina,A12,m,4,3,a
mother,58979,59920,941,Argentina,A12,f,4,4,a
father,61780,62641,861,Argentina,A12,m,4,5,a
mother,64552,65133,581,Argentina,A12,f,4,6,a
mother,43905,48192,4287,Argentina,A12,c,5,1,a
mother,73464,75427,1963,Argentina,A12,c,6,1,a
father,75457,78802,3345,Argentina,A12,c,6,2,a
child,76854,78780,1926,Argentina,A12,b,6,3,a
mother,85008,85773,765,Argentina,A12,c,6,4,a
child,95177,95861,684,Argentina,A12,b,7,1,a
mother,96214,104273,8059,Argentina,A12,c,7,2,i
mother,107795,109508,1713,Argentina,A12,c,7,3,q
child,110648,111883,1235,Argentina,A12,m,7,4,a
mother,112273,113523,1250,Argentina,A12,c,7,5,a
child,119288,120744,1456,Argentina,A12,m,7,6,a
mother,122214,127567,5353,Argentina,A12,c,7,7,a
child,126185,127817,1632,Argentina,A12,m,7,8,a
mother,131530,133825,2295,Argentina,A12,f,7,9,q
mother,136075,140604,4529,Argentina,A12,f,7,10,a
mother,144670,152950,8280,Argentina,A12,c,7,11,a
child,146244,146766,522,Argentina,A12,m,7,12,a
mother,156575,158472,1897,Argentina,A12,c,7,13,a
mother,168722,169464,742,Argentina,A12,c,8,1,a
child,169082,170288,1206,Argentina,A12,m,8,2,a
mother,179685,180700,1015,Argentina,A12,c,9,1,a
mother,183111,183972,861,Argentina,A12,c,9,2,a
mother,203030,204207,1177,Argentina,A12,c,9,3,a
child,213883,215383,1500,Argentina,A12,f,10,1,a
father,215597,216302,705,Argentina,A12,c,10,2,a
child,217369,218986,1617,Argentina,A12,f,10,3,a
mother,217457,218663,1206,Argentina,A12,c,10,4,a
father,218942,220214,1272,Argentina,A12,c,10,5,q
child,220552,221214,662,Argentina,A12,f,10,6,a
mother,243825,244861,1036,Argentina,A12,f,11,1,q
father,245472,246192,720,Argentina,A12,m,11,2,a
mother,249251,249920,669,Argentina,A12,f,11,3,a
father,253185,254383,1198,Argentina,A12,m,11,4,q
mother,264604,267788,3184,Argentina,A12,f,12,1,a
father,272832,276655,3823,Argentina,A12,m,12,2,a
mother,277670,278950,1280,Argentina,A12,f,12,3,a
mother,283163,284435,1272,Argentina,A12,f,12,4,a
father,284391,285001,610,Argentina,A12,m,12,5,a
father,293052,294155,1103,Argentina,A12,m,12,6,a
father,299883,304097,4214,Argentina,A12,m,12,7,a
child,269876,270575,699,Argentina,A12,m,13,1,a
mother,270685,273280,2595,Argentina,A12,c,13,2,a
mother,292405,293369,964,Argentina,A12,c,14,1,a
child,310714,311391,677,Argentina,A12,m,15,1,a
mother,320001,321391,1390,Argentina,A12,c,15,2,a
father,315589,316722,1133,Argentina,A12,m,16,1,a
father,319736,320825,1089,Argentina,A12,m,16,2,a
child,325060,326045,985,Argentina,A12,m,17,1,a
child,328258,329104,846,Argentina,A12,m,17,2,a
child,331501,336486,4985,Argentina,A12,m,17,3,a
mother,335133,338089,2956,Argentina,A12,c,17,4,a
child,338486,339722,1236,Argentina,A12,b,17,5,a
father,339847,341045,1198,Argentina,A12,c,17,6,q
child,340869,344361,3492,Argentina,A12,f,17,7,a
father,345325,346744,1419,Argentina,A12,m,17,8,a
mother,348104,348677,573,Argentina,A12,f,17,9,a
father,356655,357773,1118,Argentina,A12,b,17,10,a
mother,360626,363405,2779,Argentina,A12,c,17,11,a
child,362950,365369,2419,Argentina,A12,m,17,12,a
father,366354,371023,4669,Argentina,A12,m,17,13,a
child,368302,368935,633,Argentina,A12,f,17,14,a
mother,372405,378545,6140,Argentina,A12,f,17,15,a
mother,381854,382854,1000,Argentina,A12,b,17,16,a
father,383464,386126,2662,Argentina,A12,m,17,17,a
father,389030,394589,5559,Argentina,A12,m,17,18,a
mother,392104,394567,2463,Argentina,A12,f,17,19,a
mother,403266,403751,485,Argentina,A12,f,17,20,a
father,412589,414273,1684,Argentina,A12,m,17,21,a
mother,413780,418016,4236,Argentina,A12,c,17,22,a
mother,428347,428994,647,Argentina,A12,b,18,1,a
child,430317,431030,713,Argentina,A12,m,19,1,a
child,435347,439633,4286,Argentina,A12,f,19,2,a
mother,439847,440920,1073,Argentina,A12,c,19,3,q
child,441508,442089,581,Argentina,A12,f,19,4,a
mother,442523,445295,2772,Argentina,A12,c,19,5,q
child,443847,445839,1992,Argentina,A12,m,19,6,a
child,450052,451067,1015,Argentina,A12,b,19,7,a
father,450457,451810,1353,Argentina,A12,c,19,8,a
mother,462420,463141,721,Argentina,A12,c,20,1,a
father,463097,465251,2154,Argentina,A12,c,20,2,a
father,467766,468663,897,Argentina,A12,c,20,3,a
mother,468663,470008,1345,Argentina,A12,b,20,4,a
father,470920,473898,2978,Argentina,A12,c,20,5,i
mother,478766,479420,654,Argentina,A12,c,20,6,a
child,480244,482994,2750,Argentina,A12,m,20,7,a
mother,482126,483450,1324,Argentina,A12,c,20,8,a
child,483920,487185,3265,Argentina,A12,f,20,9,a
mother,487177,488685,1508,Argentina,A12,c,20,10,i
child,488861,489427,566,Argentina,A12,m,20,11,a
mother,489575,490141,566,Argentina,A12,c,20,12,a
mother,501104,504964,3860,Argentina,A12,c,21,1,a
mother,508567,509545,978,Argentina,A12,b,21,2,a
mother,515986,518655,2669,Argentina,A12,c,21,3,a
mother,521486,525582,4096,Argentina,A12,c,21,4,a
child,524133,527030,2897,Argentina,A12,m,21,5,a
mother,526972,527663,691,Argentina,A12,c,21,6,a
child,527802,528729,927,Argentina,A12,b,21,7,a
mother,529030,530413,1383,Argentina,A12,c,21,8,a
child,529986,534376,4390,Argentina,A12,b,21,9,a
father,545641,546325,684,Argentina,A12,c,22,1,a
mother,550119,550898,779,Argentina,A12,c,22,2,i
father,552089,552810,721,Argentina,A12,c,22,3,a
mother,560170,561383,1213,Argentina,A12,c,22,4,a
child,554523,555464,941,Argentina,A12,b,23,1,a
mother,565398,566435,1037,Argentina,A12,c,23,2,a
child,565677,566376,699,Argentina,A12,m,23,3,a
father,566486,567258,772,Argentina,A12,b,23,4,a
mother,566950,569119,2169,Argentina,A12,c,23,5,a
child,567508,568714,1206,Argentina,A12,m,23,6,a
father,570545,571082,537,Argentina,A12,c,23,7,a
child,571876,576876,5000,Argentina,A12,b,23,8,a
mother,575236,579677,4441,Argentina,A12,c,23,9,a
child,581030,582604,1574,Argentina,A12,m,23,10,a
father,581597,581942,345,Argentina,A12,c,23,11,a
mother,582486,583082,596,Argentina,A12,c,23,12,a
father,585016,585780,764,Argentina,A12,b,23,13,a
mother,593001,595126,2125,Argentina,A12,c,24,1,a
mother,598354,599133,779,Argentina,A12,c,24,2,a
silence,7310,9501,2191,Argentina,A12,NA,NA,NA,NA
silence,10310,12935,2625,Argentina,A12,NA,NA,NA,NA
child_gesture,12920,14100,1180,Argentina,A12,NA,NA,NA,NA
mother_gesture,15055,16645,1590,Argentina,A12,NA,NA,NA,NA
silence,16927,17270,343,Argentina,A12,NA,NA,NA,NA
silence,18480,20854,2374,Argentina,A12,NA,NA,NA,NA
silence,21692,25067,3375,Argentina,A12,NA,NA,NA,NA
silence,26148,28251,2103,Argentina,A12,NA,NA,NA,NA
silence,28950,29883,933,Argentina,A12,NA,NA,NA,NA
mother_gesture,29601,30771,1170,Argentina,A12,NA,NA,NA,NA
silence,30641,32280,1639,Argentina,A12,NA,NA,NA,NA
silence,32935,40148,7213,Argentina,A12,NA,NA,NA,NA
silence,41097,42545,1448,Argentina,A12,NA,NA,NA,NA
silence,43766,43905,139,Argentina,A12,NA,NA,NA,NA
silence,48192,51626,3434,Argentina,A12,NA,NA,NA,NA
silence,52420,53317,897,Argentina,A12,NA,NA,NA,NA
silence,54310,58979,4669,Argentina,A12,NA,NA,NA,NA
silence,59920,61780,1860,Argentina,A12,NA,NA,NA,NA
silence,62641,64552,1911,Argentina,A12,NA,NA,NA,NA
silence,65133,73464,8331,Argentina,A12,NA,NA,NA,NA
silence,75427,75457,30,Argentina,A12,NA,NA,NA,NA
silence,78802,85008,6206,Argentina,A12,NA,NA,NA,NA
silence,85773,95177,9404,Argentina,A12,NA,NA,NA,NA
silence,95861,96214,353,Argentina,A12,NA,NA,NA,NA
silence,104273,107795,3522,Argentina,A12,NA,NA,NA,NA
silence,109508,110648,1140,Argentina,A12,NA,NA,NA,NA
silence,111883,112273,390,Argentina,A12,NA,NA,NA,NA
silence,113523,119288,5765,Argentina,A12,NA,NA,NA,NA
silence,120744,122214,1470,Argentina,A12,NA,NA,NA,NA
silence,127817,131530,3713,Argentina,A12,NA,NA,NA,NA
silence,133825,136075,2250,Argentina,A12,NA,NA,NA,NA
silence,140604,144670,4066,Argentina,A12,NA,NA,NA,NA
silence,152950,156575,3625,Argentina,A12,NA,NA,NA,NA
mother_gesture,155990,157671,1681,Argentina,A12,NA,NA,NA,NA
silence,158472,168722,10250,Argentina,A12,NA,NA,NA,NA
silence,170288,179685,9397,Argentina,A12,NA,NA,NA,NA
silence,180700,183111,2411,Argentina,A12,NA,NA,NA,NA
silence,183972,203030,19058,Argentina,A12,NA,NA,NA,NA
silence,204207,213883,9676,Argentina,A12,NA,NA,NA,NA
silence,215383,215597,214,Argentina,A12,NA,NA,NA,NA
silence,216302,217369,1067,Argentina,A12,NA,NA,NA,NA
child_gesture,217020,219751,2731,Argentina,A12,NA,NA,NA,NA
silence,220214,220552,338,Argentina,A12,NA,NA,NA,NA
silence,221214,243825,22611,Argentina,A12,NA,NA,NA,NA
mother_gesture,242918,245016,2098,Argentina,A12,NA,NA,NA,NA
silence,244861,245472,611,Argentina,A12,NA,NA,NA,NA
silence,246192,249251,3059,Argentina,A12,NA,NA,NA,NA
silence,249920,253185,3265,Argentina,A12,NA,NA,NA,NA
silence,254383,264604,10221,Argentina,A12,NA,NA,NA,NA
mother_gesture,264920,267060,2140,Argentina,A12,NA,NA,NA,NA
silence,267788,269876,2088,Argentina,A12,NA,NA,NA,NA
silence,270575,270685,110,Argentina,A12,NA,NA,NA,NA
silence,276655,277670,1015,Argentina,A12,NA,NA,NA,NA
silence,278950,283163,4213,Argentina,A12,NA,NA,NA,NA
father_gesture,280360,282589,2229,Argentina,A12,NA,NA,NA,NA
mother_gesture,283287,284936,1649,Argentina,A12,NA,NA,NA,NA
silence,285001,292405,7404,Argentina,A12,NA,NA,NA,NA
silence,294155,299883,5728,Argentina,A12,NA,NA,NA,NA
silence,304097,310714,6617,Argentina,A12,NA,NA,NA,NA
silence,311391,315589,4198,Argentina,A12,NA,NA,NA,NA
silence,316722,319736,3014,Argentina,A12,NA,NA,NA,NA
silence,321391,325060,3669,Argentina,A12,NA,NA,NA,NA
child_gesture,324834,326574,1740,Argentina,A12,NA,NA,NA,NA
silence,326045,328258,2213,Argentina,A12,NA,NA,NA,NA
child_gesture,328915,333570,4655,Argentina,A12,NA,NA,NA,NA
silence,329104,331501,2397,Argentina,A12,NA,NA,NA,NA
child_gesture,334139,335478,1339,Argentina,A12,NA,NA,NA,NA
silence,338089,338486,397,Argentina,A12,NA,NA,NA,NA
silence,339722,339847,125,Argentina,A12,NA,NA,NA,NA
silence,344361,345325,964,Argentina,A12,NA,NA,NA,NA
silence,346744,348104,1360,Argentina,A12,NA,NA,NA,NA
silence,348677,356655,7978,Argentina,A12,NA,NA,NA,NA
silence,357773,360626,2853,Argentina,A12,NA,NA,NA,NA
child_gesture,359267,362423,3156,Argentina,A12,NA,NA,NA,NA
child_gesture,362903,365004,2101,Argentina,A12,NA,NA,NA,NA
silence,365369,366354,985,Argentina,A12,NA,NA,NA,NA
silence,371023,372405,1382,Argentina,A12,NA,NA,NA,NA
mother_gesture,375090,378728,3638,Argentina,A12,NA,NA,NA,NA
silence,378545,381854,3309,Argentina,A12,NA,NA,NA,NA
silence,382854,383464,610,Argentina,A12,NA,NA,NA,NA
silence,386126,389030,2904,Argentina,A12,NA,NA,NA,NA
silence,394589,403266,8677,Argentina,A12,NA,NA,NA,NA
silence,403751,412589,8838,Argentina,A12,NA,NA,NA,NA
silence,418016,428347,10331,Argentina,A12,NA,NA,NA,NA
silence,428994,430317,1323,Argentina,A12,NA,NA,NA,NA
silence,431030,435347,4317,Argentina,A12,NA,NA,NA,NA
silence,439633,439847,214,Argentina,A12,NA,NA,NA,NA
silence,440920,441508,588,Argentina,A12,NA,NA,NA,NA
silence,442089,442523,434,Argentina,A12,NA,NA,NA,NA
silence,445839,450052,4213,Argentina,A12,NA,NA,NA,NA
child_gesture,449958,451497,1539,Argentina,A12,NA,NA,NA,NA
silence,451810,462420,10610,Argentina,A12,NA,NA,NA,NA
silence,465251,467766,2515,Argentina,A12,NA,NA,NA,NA
silence,470008,470920,912,Argentina,A12,NA,NA,NA,NA
silence,473898,478766,4868,Argentina,A12,NA,NA,NA,NA
silence,479420,480244,824,Argentina,A12,NA,NA,NA,NA
silence,483450,483920,470,Argentina,A12,NA,NA,NA,NA
silence,488685,488861,176,Argentina,A12,NA,NA,NA,NA
silence,489427,489575,148,Argentina,A12,NA,NA,NA,NA
silence,490141,501104,10963,Argentina,A12,NA,NA,NA,NA
silence,504964,508567,3603,Argentina,A12,NA,NA,NA,NA
silence,509545,515986,6441,Argentina,A12,NA,NA,NA,NA
silence,518655,521486,2831,Argentina,A12,NA,NA,NA,NA
silence,527663,527802,139,Argentina,A12,NA,NA,NA,NA
silence,528729,529030,301,Argentina,A12,NA,NA,NA,NA
silence,534376,545641,11265,Argentina,A12,NA,NA,NA,NA
silence,546325,550119,3794,Argentina,A12,NA,NA,NA,NA
silence,550898,552089,1191,Argentina,A12,NA,NA,NA,NA
silence,552810,554523,1713,Argentina,A12,NA,NA,NA,NA
silence,555464,560170,4706,Argentina,A12,NA,NA,NA,NA
silence,561383,565398,4015,Argentina,A12,NA,NA,NA,NA
child_gesture,565773,566631,858,Argentina,A12,NA,NA,NA,NA
silence,566435,566486,51,Argentina,A12,NA,NA,NA,NA
silence,569119,570545,1426,Argentina,A12,NA,NA,NA,NA
silence,571082,571876,794,Argentina,A12,NA,NA,NA,NA
child_gesture,573506,576690,3184,Argentina,A12,NA,NA,NA,NA
silence,579677,581030,1353,Argentina,A12,NA,NA,NA,NA
child_gesture,581928,583405,1477,Argentina,A12,NA,NA,NA,NA
silence,583082,585016,1934,Argentina,A12,NA,NA,NA,NA
silence,585780,593001,7221,Argentina,A12,NA,NA,NA,NA
silence,595126,598354,3228,Argentina,A12,NA,NA,NA,NA
mother,3220,3970,750,Argentina,A13,f,1,1,q
father,3970,4600,630,Argentina,A13,m,1,2,a
mother,5250,6570,1320,Argentina,A13,f,1,3,q
father,7100,8040,940,Argentina,A13,m,1,4,a
mother,8960,11890,2930,Argentina,A13,f,1,5,a
father,12430,14040,1610,Argentina,A13,m,1,6,a
mother,14930,16050,1120,Argentina,A13,f,2,1,a
father,16640,26200,9560,Argentina,A13,m,2,2,a
child,16120,17140,1020,Argentina,A13,b,3,1,a
child,25700,29580,3880,Argentina,A13,f,4,1,a
father,28100,29760,1660,Argentina,A13,c,4,2,a
father,32000,35590,3590,Argentina,A13,c,4,3,a
mother,30670,31980,1310,Argentina,A13,c,5,1,a
father,36890,56570,19680,Argentina,A13,b,6,1,a
father,58120,65190,7070,Argentina,A13,b,6,2,a
child,55060,58880,3820,Argentina,A13,m,7,1,a
child,65990,70090,4100,Argentina,A13,f,7,2,a
child,80030,82880,2850,Argentina,A13,b,7,3,a
mother,84715,88737,4022,Argentina,A13,c,7,4,a
child,91780,92630,850,Argentina,A13,m,7,5,q
mother,92730,93810,1080,Argentina,A13,c,7,6,a
child,94980,95610,630,Argentina,A13,m,7,7,q
mother,95630,97830,2200,Argentina,A13,c,7,8,a
child,107940,113050,5110,Argentina,A13,m,7,9,q
mother,114750,119300,4550,Argentina,A13,c,7,10,i
father,118630,124610,5980,Argentina,A13,c,7,11,a
mother,125180,128630,3450,Argentina,A13,c,7,12,a
mother,135800,139610,3810,Argentina,A13,c,7,13,q
child,139740,140380,640,Argentina,A13,m,7,14,a
mother,140280,141600,1320,Argentina,A13,c,7,15,q
child,142070,149340,7270,Argentina,A13,m,7,16,a
mother,149390,151230,1840,Argentina,A13,c,7,17,a
child,160590,162140,1550,Argentina,A13,m,7,18,a
child,168790,174260,5470,Argentina,A13,m,7,19,a
child,175030,176000,970,Argentina,A13,m,7,20,a
mother,176120,177090,970,Argentina,A13,c,7,21,a
child,177050,181440,4390,Argentina,A13,m,7,22,a
mother,178550,179600,1050,Argentina,A13,c,7,23,a
mother,181150,193360,12210,Argentina,A13,c,7,24,a
child,200940,201910,970,Argentina,A13,m,7,25,q
mother,202350,203290,940,Argentina,A13,c,7,26,q
child,205150,208400,3250,Argentina,A13,m,7,27,a
mother,208880,209850,970,Argentina,A13,c,7,28,q
child,210560,212250,1690,Argentina,A13,m,7,29,a
child,216360,223350,6990,Argentina,A13,m,7,30,a
mother,221730,222930,1200,Argentina,A13,c,7,31,a
father,224290,224900,610,Argentina,A13,m,7,32,q
child,224370,225780,1410,Argentina,A13,m,7,33,a
mother,226590,228270,1680,Argentina,A13,c,7,34,q
child,228240,228900,660,Argentina,A13,m,7,35,a
mother,228880,229750,870,Argentina,A13,c,7,36,q
mother,70950,78230,7280,Argentina,A13,o,8,1,a
mother,81910,84548,2638,Argentina,A13,o,8,2,a
father,161650,164320,2670,Argentina,A13,o,9,1,i
father,170920,172710,1790,Argentina,A13,m,10,1,a
father,175360,176390,1030,Argentina,A13,m,10,2,q
father,176910,180060,3150,Argentina,A13,m,10,3,q
mother,179840,180360,520,Argentina,A13,f,10,4,a
mother,213030,216880,3850,Argentina,A13,o,11,1,i
father,232980,236450,3470,Argentina,A13,b,12,1,a
father,259860,262010,2150,Argentina,A13,m,13,1,a
father,264340,266960,2620,Argentina,A13,m,13,2,a
child,260240,262970,2730,Argentina,A13,m,14,1,a
child,269660,271280,1620,Argentina,A13,m,14,2,a
mother,272720,276870,4150,Argentina,A13,c,14,3,q
child,274720,275360,640,Argentina,A13,m,14,4,a
child,284960,285740,780,Argentina,A13,m,14,5,a
child,290480,292300,1820,Argentina,A13,m,14,6,a
child,293330,301370,8040,Argentina,A13,m,14,7,a
child,303720,304300,580,Argentina,A13,m,14,8,a
child,310040,314000,3960,Argentina,A13,f,14,9,a
mother,313570,314380,810,Argentina,A13,c,14,10,a
child,314820,316640,1820,Argentina,A13,f,14,11,a
father,316110,320130,4020,Argentina,A13,c,14,12,a
child,320290,320740,450,Argentina,A13,f,14,13,a
father,321240,327950,6710,Argentina,A13,c,14,14,a
child,327420,328190,770,Argentina,A13,m,14,15,q
father,292130,293080,950,Argentina,A13,b,15,1,a
father,294290,301590,7300,Argentina,A13,m,16,1,q
child,330020,330990,970,Argentina,A13,m,16,2,a
father,331160,335140,3980,Argentina,A13,m,17,1,a
mother,332370,335450,3080,Argentina,A13,b,18,1,a
child,335270,336660,1390,Argentina,A13,m,18,2,a
father,336620,338220,1600,Argentina,A13,m,18,3,q
mother,338830,339350,520,Argentina,A13,f,18,4,a
father,340920,341920,1000,Argentina,A13,m,18,5,a
father,344000,345870,1870,Argentina,A13,m,18,6,a
mother,347700,349210,1510,Argentina,A13,f,18,7,a
father,350060,351510,1450,Argentina,A13,m,18,8,q
mother,350900,362260,11360,Argentina,A13,f,18,9,a
father,358760,368000,9240,Argentina,A13,m,18,10,a
father,371590,375480,3890,Argentina,A13,m,18,11,a
mother,375000,378690,3690,Argentina,A13,f,18,12,a
father,379190,382160,2970,Argentina,A13,m,18,13,a
mother,382610,383520,910,Argentina,A13,f,18,14,a
father,383230,392340,9110,Argentina,A13,m,18,15,a
father,393920,400550,6630,Argentina,A13,m,18,16,a
child,340370,343650,3280,Argentina,A13,b,19,1,a
mother,343700,344260,560,Argentina,A13,c,19,2,a
child,344850,346250,1400,Argentina,A13,m,19,3,a
child,351460,353210,1750,Argentina,A13,b,20,1,a
child,366950,369550,2600,Argentina,A13,m,20,2,a
child,372910,373890,980,Argentina,A13,b,21,1,a
child,388720,396520,7800,Argentina,A13,o,22,1,a
child,399500,401370,1870,Argentina,A13,m,23,1,a
mother,401160,402150,990,Argentina,A13,c,23,2,q
child,401800,403880,2080,Argentina,A13,m,23,3,a
mother,403410,404130,720,Argentina,A13,c,23,4,q
child,404350,407830,3480,Argentina,A13,m,23,5,a
father,408540,416320,7780,Argentina,A13,c,23,6,a
child,416010,416780,770,Argentina,A13,f,23,7,a
father,416840,419230,2390,Argentina,A13,c,23,8,a
child,417650,420490,2840,Argentina,A13,f,23,9,a
father,419840,425150,5310,Argentina,A13,c,23,10,a
child,434300,435250,950,Argentina,A13,f,23,11,a
father,435600,438880,3280,Argentina,A13,c,23,12,a
father,439520,448330,8810,Argentina,A13,c,24,1,a
child,448560,449580,1020,Argentina,A13,f,24,2,a
father,449910,450610,700,Argentina,A13,c,24,3,q
child,450870,453910,3040,Argentina,A13,f,24,4,a
mother,451780,453650,1870,Argentina,A13,f,25,1,a
father,454720,455290,570,Argentina,A13,m,25,2,q
mother,455380,456230,850,Argentina,A13,f,25,3,a
father,456590,464330,7740,Argentina,A13,m,25,4,a
mother,464330,465900,1570,Argentina,A13,f,25,5,a
father,466650,468160,1510,Argentina,A13,m,25,6,a
mother,469040,472600,3560,Argentina,A13,f,25,7,a
father,478480,481710,3230,Argentina,A13,m,25,8,a
child,472890,480960,8070,Argentina,A13,b,26,1,a
mother,481790,482780,990,Argentina,A13,c,26,2,q
child,483280,484180,900,Argentina,A13,m,26,3,a
child,485300,494090,8790,Argentina,A13,m,26,4,a
mother,485410,486290,880,Argentina,A13,c,26,5,q
father,482550,483890,1340,Argentina,A13,m,27,1,i
father,484180,485320,1140,Argentina,A13,m,27,2,q
mother,486810,488320,1510,Argentina,A13,f,27,3,q
father,488940,489540,600,Argentina,A13,m,27,4,a
mother,490310,491500,1190,Argentina,A13,f,27,5,a
mother,495140,499560,4420,Argentina,A13,c,28,1,q
child,497520,500540,3020,Argentina,A13,m,28,2,a
mother,500670,501860,1190,Argentina,A13,c,28,3,q
child,501790,504660,2870,Argentina,A13,m,28,4,a
child,511220,519850,8630,Argentina,A13,m,28,5,a
mother,520390,521110,720,Argentina,A13,c,28,6,q
child,521130,521690,560,Argentina,A13,m,28,7,a
mother,521750,522400,650,Argentina,A13,c,28,8,a
child,523610,524510,900,Argentina,A13,m,28,9,a
mother,524830,526250,1420,Argentina,A13,c,28,10,q
child,526240,526680,440,Argentina,A13,m,28,11,a
mother,526640,527490,850,Argentina,A13,c,28,12,i
father,503820,508340,4520,Argentina,A13,m,29,1,a
father,513820,515330,1510,Argentina,A13,m,29,2,a
father,528150,532770,4620,Argentina,A13,c,30,1,q
father,537390,546730,9340,Argentina,A13,c,31,1,a
child,543110,544280,1170,Argentina,A13,f,31,2,a
father,548910,553410,4500,Argentina,A13,c,31,3,q
mother,553380,554490,1110,Argentina,A13,f,31,4,i
father,555300,571580,16280,Argentina,A13,m,31,5,a
child,571960,573030,1070,Argentina,A13,b,32,1,a
mother,576690,580210,3520,Argentina,A13,c,33,1,i
father,578410,584340,5930,Argentina,A13,c,33,2,i
mother,581560,584950,3390,Argentina,A13,c,33,3,i
father,585070,587810,2740,Argentina,A13,b,33,4,a
mother,593250,594380,1130,Argentina,A13,f,33,5,a
silence,4600,5250,650,Argentina,A13,NA,NA,NA,NA
silence,6570,7100,530,Argentina,A13,NA,NA,NA,NA
silence,8040,8960,920,Argentina,A13,NA,NA,NA,NA
silence,11890,12430,540,Argentina,A13,NA,NA,NA,NA
father_gesture,12507,13939,1432,Argentina,A13,NA,NA,NA,NA
silence,14040,14930,890,Argentina,A13,NA,NA,NA,NA
silence,16050,16120,70,Argentina,A13,NA,NA,NA,NA
father_gesture,23550,25013,1463,Argentina,A13,NA,NA,NA,NA
silence,29760,30670,910,Argentina,A13,NA,NA,NA,NA
silence,31980,32000,20,Argentina,A13,NA,NA,NA,NA
father_gesture,32380,34128,1748,Argentina,A13,NA,NA,NA,NA
silence,35590,36890,1300,Argentina,A13,NA,NA,NA,NA
father_gesture,36600,38246,1646,Argentina,A13,NA,NA,NA,NA
father_gesture,59700,60729,1029,Argentina,A13,NA,NA,NA,NA
silence,65190,65990,800,Argentina,A13,NA,NA,NA,NA
child_gesture,66718,67827,1109,Argentina,A13,NA,NA,NA,NA
silence,70090,70950,860,Argentina,A13,NA,NA,NA,NA
silence,78230,80030,1800,Argentina,A13,NA,NA,NA,NA
silence,84548,84715,167,Argentina,A13,NA,NA,NA,NA
silence,88737,91780,3043,Argentina,A13,NA,NA,NA,NA
silence,92630,92730,100,Argentina,A13,NA,NA,NA,NA
silence,93810,94980,1170,Argentina,A13,NA,NA,NA,NA
silence,95610,95630,20,Argentina,A13,NA,NA,NA,NA
mother_gesture,96495,98355,1860,Argentina,A13,NA,NA,NA,NA
silence,97830,107940,10110,Argentina,A13,NA,NA,NA,NA
child_gesture,107760,110027,2267,Argentina,A13,NA,NA,NA,NA
silence,113050,114750,1700,Argentina,A13,NA,NA,NA,NA
silence,124610,125180,570,Argentina,A13,NA,NA,NA,NA
silence,128630,135800,7170,Argentina,A13,NA,NA,NA,NA
mother_gesture,135390,136762,1372,Argentina,A13,NA,NA,NA,NA
silence,139610,139740,130,Argentina,A13,NA,NA,NA,NA
silence,141600,142070,470,Argentina,A13,NA,NA,NA,NA
child_gesture,144475,145825,1350,Argentina,A13,NA,NA,NA,NA
child_gesture,147835,148856,1021,Argentina,A13,NA,NA,NA,NA
silence,149340,149390,50,Argentina,A13,NA,NA,NA,NA
silence,151230,160590,9360,Argentina,A13,NA,NA,NA,NA
child_gesture,161121,162768,1647,Argentina,A13,NA,NA,NA,NA
silence,164320,168790,4470,Argentina,A13,NA,NA,NA,NA
child_gesture,172450,173630,1180,Argentina,A13,NA,NA,NA,NA
silence,174260,175030,770,Argentina,A13,NA,NA,NA,NA
mother_gesture,190587,191937,1350,Argentina,A13,NA,NA,NA,NA
silence,193360,200940,7580,Argentina,A13,NA,NA,NA,NA
silence,201910,202350,440,Argentina,A13,NA,NA,NA,NA
silence,203290,205150,1860,Argentina,A13,NA,NA,NA,NA
silence,208400,208880,480,Argentina,A13,NA,NA,NA,NA
silence,209850,210560,710,Argentina,A13,NA,NA,NA,NA
silence,212250,213030,780,Argentina,A13,NA,NA,NA,NA
silence,223350,224290,940,Argentina,A13,NA,NA,NA,NA
silence,225780,226590,810,Argentina,A13,NA,NA,NA,NA
silence,229750,232980,3230,Argentina,A13,NA,NA,NA,NA
silence,236450,259860,23410,Argentina,A13,NA,NA,NA,NA
silence,262970,264340,1370,Argentina,A13,NA,NA,NA,NA
silence,266960,269660,2700,Argentina,A13,NA,NA,NA,NA
child_gesture,269618,271501,1883,Argentina,A13,NA,NA,NA,NA
silence,271280,272720,1440,Argentina,A13,NA,NA,NA,NA
silence,276870,284960,8090,Argentina,A13,NA,NA,NA,NA
silence,285740,290480,4740,Argentina,A13,NA,NA,NA,NA
silence,293080,293330,250,Argentina,A13,NA,NA,NA,NA
silence,301590,303720,2130,Argentina,A13,NA,NA,NA,NA
silence,304300,310040,5740,Argentina,A13,NA,NA,NA,NA
child_gesture,310243,311450,1207,Argentina,A13,NA,NA,NA,NA
child_gesture,313499,314399,900,Argentina,A13,NA,NA,NA,NA
silence,314380,314820,440,Argentina,A13,NA,NA,NA,NA
father_gesture,318972,320463,1491,Argentina,A13,NA,NA,NA,NA
silence,320130,320290,160,Argentina,A13,NA,NA,NA,NA
silence,320740,321240,500,Argentina,A13,NA,NA,NA,NA
father_gesture,322821,324398,1577,Argentina,A13,NA,NA,NA,NA
silence,328190,330020,1830,Argentina,A13,NA,NA,NA,NA
silence,330990,331160,170,Argentina,A13,NA,NA,NA,NA
father_gesture,336580,338166,1586,Argentina,A13,NA,NA,NA,NA
silence,338220,338830,610,Argentina,A13,NA,NA,NA,NA
silence,339350,340370,1020,Argentina,A13,NA,NA,NA,NA
silence,343650,343700,50,Argentina,A13,NA,NA,NA,NA
silence,346250,347700,1450,Argentina,A13,NA,NA,NA,NA
silence,349210,350060,850,Argentina,A13,NA,NA,NA,NA
silence,369550,371590,2040,Argentina,A13,NA,NA,NA,NA
mother_gesture,376735,378963,2228,Argentina,A13,NA,NA,NA,NA
silence,378690,379190,500,Argentina,A13,NA,NA,NA,NA
father_gesture,379430,380492,1062,Argentina,A13,NA,NA,NA,NA
father_gesture,381150,382261,1111,Argentina,A13,NA,NA,NA,NA
silence,382160,382610,450,Argentina,A13,NA,NA,NA,NA
father_gesture,383890,385835,1945,Argentina,A13,NA,NA,NA,NA
father_gesture,389160,390524,1364,Argentina,A13,NA,NA,NA,NA
child_gesture,401961,403515,1554,Argentina,A13,NA,NA,NA,NA
silence,404130,404350,220,Argentina,A13,NA,NA,NA,NA
child_gesture,406400,408070,1670,Argentina,A13,NA,NA,NA,NA
silence,407830,408540,710,Argentina,A13,NA,NA,NA,NA
silence,416780,416840,60,Argentina,A13,NA,NA,NA,NA
silence,425150,434300,9150,Argentina,A13,NA,NA,NA,NA
silence,435250,435600,350,Argentina,A13,NA,NA,NA,NA
silence,438880,439520,640,Argentina,A13,NA,NA,NA,NA
silence,448330,448560,230,Argentina,A13,NA,NA,NA,NA
silence,449580,449910,330,Argentina,A13,NA,NA,NA,NA
silence,450610,450870,260,Argentina,A13,NA,NA,NA,NA
silence,453910,454720,810,Argentina,A13,NA,NA,NA,NA
mother_gesture,455050,456465,1415,Argentina,A13,NA,NA,NA,NA
silence,455290,455380,90,Argentina,A13,NA,NA,NA,NA
silence,456230,456590,360,Argentina,A13,NA,NA,NA,NA
silence,465900,466650,750,Argentina,A13,NA,NA,NA,NA
silence,468160,469040,880,Argentina,A13,NA,NA,NA,NA
silence,472600,472890,290,Argentina,A13,NA,NA,NA,NA
child_gesture,472967,474309,1342,Argentina,A13,NA,NA,NA,NA
silence,481710,481790,80,Argentina,A13,NA,NA,NA,NA
father_gesture,482902,484566,1664,Argentina,A13,NA,NA,NA,NA
silence,494090,495140,1050,Argentina,A13,NA,NA,NA,NA
silence,500540,500670,130,Argentina,A13,NA,NA,NA,NA
silence,508340,511220,2880,Argentina,A13,NA,NA,NA,NA
silence,519850,520390,540,Argentina,A13,NA,NA,NA,NA
silence,521110,521130,20,Argentina,A13,NA,NA,NA,NA
silence,521690,521750,60,Argentina,A13,NA,NA,NA,NA
silence,522400,523610,1210,Argentina,A13,NA,NA,NA,NA
silence,524510,524830,320,Argentina,A13,NA,NA,NA,NA
mother_gesture,525356,526800,1444,Argentina,A13,NA,NA,NA,NA
mother_gesture,526850,528871,2021,Argentina,A13,NA,NA,NA,NA
silence,527490,528150,660,Argentina,A13,NA,NA,NA,NA
silence,532770,537390,4620,Argentina,A13,NA,NA,NA,NA
silence,546730,548910,2180,Argentina,A13,NA,NA,NA,NA
silence,554490,555300,810,Argentina,A13,NA,NA,NA,NA
silence,571580,571960,380,Argentina,A13,NA,NA,NA,NA
silence,573030,576690,3660,Argentina,A13,NA,NA,NA,NA
silence,584950,585070,120,Argentina,A13,NA,NA,NA,NA
silence,587810,593250,5440,Argentina,A13,NA,NA,NA,NA
father,830,2360,1530,Argentina,A14,m,1,1,a
mother,13620,14940,1320,Argentina,A14,f,2,1,q
mother,21520,23100,1580,Argentina,A14,f,2,2,q
father,23250,23800,550,Argentina,A14,m,2,3,a
mother,32790,35210,2420,Argentina,A14,f,2,4,a
father,36360,37930,1570,Argentina,A14,m,2,5,a
mother,37970,38680,710,Argentina,A14,f,2,6,a
mother,55130,58400,3270,Argentina,A14,f,4,1,q
father,58590,59550,960,Argentina,A14,m,4,2,a
mother,61080,61950,870,Argentina,A14,f,4,3,a
child,93510,94250,740,Argentina,A14,m,5,1,q
mother,110670,112550,1880,Argentina,A14,f,6,1,q
mother,115990,120040,4050,Argentina,A14,f,6,2,q
father,121190,122220,1030,Argentina,A14,m,6,3,a
mother,122570,127470,4900,Argentina,A14,f,6,4,a
mother,156100,161430,5330,Argentina,A14,c,7,1,a
father,165470,166420,950,Argentina,A14,c,7,2,i
child,197520,198470,950,Argentina,A14,b,8,1,a
child,218290,218800,510,Argentina,A14,f,9,1,a
father,222450,223210,760,Argentina,A14,c,9,2,q
child,225830,226430,600,Argentina,A14,f,9,3,a
child,230040,231520,1480,Argentina,A14,f,10,1,a
father,231750,232490,740,Argentina,A14,c,10,2,q
mother,238970,240280,1310,Argentina,A14,f,11,1,a
child,246590,247280,690,Argentina,A14,m,12,1,a
mother,247320,247940,620,Argentina,A14,c,12,2,a
child,248640,251120,2480,Argentina,A14,b,13,1,a
father,288220,289410,1190,Argentina,A14,c,14,1,a
child,289600,290200,600,Argentina,A14,f,14,2,a
mother,297520,311560,14040,Argentina,A14,f,15,1,a
father,319300,320250,950,Argentina,A14,m,15,2,i
mother,320840,321660,820,Argentina,A14,f,15,3,a
mother,348710,356070,7360,Argentina,A14,f,16,1,a
father,358930,360280,1350,Argentina,A14,m,16,2,a
mother,362950,364290,1340,Argentina,A14,f,16,3,a
mother,369480,379390,9910,Argentina,A14,f,16,4,a
father,379320,381420,2100,Argentina,A14,m,16,5,a
child,362590,365170,2580,Argentina,A14,b,17,1,a
mother,459310,462740,3430,Argentina,A14,f,18,1,a
mother,472330,473650,1320,Argentina,A14,f,19,1,q
mother,477290,481150,3860,Argentina,A14,f,19,2,q
father,483700,484640,940,Argentina,A14,m,19,3,a
mother,483710,485780,2070,Argentina,A14,f,19,4,a
father,489130,497300,8170,Argentina,A14,m,19,5,a
mother,524410,526550,2140,Argentina,A14,f,21,1,q
mother,528820,529660,840,Argentina,A14,f,21,2,a
mother,534490,538180,3690,Argentina,A14,f,21,3,a
father,540790,542500,1710,Argentina,A14,m,21,4,a
mother,542680,566060,23380,Argentina,A14,f,21,5,a
mother,570930,573870,2940,Argentina,A14,f,21,6,a
father,574840,575960,1120,Argentina,A14,m,21,7,q
father,20720,21620,900,Argentina,A14,c,30,1,i
father,408590,411070,2480,Argentina,A14,c,31,1,q
father_gesture,1395,2474,1079,Argentina,A14,NA,NA,NA,NA
silence,2360,13620,11260,Argentina,A14,NA,NA,NA,NA
silence,14940,20720,5780,Argentina,A14,NA,NA,NA,NA
silence,23100,23250,150,Argentina,A14,NA,NA,NA,NA
silence,23800,32790,8990,Argentina,A14,NA,NA,NA,NA
silence,35210,36360,1150,Argentina,A14,NA,NA,NA,NA
silence,37930,37970,40,Argentina,A14,NA,NA,NA,NA
silence,38680,55130,16450,Argentina,A14,NA,NA,NA,NA
mother_gesture,55485,57282,1797,Argentina,A14,NA,NA,NA,NA
silence,58400,58590,190,Argentina,A14,NA,NA,NA,NA
silence,59550,61080,1530,Argentina,A14,NA,NA,NA,NA
silence,61950,93510,31560,Argentina,A14,NA,NA,NA,NA
child_gesture,92650,95830,3180,Argentina,A14,NA,NA,NA,NA
silence,94250,110670,16420,Argentina,A14,NA,NA,NA,NA
silence,112550,115990,3440,Argentina,A14,NA,NA,NA,NA
silence,120040,121190,1150,Argentina,A14,NA,NA,NA,NA
silence,122220,122570,350,Argentina,A14,NA,NA,NA,NA
silence,127470,156100,28630,Argentina,A14,NA,NA,NA,NA
silence,161430,165470,4040,Argentina,A14,NA,NA,NA,NA
silence,166420,197520,31100,Argentina,A14,NA,NA,NA,NA
silence,198470,218290,19820,Argentina,A14,NA,NA,NA,NA
child_gesture,216977,219411,2434,Argentina,A14,NA,NA,NA,NA
silence,218800,222450,3650,Argentina,A14,NA,NA,NA,NA
father_gesture,219075,222962,3887,Argentina,A14,NA,NA,NA,NA
silence,223210,225830,2620,Argentina,A14,NA,NA,NA,NA
silence,226430,230040,3610,Argentina,A14,NA,NA,NA,NA
child_gesture,229941,232185,2244,Argentina,A14,NA,NA,NA,NA
silence,231520,231750,230,Argentina,A14,NA,NA,NA,NA
silence,232490,238970,6480,Argentina,A14,NA,NA,NA,NA
silence,240280,246590,6310,Argentina,A14,NA,NA,NA,NA
child_gesture,246207,248083,1876,Argentina,A14,NA,NA,NA,NA
silence,247280,247320,40,Argentina,A14,NA,NA,NA,NA
silence,247940,248640,700,Argentina,A14,NA,NA,NA,NA
silence,251120,288220,37100,Argentina,A14,NA,NA,NA,NA
silence,289410,289600,190,Argentina,A14,NA,NA,NA,NA
silence,290200,297520,7320,Argentina,A14,NA,NA,NA,NA
silence,311560,319300,7740,Argentina,A14,NA,NA,NA,NA
silence,320250,320840,590,Argentina,A14,NA,NA,NA,NA
silence,321660,348710,27050,Argentina,A14,NA,NA,NA,NA
silence,356070,358930,2860,Argentina,A14,NA,NA,NA,NA
silence,360280,362590,2310,Argentina,A14,NA,NA,NA,NA
silence,365170,369480,4310,Argentina,A14,NA,NA,NA,NA
silence,381420,408590,27170,Argentina,A14,NA,NA,NA,NA
silence,411070,459310,48240,Argentina,A14,NA,NA,NA,NA
silence,462740,472330,9590,Argentina,A14,NA,NA,NA,NA
silence,473650,477290,3640,Argentina,A14,NA,NA,NA,NA
father_gesture,474130,476019,1889,Argentina,A14,NA,NA,NA,NA
silence,481150,483700,2550,Argentina,A14,NA,NA,NA,NA
silence,485780,489130,3350,Argentina,A14,NA,NA,NA,NA
silence,497300,524410,27110,Argentina,A14,NA,NA,NA,NA
silence,526550,528820,2270,Argentina,A14,NA,NA,NA,NA
silence,529660,534490,4830,Argentina,A14,NA,NA,NA,NA
silence,538180,540790,2610,Argentina,A14,NA,NA,NA,NA
silence,542500,542680,180,Argentina,A14,NA,NA,NA,NA
mother_gesture,546985,548769,1784,Argentina,A14,NA,NA,NA,NA
mother_gesture,549559,551497,1938,Argentina,A14,NA,NA,NA,NA
silence,566060,570930,4870,Argentina,A14,NA,NA,NA,NA
silence,573870,574840,970,Argentina,A14,NA,NA,NA,NA
silence,575960,599460,23500,Argentina,A14,NA,NA,NA,NA
mother,388,9938,9550,Argentina,A15,f,1,1,a
child,10408,12308,1900,Argentina,A15,m,2,1,a
father,18018,18958,940,Argentina,A15,m,3,1,q
mother,19458,20168,710,Argentina,A15,f,3,2,a
child,20588,21868,1280,Argentina,A15,b,4,1,a
mother,29088,31778,2690,Argentina,A15,c,4,2,i
child,34258,35418,1160,Argentina,A15,m,4,3,a
child,44388,45448,1060,Argentina,A15,m,4,4,a
mother,45498,48668,3170,Argentina,A15,c,4,5,i
mother,52358,52968,610,Argentina,A15,c,4,6,a
child,56208,57918,1710,Argentina,A15,m,4,7,a
child,60428,62498,2070,Argentina,A15,b,4,8,a
child,73718,74888,1170,Argentina,A15,b,7,1,a
child,85048,85968,920,Argentina,A15,f,8,1,q
child,88468,91798,3330,Argentina,A15,f,8,2,a
mother,91668,92678,1010,Argentina,A15,c,8,3,a
father,94498,95038,540,Argentina,A15,m,8,4,q
mother,95398,96408,1010,Argentina,A15,f,8,5,a
father,97998,98658,660,Argentina,A15,m,8,6,a
mother,99718,100908,1190,Argentina,A15,f,8,7,a
mother,102248,106008,3760,Argentina,A15,f,8,8,a
child,101878,107348,5470,Argentina,A15,m,9,1,a
mother,106548,107998,1450,Argentina,A15,c,9,2,q
child,108208,109358,1150,Argentina,A15,m,9,3,a
mother,108908,111508,2600,Argentina,A15,c,9,4,a
child,111048,113758,2710,Argentina,A15,m,9,5,a
mother,114028,116838,2810,Argentina,A15,f,9,6,i
child,116848,118028,1180,Argentina,A15,f,9,7,i
father,116888,118048,1160,Argentina,A15,m,9,8,a
mother,118048,119478,1430,Argentina,A15,c,9,9,a
child,119028,119518,490,Argentina,A15,m,9,10,a
mother,121488,122348,860,Argentina,A15,b,9,11,a
child,123478,126088,2610,Argentina,A15,f,10,1,a
child,126688,128498,1810,Argentina,A15,b,10,2,a
mother,134588,136068,1480,Argentina,A15,c,10,3,a
child,136028,137568,1540,Argentina,A15,b,10,4,a
father,136598,138198,1600,Argentina,A15,c,10,5,a
mother,124388,126048,1660,Argentina,A15,f,11,1,a
mother,140198,148428,8230,Argentina,A15,f,14,1,a
child,153718,154488,770,Argentina,A15,b,14,2,a
father,155978,156838,860,Argentina,A15,c,15,1,a
child,159678,161028,1350,Argentina,A15,b,15,2,a
child,163678,164558,880,Argentina,A15,b,15,3,a
mother,165278,166018,740,Argentina,A15,f,15,4,a
father,166298,167408,1110,Argentina,A15,b,15,5,a
mother,172478,176748,4270,Argentina,A15,c,16,1,a
mother,179048,179808,760,Argentina,A15,c,16,2,q
child,179628,186958,7330,Argentina,A15,m,16,3,a
mother,184658,193868,9210,Argentina,A15,f,17,1,a
mother,198988,202618,3630,Argentina,A15,f,17,2,a
child,204748,209998,5250,Argentina,A15,f,18,1,a
mother,214988,219598,4610,Argentina,A15,f,19,1,a
child,223238,226348,3110,Argentina,A15,m,20,1,q
mother,226468,226988,520,Argentina,A15,c,20,2,q
child,227038,227868,830,Argentina,A15,m,20,3,q
mother,228788,229898,1110,Argentina,A15,c,20,4,a
child,230028,230738,710,Argentina,A15,m,20,5,q
mother,230878,231438,560,Argentina,A15,c,20,6,a
child,231598,232138,540,Argentina,A15,m,20,7,q
mother,232378,234368,1990,Argentina,A15,c,20,8,i
child,234398,235978,1580,Argentina,A15,m,20,9,a
mother,236288,239798,3510,Argentina,A15,c,20,10,i
child,238958,239788,830,Argentina,A15,m,20,11,q
mother,241058,241728,670,Argentina,A15,c,20,12,a
child,242068,250798,8730,Argentina,A15,m,20,13,a
mother,256928,258268,1340,Argentina,A15,c,20,14,q
child,258568,259478,910,Argentina,A15,m,20,15,a
mother,259398,260918,1520,Argentina,A15,c,20,16,a
father,261438,264128,2690,Argentina,A15,c,20,17,q
child,264248,265008,760,Argentina,A15,f,20,18,a
mother,265108,265808,700,Argentina,A15,c,20,19,a
father,266248,266758,510,Argentina,A15,c,20,20,a
mother,268908,271548,2640,Argentina,A15,c,20,21,i
child,270528,272848,2320,Argentina,A15,b,20,22,a
mother,273428,274048,620,Argentina,A15,c,20,23,a
child,274268,274968,700,Argentina,A15,b,20,24,a
mother,275308,276548,1240,Argentina,A15,c,20,25,a
child,276718,279178,2460,Argentina,A15,m,20,26,q
father,279818,280278,460,Argentina,A15,c,20,27,a
mother,280228,287318,7090,Argentina,A15,c,20,28,i
child,291798,292478,680,Argentina,A15,m,20,29,q
mother,293258,299888,6630,Argentina,A15,c,20,30,i
mother,289558,290438,880,Argentina,A15,o,21,1,a
father,303188,305248,2060,Argentina,A15,m,24,1,a
mother,305798,307348,1550,Argentina,A15,f,24,2,q
mother,310108,312108,2000,Argentina,A15,f,24,3,a
father,311508,312768,1260,Argentina,A15,m,24,4,a
child,312818,313778,960,Argentina,A15,m,24,5,a
mother,315748,321438,5690,Argentina,A15,c,25,1,q
child,321458,322068,610,Argentina,A15,m,25,2,a
mother,322098,324918,2820,Argentina,A15,f,25,3,i
father,323798,325208,1410,Argentina,A15,m,25,4,a
child,325278,326098,820,Argentina,A15,f,25,5,a
mother,326278,327688,1410,Argentina,A15,f,25,6,a
father,327488,330688,3200,Argentina,A15,c,25,7,a
mother,329028,334328,5300,Argentina,A15,c,25,8,a
father,331728,334128,2400,Argentina,A15,c,25,9,a
child,333218,334028,810,Argentina,A15,b,25,10,a
father,335148,336788,1640,Argentina,A15,c,25,11,a
mother,335308,336818,1510,Argentina,A15,c,25,12,a
mother,343378,345478,2100,Argentina,A15,f,25,13,a
father,345508,348128,2620,Argentina,A15,m,25,14,a
father,351598,367648,16050,Argentina,A15,c,25,15,a
mother,363368,367218,3850,Argentina,A15,c,25,16,a
father,368068,370478,2410,Argentina,A15,c,25,17,a
child,370158,370958,800,Argentina,A15,f,25,18,a
father,371478,372208,730,Argentina,A15,c,25,19,q
child,372048,372488,440,Argentina,A15,f,25,20,a
mother,373208,374488,1280,Argentina,A15,c,25,21,i
father,373388,374888,1500,Argentina,A15,c,25,22,a
child,383728,384868,1140,Argentina,A15,f,25,23,a
father,385238,398118,12880,Argentina,A15,c,25,24,a
mother,394598,395778,1180,Argentina,A15,f,25,25,i
child,398528,399218,690,Argentina,A15,f,25,26,a
father,398568,400088,1520,Argentina,A15,m,25,27,a
child,400298,412808,12510,Argentina,A15,f,25,28,a
father,413688,414448,760,Argentina,A15,c,25,29,q
mother,348148,349468,1320,Argentina,A15,c,27,1,a
child,415148,415898,750,Argentina,A15,m,30,1,a
mother,415668,418288,2620,Argentina,A15,c,30,2,q
child,422878,428498,5620,Argentina,A15,b,31,1,a
mother,427538,428568,1030,Argentina,A15,c,31,2,q
child,429628,431278,1650,Argentina,A15,b,31,3,a
mother,431538,433628,2090,Argentina,A15,c,31,4,q
child,432698,433228,530,Argentina,A15,f,31,5,a
child,435398,436138,740,Argentina,A15,f,31,6,a
father,437948,441328,3380,Argentina,A15,c,32,1,q
child,441738,442308,570,Argentina,A15,f,32,2,a
mother,442548,445938,3390,Argentina,A15,b,32,3,a
father,442708,443648,940,Argentina,A15,c,32,4,q
father,447038,454308,7270,Argentina,A15,c,32,5,a
child,454358,455818,1460,Argentina,A15,f,32,6,a
child,459638,461828,2190,Argentina,A15,f,32,7,a
father,462918,475168,12250,Argentina,A15,c,32,8,a
child,464998,467468,2470,Argentina,A15,f,32,9,a
child,475098,477778,2680,Argentina,A15,f,32,10,i
father,483408,484548,1140,Argentina,A15,c,32,11,a
child,487718,489648,1930,Argentina,A15,f,32,12,a
child,494908,498988,4080,Argentina,A15,f,34,1,a
mother,506798,508468,1670,Argentina,A15,f,35,1,a
mother,510878,512468,1590,Argentina,A15,f,35,2,a
child,522348,524698,2350,Argentina,A15,f,36,1,a
father,524998,525708,710,Argentina,A15,c,36,2,a
child,526008,531108,5100,Argentina,A15,f,36,3,a
mother,531628,536948,5320,Argentina,A15,c,36,4,q
child,537228,537978,750,Argentina,A15,m,36,5,a
mother,538938,540288,1350,Argentina,A15,c,36,6,q
child,539778,541348,1570,Argentina,A15,m,36,7,a
mother,541798,543028,1230,Argentina,A15,c,36,8,q
child,543118,543638,520,Argentina,A15,m,36,9,a
mother,544488,550488,6000,Argentina,A15,c,36,10,q
child,548048,548958,910,Argentina,A15,m,36,11,a
child,550448,550958,510,Argentina,A15,m,36,12,a
mother,551138,555588,4450,Argentina,A15,c,36,13,q
child,555478,555988,510,Argentina,A15,m,36,14,a
mother,556118,559558,3440,Argentina,A15,c,36,15,a
child,559398,560098,700,Argentina,A15,m,36,16,a
child,561578,562208,630,Argentina,A15,m,36,17,q
father,559898,562318,2420,Argentina,A15,c,37,1,a
father,563118,578448,15330,Argentina,A15,c,37,2,a
child,563226,564391,1165,Argentina,A15,b,37,3,a
child,574208,574828,620,Argentina,A15,b,37,4,a
child,578318,580508,2190,Argentina,A15,f,37,5,a
father,580488,585488,5000,Argentina,A15,c,37,6,a
child,586468,587808,1340,Argentina,A15,f,37,7,a
father,587858,592318,4460,Argentina,A15,c,37,8,q
mother,593338,595798,2460,Argentina,A15,b,37,9,a
child,595818,596918,1100,Argentina,A15,f,37,10,a
father,597598,598608,1010,Argentina,A15,c,37,11,i
child,504138,504788,650,Argentina,A15,f,38,1,q
silence,9938,10408,470,Argentina,A15,NA,NA,NA,NA
child_gesture,10637,11803,1166,Argentina,A15,NA,NA,NA,NA
silence,12308,18018,5710,Argentina,A15,NA,NA,NA,NA
silence,18958,19458,500,Argentina,A15,NA,NA,NA,NA
silence,20168,20588,420,Argentina,A15,NA,NA,NA,NA
silence,21868,29088,7220,Argentina,A15,NA,NA,NA,NA
silence,31778,34258,2480,Argentina,A15,NA,NA,NA,NA
silence,35418,44388,8970,Argentina,A15,NA,NA,NA,NA
silence,45448,45498,50,Argentina,A15,NA,NA,NA,NA
silence,48668,52358,3690,Argentina,A15,NA,NA,NA,NA
silence,52968,56208,3240,Argentina,A15,NA,NA,NA,NA
silence,57918,60428,2510,Argentina,A15,NA,NA,NA,NA
silence,62498,73718,11220,Argentina,A15,NA,NA,NA,NA
silence,74888,85048,10160,Argentina,A15,NA,NA,NA,NA
silence,85968,88468,2500,Argentina,A15,NA,NA,NA,NA
silence,92678,94498,1820,Argentina,A15,NA,NA,NA,NA
silence,95038,95398,360,Argentina,A15,NA,NA,NA,NA
silence,96408,97998,1590,Argentina,A15,NA,NA,NA,NA
silence,98658,99718,1060,Argentina,A15,NA,NA,NA,NA
silence,100908,101878,970,Argentina,A15,NA,NA,NA,NA
silence,107998,108208,210,Argentina,A15,NA,NA,NA,NA
silence,113758,114028,270,Argentina,A15,NA,NA,NA,NA
silence,116838,116848,10,Argentina,A15,NA,NA,NA,NA
father_gesture,117038,117963,925,Argentina,A15,NA,NA,NA,NA
silence,119518,121488,1970,Argentina,A15,NA,NA,NA,NA
silence,122348,123478,1130,Argentina,A15,NA,NA,NA,NA
child_gesture,124286,126038,1752,Argentina,A15,NA,NA,NA,NA
silence,126088,126688,600,Argentina,A15,NA,NA,NA,NA
silence,128498,134588,6090,Argentina,A15,NA,NA,NA,NA
silence,138198,140198,2000,Argentina,A15,NA,NA,NA,NA
silence,148428,153718,5290,Argentina,A15,NA,NA,NA,NA
silence,154488,155978,1490,Argentina,A15,NA,NA,NA,NA
silence,156838,159678,2840,Argentina,A15,NA,NA,NA,NA
silence,161028,163678,2650,Argentina,A15,NA,NA,NA,NA
silence,164558,165278,720,Argentina,A15,NA,NA,NA,NA
silence,166018,166298,280,Argentina,A15,NA,NA,NA,NA
silence,167408,172478,5070,Argentina,A15,NA,NA,NA,NA
silence,176748,179048,2300,Argentina,A15,NA,NA,NA,NA
silence,193868,198988,5120,Argentina,A15,NA,NA,NA,NA
silence,202618,204748,2130,Argentina,A15,NA,NA,NA,NA
silence,209998,214988,4990,Argentina,A15,NA,NA,NA,NA
silence,219598,223238,3640,Argentina,A15,NA,NA,NA,NA
silence,226348,226468,120,Argentina,A15,NA,NA,NA,NA
silence,226988,227038,50,Argentina,A15,NA,NA,NA,NA
silence,227868,228788,920,Argentina,A15,NA,NA,NA,NA
mother_gesture,229065,230069,1004,Argentina,A15,NA,NA,NA,NA
silence,229898,230028,130,Argentina,A15,NA,NA,NA,NA
mother_gesture,230638,231648,1010,Argentina,A15,NA,NA,NA,NA
silence,230738,230878,140,Argentina,A15,NA,NA,NA,NA
silence,231438,231598,160,Argentina,A15,NA,NA,NA,NA
silence,232138,232378,240,Argentina,A15,NA,NA,NA,NA
mother_gesture,233098,235503,2405,Argentina,A15,NA,NA,NA,NA
silence,234368,234398,30,Argentina,A15,NA,NA,NA,NA
silence,235978,236288,310,Argentina,A15,NA,NA,NA,NA
silence,239798,241058,1260,Argentina,A15,NA,NA,NA,NA
silence,241728,242068,340,Argentina,A15,NA,NA,NA,NA
silence,250798,256928,6130,Argentina,A15,NA,NA,NA,NA
silence,258268,258568,300,Argentina,A15,NA,NA,NA,NA
silence,260918,261438,520,Argentina,A15,NA,NA,NA,NA
silence,264128,264248,120,Argentina,A15,NA,NA,NA,NA
silence,265008,265108,100,Argentina,A15,NA,NA,NA,NA
silence,265808,266248,440,Argentina,A15,NA,NA,NA,NA
silence,266758,268908,2150,Argentina,A15,NA,NA,NA,NA
silence,272848,273428,580,Argentina,A15,NA,NA,NA,NA
silence,274048,274268,220,Argentina,A15,NA,NA,NA,NA
silence,274968,275308,340,Argentina,A15,NA,NA,NA,NA
silence,276548,276718,170,Argentina,A15,NA,NA,NA,NA
silence,279178,279818,640,Argentina,A15,NA,NA,NA,NA
mother_gesture,280570,282236,1666,Argentina,A15,NA,NA,NA,NA
silence,287318,289558,2240,Argentina,A15,NA,NA,NA,NA
silence,290438,291798,1360,Argentina,A15,NA,NA,NA,NA
silence,292478,293258,780,Argentina,A15,NA,NA,NA,NA
mother_gesture,298598,299983,1385,Argentina,A15,NA,NA,NA,NA
silence,299888,303188,3300,Argentina,A15,NA,NA,NA,NA
silence,305248,305798,550,Argentina,A15,NA,NA,NA,NA
silence,307348,310108,2760,Argentina,A15,NA,NA,NA,NA
mother_gesture,311428,312975,1547,Argentina,A15,NA,NA,NA,NA
silence,312768,312818,50,Argentina,A15,NA,NA,NA,NA
silence,313778,315748,1970,Argentina,A15,NA,NA,NA,NA
silence,321438,321458,20,Argentina,A15,NA,NA,NA,NA
silence,322068,322098,30,Argentina,A15,NA,NA,NA,NA
silence,325208,325278,70,Argentina,A15,NA,NA,NA,NA
silence,326098,326278,180,Argentina,A15,NA,NA,NA,NA
silence,334328,335148,820,Argentina,A15,NA,NA,NA,NA
silence,336818,343378,6560,Argentina,A15,NA,NA,NA,NA
silence,345478,345508,30,Argentina,A15,NA,NA,NA,NA
silence,348128,348148,20,Argentina,A15,NA,NA,NA,NA
silence,349468,351598,2130,Argentina,A15,NA,NA,NA,NA
silence,367648,368068,420,Argentina,A15,NA,NA,NA,NA
silence,370958,371478,520,Argentina,A15,NA,NA,NA,NA
silence,372488,373208,720,Argentina,A15,NA,NA,NA,NA
silence,374888,383728,8840,Argentina,A15,NA,NA,NA,NA
silence,384868,385238,370,Argentina,A15,NA,NA,NA,NA
silence,398118,398528,410,Argentina,A15,NA,NA,NA,NA
silence,400088,400298,210,Argentina,A15,NA,NA,NA,NA
child_gesture,400836,401931,1095,Argentina,A15,NA,NA,NA,NA
child_gesture,403699,404553,854,Argentina,A15,NA,NA,NA,NA
child_gesture,406522,408555,2033,Argentina,A15,NA,NA,NA,NA
child_gesture,410933,412583,1650,Argentina,A15,NA,NA,NA,NA
silence,412808,413688,880,Argentina,A15,NA,NA,NA,NA
silence,414448,415148,700,Argentina,A15,NA,NA,NA,NA
silence,418288,422878,4590,Argentina,A15,NA,NA,NA,NA
silence,428568,429628,1060,Argentina,A15,NA,NA,NA,NA
silence,431278,431538,260,Argentina,A15,NA,NA,NA,NA
silence,433628,435398,1770,Argentina,A15,NA,NA,NA,NA
silence,436138,437948,1810,Argentina,A15,NA,NA,NA,NA
silence,441328,441738,410,Argentina,A15,NA,NA,NA,NA
silence,442308,442548,240,Argentina,A15,NA,NA,NA,NA
silence,445938,447038,1100,Argentina,A15,NA,NA,NA,NA
silence,454308,454358,50,Argentina,A15,NA,NA,NA,NA
silence,455818,459638,3820,Argentina,A15,NA,NA,NA,NA
child_gesture,460041,462257,2216,Argentina,A15,NA,NA,NA,NA
silence,461828,462918,1090,Argentina,A15,NA,NA,NA,NA
child_gesture,465908,467841,1933,Argentina,A15,NA,NA,NA,NA
silence,477778,483408,5630,Argentina,A15,NA,NA,NA,NA
silence,484548,487718,3170,Argentina,A15,NA,NA,NA,NA
silence,489648,494908,5260,Argentina,A15,NA,NA,NA,NA
silence,498988,504138,5150,Argentina,A15,NA,NA,NA,NA
silence,504788,506798,2010,Argentina,A15,NA,NA,NA,NA
silence,508468,510878,2410,Argentina,A15,NA,NA,NA,NA
silence,512468,522348,9880,Argentina,A15,NA,NA,NA,NA
silence,524698,524998,300,Argentina,A15,NA,NA,NA,NA
silence,525708,526008,300,Argentina,A15,NA,NA,NA,NA
silence,531108,531628,520,Argentina,A15,NA,NA,NA,NA
silence,536948,537228,280,Argentina,A15,NA,NA,NA,NA
silence,537978,538938,960,Argentina,A15,NA,NA,NA,NA
silence,541348,541798,450,Argentina,A15,NA,NA,NA,NA
silence,543028,543118,90,Argentina,A15,NA,NA,NA,NA
silence,543638,544488,850,Argentina,A15,NA,NA,NA,NA
mother_gesture,549273,550573,1300,Argentina,A15,NA,NA,NA,NA
silence,550958,551138,180,Argentina,A15,NA,NA,NA,NA
silence,555988,556118,130,Argentina,A15,NA,NA,NA,NA
mother_gesture,556784,562169,5385,Argentina,A15,NA,NA,NA,NA
silence,562318,563118,800,Argentina,A15,NA,NA,NA,NA
silence,585488,586468,980,Argentina,A15,NA,NA,NA,NA
silence,587808,587858,50,Argentina,A15,NA,NA,NA,NA
silence,592318,593338,1020,Argentina,A15,NA,NA,NA,NA
silence,595798,595818,20,Argentina,A15,NA,NA,NA,NA
silence,596918,597598,680,Argentina,A15,NA,NA,NA,NA
father,1421,2581,1160,Argentina,A16,b,1,1,a
child,1851,4781,2930,Argentina,A16,b,2,1,a
child,8591,13451,4860,Argentina,A16,b,2,2,q
mother,12781,13571,790,Argentina,A16,f,4,1,q
father,14851,15671,820,Argentina,A16,m,4,2,a
mother,17001,21931,4930,Argentina,A16,f,4,3,a
father,21321,21981,660,Argentina,A16,m,4,4,a
mother,25041,26101,1060,Argentina,A16,c,4,5,a
child,20851,24151,3300,Argentina,A16,b,5,1,q
father,24181,25571,1390,Argentina,A16,c,5,2,a
father,26051,26901,850,Argentina,A16,c,5,3,a
child,26771,28061,1290,Argentina,A16,f,5,4,i
father,27431,29011,1580,Argentina,A16,c,5,5,a
child,28791,29521,730,Argentina,A16,f,5,6,a
father,30201,30981,780,Argentina,A16,c,5,7,a
child,31371,31991,620,Argentina,A16,f,5,8,a
father,31951,32661,710,Argentina,A16,c,5,9,a
child,32531,33681,1150,Argentina,A16,f,5,10,a
father,33731,35291,1560,Argentina,A16,c,5,11,i
child,35391,37141,1750,Argentina,A16,f,5,12,a
father,39971,40551,580,Argentina,A16,c,5,13,i
child,42901,43891,990,Argentina,A16,f,5,14,a
mother,42981,44681,1700,Argentina,A16,c,5,15,a
father,43861,45401,1540,Argentina,A16,c,5,16,a
child,47371,48821,1450,Argentina,A16,f,5,17,a
child,53051,54001,950,Argentina,A16,f,6,1,a
father,54061,55061,1000,Argentina,A16,c,6,2,q
child,56321,57061,740,Argentina,A16,f,6,3,a
father,56971,57611,640,Argentina,A16,c,6,4,a
mother,57801,58571,770,Argentina,A16,c,6,5,q
child,58731,59331,600,Argentina,A16,m,6,6,a
father,59261,59831,570,Argentina,A16,c,6,7,q
mother,59321,60111,790,Argentina,A16,c,6,8,q
child,60271,60891,620,Argentina,A16,m,6,9,a
mother,60981,61731,750,Argentina,A16,c,6,10,q
child,61781,62441,660,Argentina,A16,m,6,11,a
father,63301,64301,1000,Argentina,A16,c,6,12,q
child,64551,65061,510,Argentina,A16,f,6,13,a
mother,74321,75821,1500,Argentina,A16,c,7,1,a
father,75311,76301,990,Argentina,A16,c,7,2,a
child,82901,86201,3300,Argentina,A16,b,8,1,a
mother,86301,87011,710,Argentina,A16,c,8,2,a
child,87081,88111,1030,Argentina,A16,b,8,3,a
mother,88271,89381,1110,Argentina,A16,c,8,4,a
child,91021,97731,6710,Argentina,A16,m,9,1,a
mother,98061,98751,690,Argentina,A16,f,10,1,a
father,100931,104051,3120,Argentina,A16,c,11,1,q
child,103811,104461,650,Argentina,A16,f,11,2,a
father,104631,105201,570,Argentina,A16,c,11,3,q
child,105331,106541,1210,Argentina,A16,f,11,4,a
mother,109661,110661,1000,Argentina,A16,c,12,1,q
mother,119301,120261,960,Argentina,A16,c,12,2,q
child,122881,123681,800,Argentina,A16,m,12,3,a
child,127671,132771,5100,Argentina,A16,b,13,1,a
father,129781,130621,840,Argentina,A16,c,13,2,q
mother,132431,133291,860,Argentina,A16,c,13,3,a
child,133471,135121,1650,Argentina,A16,b,13,4,a
father,135411,136161,750,Argentina,A16,c,13,5,a
mother,142071,143271,1200,Argentina,A16,f,13,6,q
father,144051,144651,600,Argentina,A16,m,13,7,a
mother,158791,159831,1040,Argentina,A16,c,15,1,i
child,163611,165811,2200,Argentina,A16,f,16,1,a
father,165831,166411,580,Argentina,A16,c,16,2,q
child,166631,168631,2000,Argentina,A16,f,16,3,a
father,168511,169291,780,Argentina,A16,c,16,4,a
father,182991,183621,630,Argentina,A16,m,17,1,a
mother,187701,188411,710,Argentina,A16,f,17,2,a
father,189681,190481,800,Argentina,A16,m,17,3,a
mother,190711,191781,1070,Argentina,A16,f,18,1,q
father,191981,192551,570,Argentina,A16,m,18,2,a
child,217281,218111,830,Argentina,A16,b,19,1,a
father,232341,233671,1330,Argentina,A16,c,20,1,a
child,245761,246291,530,Argentina,A16,b,21,1,a
mother,252721,259031,6310,Argentina,A16,f,23,1,q
father,257681,263331,5650,Argentina,A16,m,23,2,q
mother,262151,262691,540,Argentina,A16,f,23,3,a
mother,267141,273471,6330,Argentina,A16,f,23,4,a
father,273561,274421,860,Argentina,A16,m,23,5,q
mother,278691,279391,700,Argentina,A16,f,23,6,a
father,279441,286421,6980,Argentina,A16,m,23,7,a
mother,285941,288241,2300,Argentina,A16,c,24,1,i
mother,290821,292021,1200,Argentina,A16,c,24,2,i
mother,296531,297331,800,Argentina,A16,c,24,3,i
child,295571,296341,770,Argentina,A16,m,25,1,a
child,297241,298221,980,Argentina,A16,m,25,2,a
father,298391,299861,1470,Argentina,A16,c,25,3,a
mother,298511,299481,970,Argentina,A16,c,25,4,a
child,341331,343651,2320,Argentina,A16,b,25,5,a
mother,343561,345621,2060,Argentina,A16,c,25,6,i
father,344971,347921,2950,Argentina,A16,c,25,7,a
child,349651,350961,1310,Argentina,A16,f,25,8,q
father,350761,351581,820,Argentina,A16,c,25,9,i
child,356471,357231,760,Argentina,A16,f,25,10,a
mother,358471,359351,880,Argentina,A16,c,25,11,i
child,360041,361341,1300,Argentina,A16,b,25,12,a
child,363491,364171,680,Argentina,A16,f,25,13,a
father,364091,370851,6760,Argentina,A16,m,28,1,a
child,374671,376001,1330,Argentina,A16,f,29,1,a
child,379411,380031,620,Argentina,A16,f,29,2,a
child,382081,383551,1470,Argentina,A16,b,29,3,a
father,384021,384991,970,Argentina,A16,c,29,4,i
mother,384501,386341,1840,Argentina,A16,f,29,5,a
mother,388411,391761,3350,Argentina,A16,f,29,6,q
mother,398041,400461,2420,Argentina,A16,c,29,7,a
father,400491,401111,620,Argentina,A16,m,29,8,a
mother,405711,407271,1560,Argentina,A16,f,30,1,a
father,409531,417671,8140,Argentina,A16,m,30,2,a
mother,417091,421141,4050,Argentina,A16,f,30,3,a
father,421201,421931,730,Argentina,A16,m,30,4,q
father,423731,424301,570,Argentina,A16,m,30,5,q
mother,429991,433401,3410,Argentina,A16,f,30,6,a
mother,421881,423780,1899,Argentina,A16,c,31,1,i
child,442581,443401,820,Argentina,A16,m,32,1,a
mother,443521,444141,620,Argentina,A16,c,32,2,q
child,444531,447211,2680,Argentina,A16,m,32,3,a
mother,447101,448061,960,Argentina,A16,c,32,4,a
child,452051,453091,1040,Argentina,A16,m,33,1,a
mother,454951,456181,1230,Argentina,A16,c,33,2,a
child,456421,457451,1030,Argentina,A16,m,33,3,a
mother,457931,459281,1350,Argentina,A16,c,33,4,q
child,459321,460391,1070,Argentina,A16,m,33,5,a
mother,460771,461921,1150,Argentina,A16,c,33,6,q
child,461911,462691,780,Argentina,A16,m,33,7,a
mother,462641,463741,1100,Argentina,A16,c,33,8,i
child,463771,464771,1000,Argentina,A16,m,33,9,a
child,468731,471211,2480,Argentina,A16,m,34,1,a
child,473771,476481,2710,Argentina,A16,m,34,2,a
mother,475711,476951,1240,Argentina,A16,c,35,1,a
child,477101,478061,960,Argentina,A16,m,35,2,a
mother,478101,479391,1290,Argentina,A16,c,35,3,q
father,479251,480161,910,Argentina,A16,b,35,4,a
child,479481,480271,790,Argentina,A16,m,35,5,a
mother,480751,481701,950,Argentina,A16,c,35,6,q
child,481901,482701,800,Argentina,A16,m,35,7,a
mother,484571,485631,1060,Argentina,A16,c,35,8,i
child,485641,486851,1210,Argentina,A16,m,35,9,a
child,490911,492311,1400,Argentina,A16,b,35,10,a
mother,492081,493211,1130,Argentina,A16,c,35,11,a
mother,495111,496141,1030,Argentina,A16,c,35,12,a
child,496671,497981,1310,Argentina,A16,b,35,13,a
mother,498471,499681,1210,Argentina,A16,c,35,14,a
child,499951,501411,1460,Argentina,A16,f,35,15,i
father,501361,502371,1010,Argentina,A16,c,35,16,a
child,502621,504171,1550,Argentina,A16,f,35,17,a
father,504141,505231,1090,Argentina,A16,c,35,18,a
child,505311,506821,1510,Argentina,A16,f,35,19,i
father,506761,508291,1530,Argentina,A16,c,35,20,a
child,512101,513921,1820,Argentina,A16,b,35,21,a
mother,513401,514671,1270,Argentina,A16,c,35,22,a
child,514851,516351,1500,Argentina,A16,f,35,23,i
mother,516371,517601,1230,Argentina,A16,c,35,24,a
child,517501,519091,1590,Argentina,A16,f,35,25,q
father,518961,519941,980,Argentina,A16,c,35,26,a
mother,519141,520281,1140,Argentina,A16,c,35,27,a
child,520811,522361,1550,Argentina,A16,b,35,28,i
mother,522121,523061,940,Argentina,A16,c,35,29,a
father,522621,523641,1020,Argentina,A16,c,35,30,a
child,525241,526831,1590,Argentina,A16,m,35,31,a
mother,526881,528041,1160,Argentina,A16,c,35,32,a
child,528321,529801,1480,Argentina,A16,m,35,33,i
child,533681,535231,1550,Argentina,A16,m,35,34,i
mother,535841,536861,1020,Argentina,A16,c,35,35,a
child,537381,538701,1320,Argentina,A16,m,35,36,q
mother,538921,539971,1050,Argentina,A16,c,35,37,a
child,539671,541111,1440,Argentina,A16,m,35,38,i
mother,541211,542111,900,Argentina,A16,c,35,39,a
child,542361,548481,6120,Argentina,A16,m,35,40,a
mother,544401,545641,1240,Argentina,A16,c,35,41,a
father,529671,532131,2460,Argentina,A16,m,36,1,a
father,538661,539231,570,Argentina,A16,o,37,1,q
mother,556551,557901,1350,Argentina,A16,c,38,1,a
father,557761,559241,1480,Argentina,A16,m,39,1,q
mother,559891,561041,1150,Argentina,A16,f,39,2,a
father,568511,570471,1960,Argentina,A16,m,39,3,q
mother,575921,578901,2980,Argentina,A16,f,39,4,a
father,584141,585071,930,Argentina,A16,m,39,5,a
father,585811,593031,7220,Argentina,A16,o,40,1,a
child,493441,494421,980,Argentina,A16,f,41,1,q
silence,4781,8591,3810,Argentina,A16,NA,NA,NA,NA
silence,13571,14851,1280,Argentina,A16,NA,NA,NA,NA
father_gesture,14913,15944,1031,Argentina,A16,NA,NA,NA,NA
silence,15671,17001,1330,Argentina,A16,NA,NA,NA,NA
child_gesture,24008,25991,1983,Argentina,A16,NA,NA,NA,NA
silence,24151,24181,30,Argentina,A16,NA,NA,NA,NA
child_gesture,28711,29689,978,Argentina,A16,NA,NA,NA,NA
silence,29521,30201,680,Argentina,A16,NA,NA,NA,NA
silence,30981,31371,390,Argentina,A16,NA,NA,NA,NA
child_gesture,31761,32155,394,Argentina,A16,NA,NA,NA,NA
child_gesture,32778,33081,303,Argentina,A16,NA,NA,NA,NA
child_gesture,33670,34223,553,Argentina,A16,NA,NA,NA,NA
silence,33681,33731,50,Argentina,A16,NA,NA,NA,NA
child_gesture,35115,35868,753,Argentina,A16,NA,NA,NA,NA
silence,35291,35391,100,Argentina,A16,NA,NA,NA,NA
child_gesture,36588,37312,724,Argentina,A16,NA,NA,NA,NA
silence,37141,39971,2830,Argentina,A16,NA,NA,NA,NA
silence,40551,42901,2350,Argentina,A16,NA,NA,NA,NA
child_gesture,43441,44113,672,Argentina,A16,NA,NA,NA,NA
father_gesture,44434,46122,1688,Argentina,A16,NA,NA,NA,NA
silence,45401,47371,1970,Argentina,A16,NA,NA,NA,NA
silence,48821,53051,4230,Argentina,A16,NA,NA,NA,NA
silence,54001,54061,60,Argentina,A16,NA,NA,NA,NA
silence,55061,56321,1260,Argentina,A16,NA,NA,NA,NA
silence,57611,57801,190,Argentina,A16,NA,NA,NA,NA
silence,58571,58731,160,Argentina,A16,NA,NA,NA,NA
silence,60111,60271,160,Argentina,A16,NA,NA,NA,NA
silence,60891,60981,90,Argentina,A16,NA,NA,NA,NA
silence,61731,61781,50,Argentina,A16,NA,NA,NA,NA
silence,62441,63301,860,Argentina,A16,NA,NA,NA,NA
silence,64301,64551,250,Argentina,A16,NA,NA,NA,NA
silence,65061,74321,9260,Argentina,A16,NA,NA,NA,NA
silence,76301,82901,6600,Argentina,A16,NA,NA,NA,NA
silence,86201,86301,100,Argentina,A16,NA,NA,NA,NA
silence,87011,87081,70,Argentina,A16,NA,NA,NA,NA
silence,88111,88271,160,Argentina,A16,NA,NA,NA,NA
silence,89381,91021,1640,Argentina,A16,NA,NA,NA,NA
silence,97731,98061,330,Argentina,A16,NA,NA,NA,NA
silence,98751,100931,2180,Argentina,A16,NA,NA,NA,NA
silence,104461,104631,170,Argentina,A16,NA,NA,NA,NA
silence,105201,105331,130,Argentina,A16,NA,NA,NA,NA
silence,106541,109661,3120,Argentina,A16,NA,NA,NA,NA
silence,110661,119301,8640,Argentina,A16,NA,NA,NA,NA
silence,120261,122881,2620,Argentina,A16,NA,NA,NA,NA
silence,123681,127671,3990,Argentina,A16,NA,NA,NA,NA
child_gesture,128089,132761,4672,Argentina,A16,NA,NA,NA,NA
silence,133291,133471,180,Argentina,A16,NA,NA,NA,NA
silence,135121,135411,290,Argentina,A16,NA,NA,NA,NA
silence,136161,142071,5910,Argentina,A16,NA,NA,NA,NA
silence,143271,144051,780,Argentina,A16,NA,NA,NA,NA
silence,144651,158791,14140,Argentina,A16,NA,NA,NA,NA
silence,159831,163611,3780,Argentina,A16,NA,NA,NA,NA
silence,165811,165831,20,Argentina,A16,NA,NA,NA,NA
silence,166411,166631,220,Argentina,A16,NA,NA,NA,NA
child_gesture,167288,168954,1666,Argentina,A16,NA,NA,NA,NA
silence,169291,182991,13700,Argentina,A16,NA,NA,NA,NA
silence,183621,187701,4080,Argentina,A16,NA,NA,NA,NA
silence,188411,189681,1270,Argentina,A16,NA,NA,NA,NA
silence,190481,190711,230,Argentina,A16,NA,NA,NA,NA
silence,191781,191981,200,Argentina,A16,NA,NA,NA,NA
silence,192551,217281,24730,Argentina,A16,NA,NA,NA,NA
silence,218111,232341,14230,Argentina,A16,NA,NA,NA,NA
father_gesture,233258,234369,1111,Argentina,A16,NA,NA,NA,NA
silence,233671,245761,12090,Argentina,A16,NA,NA,NA,NA
silence,246291,252721,6430,Argentina,A16,NA,NA,NA,NA
father_gesture,257964,258793,829,Argentina,A16,NA,NA,NA,NA
silence,263331,267141,3810,Argentina,A16,NA,NA,NA,NA
silence,273471,273561,90,Argentina,A16,NA,NA,NA,NA
silence,274421,278691,4270,Argentina,A16,NA,NA,NA,NA
silence,279391,279441,50,Argentina,A16,NA,NA,NA,NA
silence,288241,290821,2580,Argentina,A16,NA,NA,NA,NA
silence,292021,295571,3550,Argentina,A16,NA,NA,NA,NA
silence,296341,296531,190,Argentina,A16,NA,NA,NA,NA
silence,298221,298391,170,Argentina,A16,NA,NA,NA,NA
silence,299861,341331,41470,Argentina,A16,NA,NA,NA,NA
child_gesture,343064,343688,624,Argentina,A16,NA,NA,NA,NA
silence,347921,349651,1730,Argentina,A16,NA,NA,NA,NA
father_gesture,350181,351621,1440,Argentina,A16,NA,NA,NA,NA
silence,351581,356471,4890,Argentina,A16,NA,NA,NA,NA
silence,357231,358471,1240,Argentina,A16,NA,NA,NA,NA
silence,359351,360041,690,Argentina,A16,NA,NA,NA,NA
silence,361341,363491,2150,Argentina,A16,NA,NA,NA,NA
silence,370851,374671,3820,Argentina,A16,NA,NA,NA,NA
silence,376001,379411,3410,Argentina,A16,NA,NA,NA,NA
silence,380031,382081,2050,Argentina,A16,NA,NA,NA,NA
silence,383551,384021,470,Argentina,A16,NA,NA,NA,NA
silence,386341,388411,2070,Argentina,A16,NA,NA,NA,NA
silence,391761,398041,6280,Argentina,A16,NA,NA,NA,NA
silence,400461,400491,30,Argentina,A16,NA,NA,NA,NA
silence,401111,405711,4600,Argentina,A16,NA,NA,NA,NA
silence,407271,409531,2260,Argentina,A16,NA,NA,NA,NA
silence,421141,421201,60,Argentina,A16,NA,NA,NA,NA
silence,424301,429991,5690,Argentina,A16,NA,NA,NA,NA
silence,433401,442581,9180,Argentina,A16,NA,NA,NA,NA
silence,443401,443521,120,Argentina,A16,NA,NA,NA,NA
silence,444141,444531,390,Argentina,A16,NA,NA,NA,NA
child_gesture,444807,445881,1074,Argentina,A16,NA,NA,NA,NA
silence,448061,452051,3990,Argentina,A16,NA,NA,NA,NA
silence,453091,454951,1860,Argentina,A16,NA,NA,NA,NA
silence,456181,456421,240,Argentina,A16,NA,NA,NA,NA
silence,457451,457931,480,Argentina,A16,NA,NA,NA,NA
silence,459281,459321,40,Argentina,A16,NA,NA,NA,NA
silence,460391,460771,380,Argentina,A16,NA,NA,NA,NA
silence,463741,463771,30,Argentina,A16,NA,NA,NA,NA
silence,464771,468731,3960,Argentina,A16,NA,NA,NA,NA
silence,471211,473771,2560,Argentina,A16,NA,NA,NA,NA
silence,476951,477101,150,Argentina,A16,NA,NA,NA,NA
silence,478061,478101,40,Argentina,A16,NA,NA,NA,NA
silence,480271,480751,480,Argentina,A16,NA,NA,NA,NA
silence,481701,481901,200,Argentina,A16,NA,NA,NA,NA
silence,482701,484571,1870,Argentina,A16,NA,NA,NA,NA
silence,485631,485641,10,Argentina,A16,NA,NA,NA,NA
silence,486851,490911,4060,Argentina,A16,NA,NA,NA,NA
silence,493211,493441,230,Argentina,A16,NA,NA,NA,NA
silence,494421,495111,690,Argentina,A16,NA,NA,NA,NA
silence,496141,496671,530,Argentina,A16,NA,NA,NA,NA
silence,497981,498471,490,Argentina,A16,NA,NA,NA,NA
silence,499681,499951,270,Argentina,A16,NA,NA,NA,NA
silence,502371,502621,250,Argentina,A16,NA,NA,NA,NA
silence,505231,505311,80,Argentina,A16,NA,NA,NA,NA
silence,508291,512101,3810,Argentina,A16,NA,NA,NA,NA
silence,514671,514851,180,Argentina,A16,NA,NA,NA,NA
silence,516351,516371,20,Argentina,A16,NA,NA,NA,NA
child_gesture,517451,519077,1626,Argentina,A16,NA,NA,NA,NA
silence,520281,520811,530,Argentina,A16,NA,NA,NA,NA
silence,523641,525241,1600,Argentina,A16,NA,NA,NA,NA
silence,526831,526881,50,Argentina,A16,NA,NA,NA,NA
silence,528041,528321,280,Argentina,A16,NA,NA,NA,NA
silence,532131,533681,1550,Argentina,A16,NA,NA,NA,NA
silence,535231,535841,610,Argentina,A16,NA,NA,NA,NA
silence,536861,537381,520,Argentina,A16,NA,NA,NA,NA
child_gesture,537773,538774,1001,Argentina,A16,NA,NA,NA,NA
child_gesture,540938,541962,1024,Argentina,A16,NA,NA,NA,NA
silence,541111,541211,100,Argentina,A16,NA,NA,NA,NA
silence,542111,542361,250,Argentina,A16,NA,NA,NA,NA
silence,548481,556551,8070,Argentina,A16,NA,NA,NA,NA
silence,559241,559891,650,Argentina,A16,NA,NA,NA,NA
silence,561041,568511,7470,Argentina,A16,NA,NA,NA,NA
silence,570471,575921,5450,Argentina,A16,NA,NA,NA,NA
silence,578901,584141,5240,Argentina,A16,NA,NA,NA,NA
silence,585071,585811,740,Argentina,A16,NA,NA,NA,NA
mother,1050,4890,3840,Argentina,A17,f,1,1,a
father,1880,2530,650,Argentina,A17,m,1,2,a
father,4610,10790,6180,Argentina,A17,m,1,3,a
child,13690,16080,2390,Argentina,A17,b,2,1,a
father,16370,17350,980,Argentina,A17,c,2,2,q
child,17420,18210,790,Argentina,A17,f,2,3,a
father,19790,20940,1150,Argentina,A17,c,2,4,q
child,21150,23380,2230,Argentina,A17,f,2,5,a
father,23440,26060,2620,Argentina,A17,c,2,6,a
mother,23450,25070,1620,Argentina,A17,c,2,7,a
child,26580,28520,1940,Argentina,A17,f,2,8,a
mother,28930,29500,570,Argentina,A17,b,2,9,a
father,31030,33600,2570,Argentina,A17,b,2,10,a
mother,33480,34380,900,Argentina,A17,f,2,11,a
father,35180,36380,1200,Argentina,A17,c,2,12,a
mother,38120,40230,2110,Argentina,A17,b,3,1,a
father,41660,42720,1060,Argentina,A17,c,3,2,q
father,45320,47040,1720,Argentina,A17,c,3,3,q
father,49190,51240,2050,Argentina,A17,c,3,4,a
child,50240,53330,3090,Argentina,A17,f,3,5,a
father,53030,54090,1060,Argentina,A17,c,3,6,i
mother,53220,58330,5110,Argentina,A17,c,3,7,a
father,57110,72940,15830,Argentina,A17,c,3,8,q
mother,75410,78010,2600,Argentina,A17,c,3,9,a
father,78400,85110,6710,Argentina,A17,c,3,10,a
father,87250,88130,880,Argentina,A17,c,3,11,q
mother,87270,89900,2630,Argentina,A17,c,3,12,a
father,91290,94600,3310,Argentina,A17,c,3,13,a
father,98090,99020,930,Argentina,A17,c,3,14,q
mother,67190,68780,1590,Argentina,A17,f,4,1,q
mother,97930,102350,4420,Argentina,A17,f,5,1,q
father,102680,107610,4930,Argentina,A17,m,5,2,a
child,107370,110880,3510,Argentina,A17,m,6,1,a
mother,111810,113130,1320,Argentina,A17,c,6,2,q
child,113480,115550,2070,Argentina,A17,m,6,3,a
mother,114870,117790,2920,Argentina,A17,c,6,4,a
father,117270,118840,1570,Argentina,A17,c,6,5,q
child,119070,119650,580,Argentina,A17,f,6,6,a
father,119810,120840,1030,Argentina,A17,c,6,7,q
child,121450,124040,2590,Argentina,A17,f,6,8,a
father,123160,127930,4770,Argentina,A17,c,6,9,q
child,124370,125030,660,Argentina,A17,f,6,10,a
mother,124660,125570,910,Argentina,A17,c,6,11,a
child,127970,128730,760,Argentina,A17,f,6,12,a
father,128190,131310,3120,Argentina,A17,c,6,13,a
mother,130600,132200,1600,Argentina,A17,c,6,14,q
father,131580,133950,2370,Argentina,A17,c,6,15,q
child,135000,135630,630,Argentina,A17,f,6,16,a
father,135690,142790,7100,Argentina,A17,c,6,17,a
mother,135770,138050,2280,Argentina,A17,c,6,18,a
mother,140420,148650,8230,Argentina,A17,c,6,19,i
father,149620,153590,3970,Argentina,A17,c,6,20,a
mother,154460,155380,920,Argentina,A17,c,6,21,i
father,158290,159040,750,Argentina,A17,c,6,22,a
mother,158940,160200,1260,Argentina,A17,c,6,23,a
father,160680,161740,1060,Argentina,A17,c,6,24,i
child,161370,162030,660,Argentina,A17,b,6,25,a
father,163770,165850,2080,Argentina,A17,c,6,26,a
mother,164340,165950,1610,Argentina,A17,c,6,27,a
father,168040,169970,1930,Argentina,A17,c,6,28,a
mother,168180,170380,2200,Argentina,A17,c,6,29,a
child,177170,177940,770,Argentina,A17,f,6,30,a
father,178080,181740,3660,Argentina,A17,c,6,31,q
father,185260,186940,1680,Argentina,A17,c,6,32,a
mother,185540,187720,2180,Argentina,A17,c,6,33,a
child,188390,190270,1880,Argentina,A17,f,6,34,a
father,190460,195720,5260,Argentina,A17,c,6,35,q
child,195970,196670,700,Argentina,A17,f,6,36,a
father,196670,201510,4840,Argentina,A17,c,6,37,a
child,203000,203870,870,Argentina,A17,f,6,38,a
father,204110,204750,640,Argentina,A17,c,6,39,q
child,205970,207500,1530,Argentina,A17,f,6,40,a
father,207480,212290,4810,Argentina,A17,c,6,41,a
father,223760,228000,4240,Argentina,A17,c,6,42,a
mother,228150,231940,3790,Argentina,A17,c,8,1,q
father,232550,234520,1970,Argentina,A17,c,8,2,q
child,235310,236840,1530,Argentina,A17,f,8,3,a
mother,236780,238150,1370,Argentina,A17,b,8,4,a
father,236840,238820,1980,Argentina,A17,c,8,5,q
mother,239050,241090,2040,Argentina,A17,f,8,6,a
father,240430,243130,2700,Argentina,A17,c,8,7,q
child,244200,246920,2720,Argentina,A17,f,8,8,a
father,247530,249060,1530,Argentina,A17,c,8,9,q
child,249320,249830,510,Argentina,A17,f,8,10,a
mother,251840,258320,6480,Argentina,A17,c,8,11,q
child,258260,259630,1370,Argentina,A17,m,8,12,a
mother,259440,261490,2050,Argentina,A17,c,8,13,a
father,259610,262520,2910,Argentina,A17,c,8,14,q
mother,262870,265260,2390,Argentina,A17,c,8,15,a
mother,270530,272520,1990,Argentina,A17,c,9,1,q
father,272460,273610,1150,Argentina,A17,c,9,2,q
child,273650,275480,1830,Argentina,A17,f,9,3,a
father,274940,276790,1850,Argentina,A17,c,9,4,a
mother,274950,277650,2700,Argentina,A17,c,9,5,a
father,277160,281540,4380,Argentina,A17,c,9,6,q
mother,278770,280510,1740,Argentina,A17,b,9,7,a
child,281560,283070,1510,Argentina,A17,f,9,8,a
father,282410,284880,2470,Argentina,A17,c,9,9,a
child,283470,285980,2510,Argentina,A17,m,9,10,a
father,285850,289880,4030,Argentina,A17,c,9,11,a
mother,288490,289870,1380,Argentina,A17,c,9,12,a
father,290400,291670,1270,Argentina,A17,c,9,13,a
mother,291630,293780,2150,Argentina,A17,c,9,14,a
child,294910,296530,1620,Argentina,A17,b,9,15,a
father,295610,296170,560,Argentina,A17,c,9,16,q
mother,296560,297600,1040,Argentina,A17,c,9,17,a
father,296840,299410,2570,Argentina,A17,c,9,18,a
child,297320,298380,1060,Argentina,A17,f,9,19,a
mother,299720,300700,980,Argentina,A17,b,9,20,a
father,300540,303910,3370,Argentina,A17,c,9,21,q
father,308530,309790,1260,Argentina,A17,c,9,22,a
father,313980,316390,2410,Argentina,A17,c,9,23,a
mother,316790,318090,1300,Argentina,A17,c,9,24,q
child,318430,320820,2390,Argentina,A17,m,9,25,a
father,320520,321880,1360,Argentina,A17,c,9,26,q
mother,320680,322610,1930,Argentina,A17,c,9,27,a
child,324300,325870,1570,Argentina,A17,b,10,1,a
father,326570,327380,810,Argentina,A17,c,10,2,q
child,327250,328150,900,Argentina,A17,b,10,3,a
mother,328110,328880,770,Argentina,A17,c,10,4,q
child,328960,329440,480,Argentina,A17,m,10,5,a
mother,329630,332470,2840,Argentina,A17,f,10,6,a
father,332360,336340,3980,Argentina,A17,c,10,7,q
mother,338020,339540,1520,Argentina,A17,b,10,8,a
father,341230,341730,500,Argentina,A17,c,10,9,q
mother,341850,342840,990,Argentina,A17,b,10,10,a
child,342310,344750,2440,Argentina,A17,b,10,11,a
father,344810,346190,1380,Argentina,A17,c,10,12,q
mother,346540,347930,1390,Argentina,A17,b,10,13,a
father,347870,348990,1120,Argentina,A17,c,10,14,a
child,351440,352200,760,Argentina,A17,f,10,15,a
father,351770,355870,4100,Argentina,A17,c,10,16,q
mother,355210,358380,3170,Argentina,A17,f,10,17,a
father,358960,359990,1030,Argentina,A17,m,10,18,q
mother,359920,361370,1450,Argentina,A17,f,10,19,a
father,361420,365460,4040,Argentina,A17,b,10,20,a
child,363950,366500,2550,Argentina,A17,f,10,21,a
mother,371010,372010,1000,Argentina,A17,f,10,22,i
father,372640,374990,2350,Argentina,A17,m,10,23,a
child,376020,376930,910,Argentina,A17,f,10,24,a
father,376870,377800,930,Argentina,A17,c,10,25,q
mother,378610,379900,1290,Argentina,A17,c,10,26,a
father,380360,383630,3270,Argentina,A17,c,10,27,a
father,394190,395590,1400,Argentina,A17,m,11,1,a
mother,403450,404270,820,Argentina,A17,f,11,2,q
child,394670,396190,1520,Argentina,A17,m,12,1,a
mother,396370,400730,4360,Argentina,A17,c,12,2,a
child,406650,407700,1050,Argentina,A17,m,12,3,a
mother,409330,410470,1140,Argentina,A17,c,12,4,q
child,411520,412430,910,Argentina,A17,m,12,5,a
mother,412570,413920,1350,Argentina,A17,c,12,6,q
child,414790,419410,4620,Argentina,A17,b,12,7,a
father,418810,419670,860,Argentina,A17,c,12,8,a
father,423100,424010,910,Argentina,A17,c,12,9,q
mother,423260,424760,1500,Argentina,A17,c,12,10,a
father,425350,427360,2010,Argentina,A17,c,12,11,q
child,427850,428570,720,Argentina,A17,f,12,12,a
father,428800,431530,2730,Argentina,A17,c,12,13,q
mother,428850,429850,1000,Argentina,A17,c,12,14,a
child,432450,434620,2170,Argentina,A17,m,13,1,a
mother,434330,442670,8340,Argentina,A17,c,13,2,q
mother,447650,448890,1240,Argentina,A17,c,13,3,q
child,447690,449120,1430,Argentina,A17,b,13,4,a
father,449170,449950,780,Argentina,A17,c,13,5,q
mother,449880,451120,1240,Argentina,A17,b,13,6,a
father,453100,454020,920,Argentina,A17,c,13,7,a
child,454490,455540,1050,Argentina,A17,b,13,8,a
mother,455690,456530,840,Argentina,A17,c,13,9,q
child,456770,457480,710,Argentina,A17,m,13,10,a
father,457060,460610,3550,Argentina,A17,c,13,11,a
child,460610,462090,1480,Argentina,A17,f,13,12,a
mother,461860,463660,1800,Argentina,A17,c,13,13,a
father,461880,462780,900,Argentina,A17,c,13,14,q
mother,465470,466880,1410,Argentina,A17,f,13,15,a
father,466980,469800,2820,Argentina,A17,c,13,16,a
mother,469780,471170,1390,Argentina,A17,b,13,17,a
father,474930,478510,3580,Argentina,A17,m,14,1,a
mother,478070,480610,2540,Argentina,A17,f,14,2,a
child,479920,480630,710,Argentina,A17,f,14,3,a
father,480630,481330,700,Argentina,A17,c,14,4,a
mother,481270,483230,1960,Argentina,A17,c,14,5,q
father,483780,485480,1700,Argentina,A17,m,14,6,a
mother,485350,485920,570,Argentina,A17,f,14,7,a
child,489320,490940,1620,Argentina,A17,f,14,8,a
mother,491120,492350,1230,Argentina,A17,c,14,9,a
father,497470,504140,6670,Argentina,A17,c,14,10,q
mother,497690,498660,970,Argentina,A17,c,14,11,a
father,491130,497020,5890,Argentina,A17,c,15,1,q
father,505320,510170,4850,Argentina,A17,c,15,2,a
father,512940,517820,4880,Argentina,A17,b,15,3,a
mother,515480,518620,3140,Argentina,A17,b,15,4,a
father,518530,519420,890,Argentina,A17,c,15,5,a
mother,521170,522760,1590,Argentina,A17,b,15,6,a
father,523240,524950,1710,Argentina,A17,c,15,7,q
child,509830,514000,4170,Argentina,A17,b,16,1,a
child,525920,527630,1710,Argentina,A17,b,17,1,a
father,527660,529800,2140,Argentina,A17,c,17,2,q
child,528550,530380,1830,Argentina,A17,f,17,3,a
father,531130,531670,540,Argentina,A17,c,17,4,q
child,532430,533000,570,Argentina,A17,f,17,5,a
father,533150,534770,1620,Argentina,A17,c,17,6,a
child,534650,536230,1580,Argentina,A17,f,17,7,a
father,536210,537280,1070,Argentina,A17,c,17,8,q
child,536910,537560,650,Argentina,A17,f,17,9,a
mother,538490,539150,660,Argentina,A17,c,17,10,a
father,539150,541420,2270,Argentina,A17,c,17,11,a
father,546010,547670,1660,Argentina,A17,c,17,12,a
child,547660,548530,870,Argentina,A17,f,17,13,a
child,550810,553600,2790,Argentina,A17,f,17,14,a
father,553650,554760,1110,Argentina,A17,c,17,15,q
child,554780,555390,610,Argentina,A17,f,17,16,a
father,557120,559740,2620,Argentina,A17,c,17,17,q
child,559820,560350,530,Argentina,A17,f,17,18,a
father,561350,562250,900,Argentina,A17,c,17,19,a
mother,561520,563370,1850,Argentina,A17,b,17,20,a
father,565050,575700,10650,Argentina,A17,c,17,21,q
child,575590,577010,1420,Argentina,A17,f,17,22,a
father,577060,577770,710,Argentina,A17,c,17,23,q
child,577610,578230,620,Argentina,A17,f,17,24,a
father,578500,585310,6810,Argentina,A17,c,17,25,i
mother,585960,587290,1330,Argentina,A17,c,17,26,a
father,588500,590070,1570,Argentina,A17,c,17,27,a
mother,592080,593090,1010,Argentina,A17,c,17,28,q
child,595620,596100,480,Argentina,A17,m,17,29,a
mother,596280,597430,1150,Argentina,A17,c,17,30,q
silence,810,1050,240,Argentina,A17,NA,NA,NA,NA
silence,10790,13690,2900,Argentina,A17,NA,NA,NA,NA
child_gesture,13764,18154,4390,Argentina,A17,NA,NA,NA,NA
silence,16080,16370,290,Argentina,A17,NA,NA,NA,NA
silence,17350,17420,70,Argentina,A17,NA,NA,NA,NA
silence,18210,19790,1580,Argentina,A17,NA,NA,NA,NA
silence,20940,21150,210,Argentina,A17,NA,NA,NA,NA
child_gesture,21222,23051,1829,Argentina,A17,NA,NA,NA,NA
silence,23380,23440,60,Argentina,A17,NA,NA,NA,NA
silence,26060,26580,520,Argentina,A17,NA,NA,NA,NA
silence,28520,28930,410,Argentina,A17,NA,NA,NA,NA
silence,29500,31030,1530,Argentina,A17,NA,NA,NA,NA
silence,34380,35180,800,Argentina,A17,NA,NA,NA,NA
silence,36380,38120,1740,Argentina,A17,NA,NA,NA,NA
silence,40230,41660,1430,Argentina,A17,NA,NA,NA,NA
silence,42720,45320,2600,Argentina,A17,NA,NA,NA,NA
silence,47040,49190,2150,Argentina,A17,NA,NA,NA,NA
child_gesture,49528,59374,9846,Argentina,A17,NA,NA,NA,NA
father_gesture,57350,58470,1120,Argentina,A17,NA,NA,NA,NA
mother_gesture,66079,68191,2112,Argentina,A17,NA,NA,NA,NA
silence,72940,75410,2470,Argentina,A17,NA,NA,NA,NA
silence,78010,78400,390,Argentina,A17,NA,NA,NA,NA
father_gesture,83212,85133,1921,Argentina,A17,NA,NA,NA,NA
silence,85110,87250,2140,Argentina,A17,NA,NA,NA,NA
silence,89900,91290,1390,Argentina,A17,NA,NA,NA,NA
father_gesture,92770,94680,1910,Argentina,A17,NA,NA,NA,NA
silence,94600,97930,3330,Argentina,A17,NA,NA,NA,NA
mother_gesture,97930,99716,1786,Argentina,A17,NA,NA,NA,NA
silence,102350,102680,330,Argentina,A17,NA,NA,NA,NA
child_gesture,109450,111208,1758,Argentina,A17,NA,NA,NA,NA
silence,110880,111810,930,Argentina,A17,NA,NA,NA,NA
silence,113130,113480,350,Argentina,A17,NA,NA,NA,NA
silence,118840,119070,230,Argentina,A17,NA,NA,NA,NA
child_gesture,119390,123179,3789,Argentina,A17,NA,NA,NA,NA
silence,119650,119810,160,Argentina,A17,NA,NA,NA,NA
silence,120840,121450,610,Argentina,A17,NA,NA,NA,NA
child_gesture,127894,130594,2700,Argentina,A17,NA,NA,NA,NA
silence,127930,127970,40,Argentina,A17,NA,NA,NA,NA
silence,133950,135000,1050,Argentina,A17,NA,NA,NA,NA
silence,135630,135690,60,Argentina,A17,NA,NA,NA,NA
silence,148650,149620,970,Argentina,A17,NA,NA,NA,NA
silence,153590,154460,870,Argentina,A17,NA,NA,NA,NA
silence,155380,158290,2910,Argentina,A17,NA,NA,NA,NA
silence,160200,160680,480,Argentina,A17,NA,NA,NA,NA
silence,162030,163770,1740,Argentina,A17,NA,NA,NA,NA
silence,165950,168040,2090,Argentina,A17,NA,NA,NA,NA
silence,170380,177170,6790,Argentina,A17,NA,NA,NA,NA
silence,177940,178080,140,Argentina,A17,NA,NA,NA,NA
silence,181740,185260,3520,Argentina,A17,NA,NA,NA,NA
silence,187720,188390,670,Argentina,A17,NA,NA,NA,NA
silence,190270,190460,190,Argentina,A17,NA,NA,NA,NA
silence,195720,195970,250,Argentina,A17,NA,NA,NA,NA
silence,201510,203000,1490,Argentina,A17,NA,NA,NA,NA
silence,203870,204110,240,Argentina,A17,NA,NA,NA,NA
silence,204750,205970,1220,Argentina,A17,NA,NA,NA,NA
silence,212290,223760,11470,Argentina,A17,NA,NA,NA,NA
silence,228000,228150,150,Argentina,A17,NA,NA,NA,NA
silence,231940,232550,610,Argentina,A17,NA,NA,NA,NA
silence,234520,235310,790,Argentina,A17,NA,NA,NA,NA
silence,238820,239050,230,Argentina,A17,NA,NA,NA,NA
father_gesture,242400,243495,1095,Argentina,A17,NA,NA,NA,NA
silence,243130,244200,1070,Argentina,A17,NA,NA,NA,NA
silence,246920,247530,610,Argentina,A17,NA,NA,NA,NA
silence,249060,249320,260,Argentina,A17,NA,NA,NA,NA
silence,249830,251840,2010,Argentina,A17,NA,NA,NA,NA
silence,262520,262870,350,Argentina,A17,NA,NA,NA,NA
silence,265260,270530,5270,Argentina,A17,NA,NA,NA,NA
silence,273610,273650,40,Argentina,A17,NA,NA,NA,NA
silence,281540,281560,20,Argentina,A17,NA,NA,NA,NA
silence,289880,290400,520,Argentina,A17,NA,NA,NA,NA
silence,293780,294910,1130,Argentina,A17,NA,NA,NA,NA
child_gesture,295688,297814,2126,Argentina,A17,NA,NA,NA,NA
silence,296530,296560,30,Argentina,A17,NA,NA,NA,NA
silence,299410,299720,310,Argentina,A17,NA,NA,NA,NA
silence,303910,308530,4620,Argentina,A17,NA,NA,NA,NA
silence,309790,313980,4190,Argentina,A17,NA,NA,NA,NA
silence,316390,316790,400,Argentina,A17,NA,NA,NA,NA
silence,318090,318430,340,Argentina,A17,NA,NA,NA,NA
silence,322610,324300,1690,Argentina,A17,NA,NA,NA,NA
child_gesture,323674,329325,5651,Argentina,A17,NA,NA,NA,NA
silence,325870,326570,700,Argentina,A17,NA,NA,NA,NA
silence,328880,328960,80,Argentina,A17,NA,NA,NA,NA
silence,329440,329630,190,Argentina,A17,NA,NA,NA,NA
silence,336340,338020,1680,Argentina,A17,NA,NA,NA,NA
silence,339540,341230,1690,Argentina,A17,NA,NA,NA,NA
silence,341730,341850,120,Argentina,A17,NA,NA,NA,NA
child_gesture,342627,346825,4198,Argentina,A17,NA,NA,NA,NA
silence,344750,344810,60,Argentina,A17,NA,NA,NA,NA
silence,346190,346540,350,Argentina,A17,NA,NA,NA,NA
silence,348990,351440,2450,Argentina,A17,NA,NA,NA,NA
silence,358380,358960,580,Argentina,A17,NA,NA,NA,NA
silence,361370,361420,50,Argentina,A17,NA,NA,NA,NA
child_gesture,363760,364640,880,Argentina,A17,NA,NA,NA,NA
child_gesture,365000,366922,1922,Argentina,A17,NA,NA,NA,NA
silence,366500,371010,4510,Argentina,A17,NA,NA,NA,NA
silence,372010,372640,630,Argentina,A17,NA,NA,NA,NA
silence,374990,376020,1030,Argentina,A17,NA,NA,NA,NA
silence,377800,378610,810,Argentina,A17,NA,NA,NA,NA
silence,379900,380360,460,Argentina,A17,NA,NA,NA,NA
father_gesture,380974,382683,1709,Argentina,A17,NA,NA,NA,NA
silence,383630,394190,10560,Argentina,A17,NA,NA,NA,NA
father_gesture,394108,395566,1458,Argentina,A17,NA,NA,NA,NA
silence,396190,396370,180,Argentina,A17,NA,NA,NA,NA
silence,400730,403450,2720,Argentina,A17,NA,NA,NA,NA
silence,404270,406650,2380,Argentina,A17,NA,NA,NA,NA
silence,407700,409330,1630,Argentina,A17,NA,NA,NA,NA
silence,410470,411520,1050,Argentina,A17,NA,NA,NA,NA
silence,412430,412570,140,Argentina,A17,NA,NA,NA,NA
silence,413920,414790,870,Argentina,A17,NA,NA,NA,NA
silence,419670,423100,3430,Argentina,A17,NA,NA,NA,NA
silence,424760,425350,590,Argentina,A17,NA,NA,NA,NA
silence,427360,427850,490,Argentina,A17,NA,NA,NA,NA
silence,428570,428800,230,Argentina,A17,NA,NA,NA,NA
silence,431530,432450,920,Argentina,A17,NA,NA,NA,NA
child_gesture,432589,434080,1491,Argentina,A17,NA,NA,NA,NA
mother_gesture,439833,441179,1346,Argentina,A17,NA,NA,NA,NA
silence,442670,447650,4980,Argentina,A17,NA,NA,NA,NA
silence,449120,449170,50,Argentina,A17,NA,NA,NA,NA
silence,451120,453100,1980,Argentina,A17,NA,NA,NA,NA
silence,454020,454490,470,Argentina,A17,NA,NA,NA,NA
child_gesture,454741,456887,2146,Argentina,A17,NA,NA,NA,NA
silence,455540,455690,150,Argentina,A17,NA,NA,NA,NA
silence,456530,456770,240,Argentina,A17,NA,NA,NA,NA
silence,463660,465470,1810,Argentina,A17,NA,NA,NA,NA
silence,466880,466980,100,Argentina,A17,NA,NA,NA,NA
silence,471170,474930,3760,Argentina,A17,NA,NA,NA,NA
father_gesture,477752,478882,1130,Argentina,A17,NA,NA,NA,NA
silence,483230,483780,550,Argentina,A17,NA,NA,NA,NA
silence,485920,489320,3400,Argentina,A17,NA,NA,NA,NA
silence,490940,491120,180,Argentina,A17,NA,NA,NA,NA
silence,497020,497470,450,Argentina,A17,NA,NA,NA,NA
silence,504140,505320,1180,Argentina,A17,NA,NA,NA,NA
silence,519420,521170,1750,Argentina,A17,NA,NA,NA,NA
silence,522760,523240,480,Argentina,A17,NA,NA,NA,NA
silence,524950,525920,970,Argentina,A17,NA,NA,NA,NA
silence,527630,527660,30,Argentina,A17,NA,NA,NA,NA
silence,530380,531130,750,Argentina,A17,NA,NA,NA,NA
silence,531670,532430,760,Argentina,A17,NA,NA,NA,NA
silence,533000,533150,150,Argentina,A17,NA,NA,NA,NA
silence,537560,538490,930,Argentina,A17,NA,NA,NA,NA
silence,541420,546010,4590,Argentina,A17,NA,NA,NA,NA
child_gesture,547610,549099,1489,Argentina,A17,NA,NA,NA,NA
silence,548530,550810,2280,Argentina,A17,NA,NA,NA,NA
child_gesture,551140,553650,2510,Argentina,A17,NA,NA,NA,NA
silence,553600,553650,50,Argentina,A17,NA,NA,NA,NA
silence,554760,554780,20,Argentina,A17,NA,NA,NA,NA
silence,555390,557120,1730,Argentina,A17,NA,NA,NA,NA
silence,559740,559820,80,Argentina,A17,NA,NA,NA,NA
silence,560350,561350,1000,Argentina,A17,NA,NA,NA,NA
silence,563370,565050,1680,Argentina,A17,NA,NA,NA,NA
father_gesture,571963,573552,1589,Argentina,A17,NA,NA,NA,NA
child_gesture,575138,577452,2314,Argentina,A17,NA,NA,NA,NA
silence,577010,577060,50,Argentina,A17,NA,NA,NA,NA
silence,578230,578500,270,Argentina,A17,NA,NA,NA,NA
silence,585310,585960,650,Argentina,A17,NA,NA,NA,NA
silence,587290,588500,1210,Argentina,A17,NA,NA,NA,NA
silence,590070,592080,2010,Argentina,A17,NA,NA,NA,NA
child_gesture,591394,593481,2087,Argentina,A17,NA,NA,NA,NA
silence,593090,595620,2530,Argentina,A17,NA,NA,NA,NA
silence,596100,596280,180,Argentina,A17,NA,NA,NA,NA
child,3620,4660,1040,Argentina,A18,m,1,1,a
mother,5320,6320,1000,Argentina,A18,c,1,2,a
child,6610,7600,990,Argentina,A18,m,1,3,a
mother,7580,8270,690,Argentina,A18,c,1,4,a
mother,10540,11170,630,Argentina,A18,c,1,5,a
father,13020,14240,1220,Argentina,A18,m,2,1,a
mother,15200,17190,1990,Argentina,A18,f,2,2,a
father,18290,18810,520,Argentina,A18,m,2,3,a
father,23520,24150,630,Argentina,A18,m,3,1,q
mother,25610,26160,550,Argentina,A18,f,3,2,a
child,32420,33640,1220,Argentina,A18,m,4,1,q
father,34390,34830,440,Argentina,A18,c,4,2,a
mother,35110,35780,670,Argentina,A18,c,4,3,a
child,35120,37570,2450,Argentina,A18,m,4,4,q
mother,37610,38260,650,Argentina,A18,c,4,5,q
child,38460,39240,780,Argentina,A18,m,4,6,a
mother,39280,39940,660,Argentina,A18,c,4,7,q
child,40100,40910,810,Argentina,A18,m,4,8,a
mother,41030,41760,730,Argentina,A18,c,4,9,a
child,42270,46240,3970,Argentina,A18,f,4,10,q
father,45620,46700,1080,Argentina,A18,c,4,11,a
child,48080,48650,570,Argentina,A18,f,4,12,q
mother,48680,50790,2110,Argentina,A18,c,4,13,q
father,50290,51230,940,Argentina,A18,c,4,14,q
child,52330,54150,1820,Argentina,A18,f,4,15,a
father,54430,55940,1510,Argentina,A18,c,4,16,q
child,55000,55710,710,Argentina,A18,b,4,17,a
mother,55610,56930,1320,Argentina,A18,c,4,18,a
child,58270,61784,3514,Argentina,A18,f,4,19,a
mother,62150,62750,600,Argentina,A18,c,4,20,a
child,65690,68060,2370,Argentina,A18,f,5,1,q
father,68230,68980,750,Argentina,A18,c,5,2,a
father,72100,73260,1160,Argentina,A18,c,5,3,a
child,73690,75710,2020,Argentina,A18,f,5,4,q
father,76090,76590,500,Argentina,A18,c,5,5,a
child,77920,78710,790,Argentina,A18,f,5,6,q
father,80630,81300,670,Argentina,A18,c,5,7,a
child,82320,83230,910,Argentina,A18,b,5,8,q
father,84290,84810,520,Argentina,A18,c,5,9,a
father,90590,91240,650,Argentina,A18,m,6,1,a
mother,91940,92890,950,Argentina,A18,f,6,2,q
father,94750,95340,590,Argentina,A18,m,6,3,a
child,99510,100300,790,Argentina,A18,f,7,1,q
father,100650,101190,540,Argentina,A18,c,7,2,q
child,102090,105360,3270,Argentina,A18,f,7,3,q
father,106660,109010,2350,Argentina,A18,c,7,4,i
father,112310,114050,1740,Argentina,A18,c,7,5,a
child,115230,116160,930,Argentina,A18,f,7,6,a
father,116180,116860,680,Argentina,A18,c,7,7,q
child,116540,118330,1790,Argentina,A18,f,7,8,a
father,118840,119530,690,Argentina,A18,c,7,9,q
mother,119710,120550,840,Argentina,A18,f,7,10,a
father,120500,121100,600,Argentina,A18,m,7,11,a
child,122670,124220,1550,Argentina,A18,f,7,12,q
father,125360,126000,640,Argentina,A18,c,7,13,a
child,126580,131160,4580,Argentina,A18,f,7,14,a
father,131830,132510,680,Argentina,A18,c,7,15,a
child,133330,135850,2520,Argentina,A18,f,7,16,q
father,136260,141370,5110,Argentina,A18,c,7,17,a
child,144240,148620,4380,Argentina,A18,f,7,18,q
mother,151360,152890,1530,Argentina,A18,c,9,1,q
mother,156470,157260,790,Argentina,A18,c,9,2,q
child,157960,158680,720,Argentina,A18,m,9,3,a
child,162040,162910,870,Argentina,A18,b,9,4,q
mother,162950,163670,720,Argentina,A18,c,9,5,a
child,164220,165710,1490,Argentina,A18,m,9,6,q
mother,164860,166590,1730,Argentina,A18,f,10,1,q
father,166710,167940,1230,Argentina,A18,m,10,2,a
father,177230,178910,1680,Argentina,A18,m,10,3,a
mother,178560,179200,640,Argentina,A18,f,10,4,a
mother,181920,183420,1500,Argentina,A18,f,10,5,a
mother,186730,188070,1340,Argentina,A18,f,10,6,q
father,187490,189080,1590,Argentina,A18,m,10,7,a
mother,189160,192310,3150,Argentina,A18,f,10,8,a
father,192760,194140,1380,Argentina,A18,m,10,9,q
child,199270,200640,1370,Argentina,A18,m,10,10,q
mother,201080,201760,680,Argentina,A18,c,10,11,a
child,201930,204120,2190,Argentina,A18,m,10,12,q
mother,204200,205700,1500,Argentina,A18,c,10,13,q
child,205760,207250,1490,Argentina,A18,m,10,14,a
mother,207290,208250,960,Argentina,A18,c,10,15,q
child,208260,208740,480,Argentina,A18,m,10,16,a
mother,209670,211240,1570,Argentina,A18,c,10,17,q
child,211270,211690,420,Argentina,A18,m,10,18,a
child,169490,173900,4410,Argentina,A18,m,11,1,q
child,176580,177600,1020,Argentina,A18,m,11,2,q
mother,213710,214570,860,Argentina,A18,c,13,1,q
child,215150,216040,890,Argentina,A18,m,13,2,a
mother,216900,217870,970,Argentina,A18,c,13,3,q
child,218720,223670,4950,Argentina,A18,f,13,4,a
father,223430,226820,3390,Argentina,A18,c,13,5,a
mother,227150,228680,1530,Argentina,A18,c,13,6,a
child,229240,231150,1910,Argentina,A18,m,13,7,q
mother,231010,232010,1000,Argentina,A18,c,13,8,a
father,232500,233880,1380,Argentina,A18,m,13,9,a
mother,234400,236210,1810,Argentina,A18,c,13,10,a
child,240230,242360,2130,Argentina,A18,m,13,11,a
mother,243980,246880,2900,Argentina,A18,c,14,1,i
child,251640,252350,710,Argentina,A18,m,14,2,a
mother,260700,266300,5600,Argentina,A18,o,15,1,a
mother,268260,270470,2210,Argentina,A18,f,16,1,a
father,269740,270590,850,Argentina,A18,m,16,2,a
mother,277110,278040,930,Argentina,A18,c,17,1,q
child,278680,280000,1320,Argentina,A18,m,17,2,a
father,281160,282960,1800,Argentina,A18,c,17,3,a
mother,283310,284620,1310,Argentina,A18,c,17,4,i
child,284840,285910,1070,Argentina,A18,m,17,5,q
mother,285970,287000,1030,Argentina,A18,c,17,6,i
child,289790,290900,1110,Argentina,A18,m,17,7,a
child,295010,298430,3420,Argentina,A18,m,18,1,q
mother,298550,302980,4430,Argentina,A18,c,18,2,i
child,301370,302970,1600,Argentina,A18,m,18,3,a
mother,303110,303870,760,Argentina,A18,c,19,1,i
mother,308780,309760,980,Argentina,A18,c,19,2,i
child,328790,329730,940,Argentina,A18,f,20,1,q
child,332410,334550,2140,Argentina,A18,f,20,2,q
father,334410,335270,860,Argentina,A18,c,20,3,a
child,340100,342510,2410,Argentina,A18,f,20,4,q
father,343390,344550,1160,Argentina,A18,c,20,5,a
child,344850,345520,670,Argentina,A18,f,20,6,a
child,347690,349680,1990,Argentina,A18,f,20,7,q
mother,349330,350300,970,Argentina,A18,c,20,8,a
child,350750,352320,1570,Argentina,A18,f,20,9,q
father,352820,354010,1190,Argentina,A18,m,20,10,a
child,355180,359410,4230,Argentina,A18,f,20,11,q
father,359720,361660,1940,Argentina,A18,c,20,12,a
child,361880,362690,810,Argentina,A18,f,20,13,a
child,371100,372000,900,Argentina,A18,b,20,14,a
mother,372390,374680,2290,Argentina,A18,f,21,1,a
father,374840,375380,540,Argentina,A18,m,21,2,q
father,377490,380644,3154,Argentina,A18,m,21,3,q
mother,381060,383430,2370,Argentina,A18,f,21,4,a
father,387390,388630,1240,Argentina,A18,m,21,5,q
mother,388790,391890,3100,Argentina,A18,f,21,6,a
father,395550,396400,850,Argentina,A18,m,21,7,q
mother,397040,398750,1710,Argentina,A18,f,21,8,a
father,399050,400630,1580,Argentina,A18,m,21,9,q
mother,401780,403330,1550,Argentina,A18,f,21,10,a
mother,407640,408180,540,Argentina,A18,f,21,11,a
mother,410350,442240,31890,Argentina,A18,f,21,12,a
father,417280,417730,450,Argentina,A18,m,21,13,a
father,422250,423010,760,Argentina,A18,m,21,14,a
father,443870,446210,2340,Argentina,A18,m,21,15,a
mother,447750,448690,940,Argentina,A18,f,21,16,a
father,452600,454220,1620,Argentina,A18,m,21,17,a
mother,457990,460650,2660,Argentina,A18,c,21,18,q
child,460950,462780,1830,Argentina,A18,m,21,19,a
mother,462430,463120,690,Argentina,A18,c,21,20,q
child,464370,464820,450,Argentina,A18,m,21,21,a
mother,465170,465830,660,Argentina,A18,c,21,22,q
child,465880,466320,440,Argentina,A18,m,21,23,a
mother,466420,466870,450,Argentina,A18,c,21,24,q
child,466970,467460,490,Argentina,A18,m,21,25,a
mother,468490,469940,1450,Argentina,A18,c,21,26,q
child,473720,475990,2270,Argentina,A18,m,21,27,a
mother,476030,476900,870,Argentina,A18,c,21,28,q
child,476880,477470,590,Argentina,A18,m,21,29,a
father,477090,478770,1680,Argentina,A18,c,21,30,a
mother,478420,479890,1470,Argentina,A18,c,21,31,a
child,480250,481650,1400,Argentina,A18,m,21,32,q
mother,481410,482260,850,Argentina,A18,c,21,33,q
child,484060,484560,500,Argentina,A18,m,21,34,a
mother,485470,486310,840,Argentina,A18,c,21,35,q
child,487470,489990,2520,Argentina,A18,m,21,36,a
mother,489380,491680,2300,Argentina,A18,c,21,37,q
father,491390,492340,950,Argentina,A18,m,21,38,a
father,494570,495470,900,Argentina,A18,c,21,39,a
mother,497050,498040,990,Argentina,A18,c,21,40,q
child,498190,498770,580,Argentina,A18,m,21,41,a
mother,498830,499630,800,Argentina,A18,c,21,42,q
child,499800,500460,660,Argentina,A18,m,21,43,a
mother,501970,505060,3090,Argentina,A18,f,21,44,a
child,505220,506240,1020,Argentina,A18,m,21,45,q
mother,506470,507000,530,Argentina,A18,c,21,46,q
child,507170,508290,1120,Argentina,A18,m,21,47,a
mother,510240,511170,930,Argentina,A18,c,21,48,q
child,511360,511840,480,Argentina,A18,m,21,49,a
mother,512100,512610,510,Argentina,A18,c,21,50,a
child,513190,514050,860,Argentina,A18,m,21,51,q
mother,514140,517460,3320,Argentina,A18,c,21,52,a
child,517120,523050,5930,Argentina,A18,m,21,53,a
mother,523300,524790,1490,Argentina,A18,c,21,54,a
child,526550,527340,790,Argentina,A18,m,21,55,q
child,451380,451990,610,Argentina,A18,m,22,1,a
child,455010,456630,1620,Argentina,A18,f,23,1,a
mother,532070,532970,900,Argentina,A18,c,24,1,i
child,535070,537750,2680,Argentina,A18,m,24,2,a
mother,537850,540850,3000,Argentina,A18,c,24,3,i
father,540870,549400,8530,Argentina,A18,c,24,4,a
mother,549360,550120,760,Argentina,A18,f,24,5,a
father,550120,556490,6370,Argentina,A18,c,24,6,a
child,556630,558110,1480,Argentina,A18,f,24,7,a
father,558050,558920,870,Argentina,A18,c,24,8,i
child,559600,564010,4410,Argentina,A18,f,24,9,a
father,564510,565460,950,Argentina,A18,b,24,10,q
mother,565300,568600,3300,Argentina,A18,f,24,11,a
father,566350,570340,3990,Argentina,A18,c,24,12,i
child,570580,571830,1250,Argentina,A18,f,24,13,a
mother,571840,572970,1130,Argentina,A18,c,24,14,q
father,573260,573920,660,Argentina,A18,c,24,15,a
child,574190,575540,1350,Argentina,A18,f,24,16,a
father,575470,576910,1440,Argentina,A18,c,24,17,a
child,577330,578050,720,Argentina,A18,f,24,18,a
mother,578010,580790,2780,Argentina,A18,c,24,19,i
child,581810,582770,960,Argentina,A18,m,24,20,q
mother,582700,584480,1780,Argentina,A18,c,24,21,i
father,584340,585280,940,Argentina,A18,c,24,22,i
mother,584910,589920,5010,Argentina,A18,c,24,23,i
father,589270,591920,2650,Argentina,A18,m,24,24,a
child,592060,595810,3750,Argentina,A18,m,24,25,a
father,596670,599200,2530,Argentina,A18,c,24,26,a
child_gesture,2906,4891,1985,Argentina,A18,NA,NA,NA,NA
silence,4660,5320,660,Argentina,A18,NA,NA,NA,NA
silence,6320,6610,290,Argentina,A18,NA,NA,NA,NA
silence,8270,10540,2270,Argentina,A18,NA,NA,NA,NA
silence,11170,13020,1850,Argentina,A18,NA,NA,NA,NA
silence,14240,15200,960,Argentina,A18,NA,NA,NA,NA
silence,17190,18290,1100,Argentina,A18,NA,NA,NA,NA
silence,18810,23520,4710,Argentina,A18,NA,NA,NA,NA
silence,24150,25610,1460,Argentina,A18,NA,NA,NA,NA
silence,26160,32420,6260,Argentina,A18,NA,NA,NA,NA
child_gesture,32573,35628,3055,Argentina,A18,NA,NA,NA,NA
silence,33640,34390,750,Argentina,A18,NA,NA,NA,NA
silence,34830,35110,280,Argentina,A18,NA,NA,NA,NA
silence,37570,37610,40,Argentina,A18,NA,NA,NA,NA
mother_gesture,37633,38636,1003,Argentina,A18,NA,NA,NA,NA
silence,38260,38460,200,Argentina,A18,NA,NA,NA,NA
silence,39240,39280,40,Argentina,A18,NA,NA,NA,NA
mother_gesture,39571,40763,1192,Argentina,A18,NA,NA,NA,NA
silence,39940,40100,160,Argentina,A18,NA,NA,NA,NA
silence,40910,41030,120,Argentina,A18,NA,NA,NA,NA
silence,41760,42270,510,Argentina,A18,NA,NA,NA,NA
child_gesture,42329,44232,1903,Argentina,A18,NA,NA,NA,NA
child_gesture,45003,46834,1831,Argentina,A18,NA,NA,NA,NA
father_gesture,45220,46861,1641,Argentina,A18,NA,NA,NA,NA
silence,46700,48080,1380,Argentina,A18,NA,NA,NA,NA
child_gesture,47908,49318,1410,Argentina,A18,NA,NA,NA,NA
silence,48650,48680,30,Argentina,A18,NA,NA,NA,NA
silence,51230,52330,1100,Argentina,A18,NA,NA,NA,NA
silence,54150,54430,280,Argentina,A18,NA,NA,NA,NA
silence,56930,58270,1340,Argentina,A18,NA,NA,NA,NA
silence,61784,62150,366,Argentina,A18,NA,NA,NA,NA
silence,62750,65690,2940,Argentina,A18,NA,NA,NA,NA
silence,68060,68230,170,Argentina,A18,NA,NA,NA,NA
silence,68980,72100,3120,Argentina,A18,NA,NA,NA,NA
father_gesture,71480,73471,1991,Argentina,A18,NA,NA,NA,NA
silence,73260,73690,430,Argentina,A18,NA,NA,NA,NA
silence,75710,76090,380,Argentina,A18,NA,NA,NA,NA
silence,76590,77920,1330,Argentina,A18,NA,NA,NA,NA
child_gesture,78012,79512,1500,Argentina,A18,NA,NA,NA,NA
silence,78710,80630,1920,Argentina,A18,NA,NA,NA,NA
silence,81300,82320,1020,Argentina,A18,NA,NA,NA,NA
silence,83230,84290,1060,Argentina,A18,NA,NA,NA,NA
silence,84810,90590,5780,Argentina,A18,NA,NA,NA,NA
silence,91240,91940,700,Argentina,A18,NA,NA,NA,NA
silence,92890,94750,1860,Argentina,A18,NA,NA,NA,NA
silence,95340,99510,4170,Argentina,A18,NA,NA,NA,NA
silence,100300,100650,350,Argentina,A18,NA,NA,NA,NA
silence,101190,102090,900,Argentina,A18,NA,NA,NA,NA
child_gesture,102543,104356,1813,Argentina,A18,NA,NA,NA,NA
silence,105360,106660,1300,Argentina,A18,NA,NA,NA,NA
silence,109010,112310,3300,Argentina,A18,NA,NA,NA,NA
silence,114050,115230,1180,Argentina,A18,NA,NA,NA,NA
silence,116160,116180,20,Argentina,A18,NA,NA,NA,NA
child_gesture,116871,119301,2430,Argentina,A18,NA,NA,NA,NA
silence,118330,118840,510,Argentina,A18,NA,NA,NA,NA
silence,119530,119710,180,Argentina,A18,NA,NA,NA,NA
silence,121100,122670,1570,Argentina,A18,NA,NA,NA,NA
silence,124220,125360,1140,Argentina,A18,NA,NA,NA,NA
silence,126000,126580,580,Argentina,A18,NA,NA,NA,NA
silence,131160,131830,670,Argentina,A18,NA,NA,NA,NA
father_gesture,131770,133324,1554,Argentina,A18,NA,NA,NA,NA
silence,132510,133330,820,Argentina,A18,NA,NA,NA,NA
silence,135850,136260,410,Argentina,A18,NA,NA,NA,NA
father_gesture,137354,138914,1560,Argentina,A18,NA,NA,NA,NA
silence,141370,144240,2870,Argentina,A18,NA,NA,NA,NA
silence,148620,151360,2740,Argentina,A18,NA,NA,NA,NA
mother_gesture,151966,153506,1540,Argentina,A18,NA,NA,NA,NA
silence,152890,156470,3580,Argentina,A18,NA,NA,NA,NA
silence,157260,157960,700,Argentina,A18,NA,NA,NA,NA
silence,158680,162040,3360,Argentina,A18,NA,NA,NA,NA
silence,162910,162950,40,Argentina,A18,NA,NA,NA,NA
silence,163670,164220,550,Argentina,A18,NA,NA,NA,NA
silence,166590,166710,120,Argentina,A18,NA,NA,NA,NA
silence,167940,169490,1550,Argentina,A18,NA,NA,NA,NA
silence,173900,176580,2680,Argentina,A18,NA,NA,NA,NA
silence,179200,181920,2720,Argentina,A18,NA,NA,NA,NA
silence,183420,186730,3310,Argentina,A18,NA,NA,NA,NA
silence,189080,189160,80,Argentina,A18,NA,NA,NA,NA
mother_gesture,189422,193522,4100,Argentina,A18,NA,NA,NA,NA
silence,192310,192760,450,Argentina,A18,NA,NA,NA,NA
silence,194140,199270,5130,Argentina,A18,NA,NA,NA,NA
silence,200640,201080,440,Argentina,A18,NA,NA,NA,NA
silence,201760,201930,170,Argentina,A18,NA,NA,NA,NA
silence,204120,204200,80,Argentina,A18,NA,NA,NA,NA
silence,205700,205760,60,Argentina,A18,NA,NA,NA,NA
silence,207250,207290,40,Argentina,A18,NA,NA,NA,NA
silence,208250,208260,10,Argentina,A18,NA,NA,NA,NA
silence,208740,209670,930,Argentina,A18,NA,NA,NA,NA
silence,211240,211270,30,Argentina,A18,NA,NA,NA,NA
silence,211690,213710,2020,Argentina,A18,NA,NA,NA,NA
silence,214570,215150,580,Argentina,A18,NA,NA,NA,NA
silence,216040,216900,860,Argentina,A18,NA,NA,NA,NA
mother_gesture,217612,219433,1821,Argentina,A18,NA,NA,NA,NA
silence,217870,218720,850,Argentina,A18,NA,NA,NA,NA
father_gesture,224420,226227,1807,Argentina,A18,NA,NA,NA,NA
silence,226820,227150,330,Argentina,A18,NA,NA,NA,NA
mother_gesture,227546,229646,2100,Argentina,A18,NA,NA,NA,NA
silence,228680,229240,560,Argentina,A18,NA,NA,NA,NA
silence,232010,232500,490,Argentina,A18,NA,NA,NA,NA
father_gesture,233620,234340,720,Argentina,A18,NA,NA,NA,NA
silence,233880,234400,520,Argentina,A18,NA,NA,NA,NA
father_gesture,234400,235090,690,Argentina,A18,NA,NA,NA,NA
silence,236210,240230,4020,Argentina,A18,NA,NA,NA,NA
silence,242360,243980,1620,Argentina,A18,NA,NA,NA,NA
mother_gesture,243880,245016,1136,Argentina,A18,NA,NA,NA,NA
mother_gesture,245847,247638,1791,Argentina,A18,NA,NA,NA,NA
silence,246880,251640,4760,Argentina,A18,NA,NA,NA,NA
silence,252350,260700,8350,Argentina,A18,NA,NA,NA,NA
silence,266300,268260,1960,Argentina,A18,NA,NA,NA,NA
mother_gesture,268030,268740,710,Argentina,A18,NA,NA,NA,NA
mother_gesture,268863,270646,1783,Argentina,A18,NA,NA,NA,NA
silence,270590,277110,6520,Argentina,A18,NA,NA,NA,NA
silence,278040,278680,640,Argentina,A18,NA,NA,NA,NA
silence,280000,281160,1160,Argentina,A18,NA,NA,NA,NA
father_gesture,281263,282724,1461,Argentina,A18,NA,NA,NA,NA
silence,282960,283310,350,Argentina,A18,NA,NA,NA,NA
mother_gesture,283662,285217,1555,Argentina,A18,NA,NA,NA,NA
silence,284620,284840,220,Argentina,A18,NA,NA,NA,NA
silence,285910,285970,60,Argentina,A18,NA,NA,NA,NA
mother_gesture,286040,287944,1904,Argentina,A18,NA,NA,NA,NA
silence,287000,289790,2790,Argentina,A18,NA,NA,NA,NA
silence,290900,295010,4110,Argentina,A18,NA,NA,NA,NA
child_gesture,295302,297586,2284,Argentina,A18,NA,NA,NA,NA
silence,298430,298550,120,Argentina,A18,NA,NA,NA,NA
child_gesture,300314,301526,1212,Argentina,A18,NA,NA,NA,NA
mother_gesture,302968,304554,1586,Argentina,A18,NA,NA,NA,NA
silence,302980,303110,130,Argentina,A18,NA,NA,NA,NA
silence,303870,308780,4910,Argentina,A18,NA,NA,NA,NA
mother_gesture,307910,310104,2194,Argentina,A18,NA,NA,NA,NA
silence,309760,328790,19030,Argentina,A18,NA,NA,NA,NA
silence,329730,332410,2680,Argentina,A18,NA,NA,NA,NA
father_gesture,334260,335649,1389,Argentina,A18,NA,NA,NA,NA
silence,335270,340100,4830,Argentina,A18,NA,NA,NA,NA
father_gesture,341982,344524,2542,Argentina,A18,NA,NA,NA,NA
silence,342510,343390,880,Argentina,A18,NA,NA,NA,NA
silence,344550,344850,300,Argentina,A18,NA,NA,NA,NA
silence,345520,347690,2170,Argentina,A18,NA,NA,NA,NA
mother_gesture,349604,351247,1643,Argentina,A18,NA,NA,NA,NA
silence,350300,350750,450,Argentina,A18,NA,NA,NA,NA
father_gesture,352317,354059,1742,Argentina,A18,NA,NA,NA,NA
silence,352320,352820,500,Argentina,A18,NA,NA,NA,NA
silence,354010,355180,1170,Argentina,A18,NA,NA,NA,NA
silence,359410,359720,310,Argentina,A18,NA,NA,NA,NA
father_gesture,359531,361494,1963,Argentina,A18,NA,NA,NA,NA
silence,361660,361880,220,Argentina,A18,NA,NA,NA,NA
silence,362690,371100,8410,Argentina,A18,NA,NA,NA,NA
silence,372000,372390,390,Argentina,A18,NA,NA,NA,NA
silence,374680,374840,160,Argentina,A18,NA,NA,NA,NA
silence,375380,377490,2110,Argentina,A18,NA,NA,NA,NA
father_gesture,378086,380549,2463,Argentina,A18,NA,NA,NA,NA
mother_gesture,380493,381569,1076,Argentina,A18,NA,NA,NA,NA
silence,380644,381060,416,Argentina,A18,NA,NA,NA,NA
silence,383430,387390,3960,Argentina,A18,NA,NA,NA,NA
silence,388630,388790,160,Argentina,A18,NA,NA,NA,NA
silence,391890,395550,3660,Argentina,A18,NA,NA,NA,NA
silence,396400,397040,640,Argentina,A18,NA,NA,NA,NA
silence,398750,399050,300,Argentina,A18,NA,NA,NA,NA
silence,400630,401780,1150,Argentina,A18,NA,NA,NA,NA
mother_gesture,402036,402951,915,Argentina,A18,NA,NA,NA,NA
silence,403330,407640,4310,Argentina,A18,NA,NA,NA,NA
mother_gesture,407521,410240,2719,Argentina,A18,NA,NA,NA,NA
silence,408180,410350,2170,Argentina,A18,NA,NA,NA,NA
mother_gesture,410450,411779,1329,Argentina,A18,NA,NA,NA,NA
mother_gesture,426240,427977,1737,Argentina,A18,NA,NA,NA,NA
mother_gesture,433189,435677,2488,Argentina,A18,NA,NA,NA,NA
mother_gesture,436094,437789,1695,Argentina,A18,NA,NA,NA,NA
mother_gesture,440240,442611,2371,Argentina,A18,NA,NA,NA,NA
silence,442240,443870,1630,Argentina,A18,NA,NA,NA,NA
silence,446210,447750,1540,Argentina,A18,NA,NA,NA,NA
silence,448690,451380,2690,Argentina,A18,NA,NA,NA,NA
silence,451990,452600,610,Argentina,A18,NA,NA,NA,NA
silence,454220,455010,790,Argentina,A18,NA,NA,NA,NA
child_gesture,455370,457026,1656,Argentina,A18,NA,NA,NA,NA
silence,456630,457990,1360,Argentina,A18,NA,NA,NA,NA
silence,460650,460950,300,Argentina,A18,NA,NA,NA,NA
silence,463120,464370,1250,Argentina,A18,NA,NA,NA,NA
silence,464820,465170,350,Argentina,A18,NA,NA,NA,NA
silence,465830,465880,50,Argentina,A18,NA,NA,NA,NA
silence,466320,466420,100,Argentina,A18,NA,NA,NA,NA
silence,466870,466970,100,Argentina,A18,NA,NA,NA,NA
silence,467460,468490,1030,Argentina,A18,NA,NA,NA,NA
silence,469940,473720,3780,Argentina,A18,NA,NA,NA,NA
silence,475990,476030,40,Argentina,A18,NA,NA,NA,NA
silence,479890,480250,360,Argentina,A18,NA,NA,NA,NA
mother_gesture,480890,482511,1621,Argentina,A18,NA,NA,NA,NA
silence,482260,484060,1800,Argentina,A18,NA,NA,NA,NA
silence,484560,485470,910,Argentina,A18,NA,NA,NA,NA
silence,486310,487470,1160,Argentina,A18,NA,NA,NA,NA
silence,492340,494570,2230,Argentina,A18,NA,NA,NA,NA
silence,495470,497050,1580,Argentina,A18,NA,NA,NA,NA
silence,498040,498190,150,Argentina,A18,NA,NA,NA,NA
silence,498770,498830,60,Argentina,A18,NA,NA,NA,NA
silence,499630,499800,170,Argentina,A18,NA,NA,NA,NA
silence,500460,501970,1510,Argentina,A18,NA,NA,NA,NA
mother_gesture,501274,503630,2356,Argentina,A18,NA,NA,NA,NA
silence,505060,505220,160,Argentina,A18,NA,NA,NA,NA
silence,506240,506470,230,Argentina,A18,NA,NA,NA,NA
silence,507000,507170,170,Argentina,A18,NA,NA,NA,NA
silence,508290,510240,1950,Argentina,A18,NA,NA,NA,NA
silence,511170,511360,190,Argentina,A18,NA,NA,NA,NA
silence,511840,512100,260,Argentina,A18,NA,NA,NA,NA
silence,512610,513190,580,Argentina,A18,NA,NA,NA,NA
silence,514050,514140,90,Argentina,A18,NA,NA,NA,NA
mother_gesture,516855,518132,1277,Argentina,A18,NA,NA,NA,NA
silence,523050,523300,250,Argentina,A18,NA,NA,NA,NA
silence,524790,526550,1760,Argentina,A18,NA,NA,NA,NA
silence,527340,532070,4730,Argentina,A18,NA,NA,NA,NA
silence,532970,535070,2100,Argentina,A18,NA,NA,NA,NA
silence,537750,537850,100,Argentina,A18,NA,NA,NA,NA
mother_gesture,538385,539738,1353,Argentina,A18,NA,NA,NA,NA
silence,540850,540870,20,Argentina,A18,NA,NA,NA,NA
father_gesture,543802,545279,1477,Argentina,A18,NA,NA,NA,NA
father_gesture,545510,546992,1482,Argentina,A18,NA,NA,NA,NA
father_gesture,547157,551129,3972,Argentina,A18,NA,NA,NA,NA
father_gesture,551313,552740,1427,Argentina,A18,NA,NA,NA,NA
father_gesture,552740,554270,1530,Argentina,A18,NA,NA,NA,NA
father_gesture,555550,557470,1920,Argentina,A18,NA,NA,NA,NA
silence,556490,556630,140,Argentina,A18,NA,NA,NA,NA
child_gesture,556512,558544,2032,Argentina,A18,NA,NA,NA,NA
silence,558920,559600,680,Argentina,A18,NA,NA,NA,NA
father_gesture,561094,562444,1350,Argentina,A18,NA,NA,NA,NA
silence,564010,564510,500,Argentina,A18,NA,NA,NA,NA
silence,570340,570580,240,Argentina,A18,NA,NA,NA,NA
silence,571830,571840,10,Argentina,A18,NA,NA,NA,NA
mother_gesture,572318,573760,1442,Argentina,A18,NA,NA,NA,NA
silence,572970,573260,290,Argentina,A18,NA,NA,NA,NA
silence,573920,574190,270,Argentina,A18,NA,NA,NA,NA
father_gesture,575540,577025,1485,Argentina,A18,NA,NA,NA,NA
silence,576910,577330,420,Argentina,A18,NA,NA,NA,NA
silence,580790,581810,1020,Argentina,A18,NA,NA,NA,NA
silence,591920,592060,140,Argentina,A18,NA,NA,NA,NA
silence,595810,596670,860,Argentina,A18,NA,NA,NA,NA
father_gesture,597010,599623,2613,Argentina,A18,NA,NA,NA,NA
mother,1629,2539,910,Argentina,A19,f,2,1,a
child,2189,2959,770,Argentina,A19,f,3,1,a
mother,3009,6359,3350,Argentina,A19,f,3,2,q
father,3169,3769,600,Argentina,A19,b,3,3,a
father,6139,7359,1220,Argentina,A19,b,3,4,a
child,6879,8019,1140,Argentina,A19,m,3,5,a
mother,7979,11649,3670,Argentina,A19,c,3,6,a
child,13539,14659,1120,Argentina,A19,m,3,7,q
mother,14299,16219,1920,Argentina,A19,f,5,1,q
father,16109,16529,420,Argentina,A19,m,5,2,a
mother,21499,23439,1940,Argentina,A19,b,6,1,a
child,24159,26609,2450,Argentina,A19,b,7,1,a
mother,26589,27299,710,Argentina,A19,c,7,2,a
child,27439,28869,1430,Argentina,A19,m,7,3,a
mother,29039,29509,470,Argentina,A19,c,7,4,a
father,28219,28769,550,Argentina,A19,m,8,1,a
mother,33469,35089,1620,Argentina,A19,c,9,1,q
father,34379,35419,1040,Argentina,A19,m,9,2,a
child,35109,37079,1970,Argentina,A19,m,9,3,a
father,36019,38189,2170,Argentina,A19,m,9,4,a
mother,37659,39499,1840,Argentina,A19,c,9,5,q
child,39809,40279,470,Argentina,A19,m,9,6,a
father,39889,40799,910,Argentina,A19,m,9,7,a
mother,42079,42669,590,Argentina,A19,f,9,8,q
father,42979,46299,3320,Argentina,A19,m,9,9,a
mother,45359,45939,580,Argentina,A19,f,9,10,a
child,46249,47879,1630,Argentina,A19,m,10,1,i
mother,47869,49539,1670,Argentina,A19,c,10,2,a
child,50849,53899,3050,Argentina,A19,m,10,3,a
mother,53639,58439,4800,Argentina,A19,c,10,4,q
child,58349,60419,2070,Argentina,A19,m,10,5,a
mother,60309,61299,990,Argentina,A19,c,10,6,a
father,62449,63819,1370,Argentina,A19,m,10,7,a
child,63859,65139,1280,Argentina,A19,m,10,8,a
mother,64759,68849,4090,Argentina,A19,c,10,9,a
mother,70599,71769,1170,Argentina,A19,c,11,1,q
child,72619,73719,1100,Argentina,A19,m,12,1,q
mother,73659,75863,2204,Argentina,A19,c,12,2,a
father,78819,79789,970,Argentina,A19,c,13,1,q
child,78949,80159,1210,Argentina,A19,o,13,2,q
mother,82839,88269,5430,Argentina,A19,c,14,1,a
child,88329,88899,570,Argentina,A19,m,14,2,a
mother,89719,91219,1500,Argentina,A19,c,14,3,q
mother,93709,96139,2430,Argentina,A19,c,15,1,a
father,95589,96359,770,Argentina,A19,m,15,2,a
mother,99159,100019,860,Argentina,A19,b,15,3,a
child,96099,97469,1370,Argentina,A19,f,16,1,i
father,97419,98279,860,Argentina,A19,c,16,2,a
child,102289,103619,1330,Argentina,A19,m,17,1,a
mother,103939,105479,1540,Argentina,A19,c,17,2,a
mother,106669,108899,2230,Argentina,A19,b,18,1,a
mother,113739,114559,820,Argentina,A19,b,18,2,a
father,114009,115479,1470,Argentina,A19,m,19,1,q
mother,115889,116439,550,Argentina,A19,f,19,2,a
mother,120579,122039,1460,Argentina,A19,f,19,3,a
mother,124459,125669,1210,Argentina,A19,f,19,4,a
mother,131769,132589,820,Argentina,A19,b,20,1,a
mother,135029,142789,7760,Argentina,A19,f,21,1,a
father,141839,147879,6040,Argentina,A19,m,21,2,a
mother,147869,150479,2610,Argentina,A19,f,21,3,a
father,151469,154079,2610,Argentina,A19,m,21,4,q
mother,151989,153759,1770,Argentina,A19,f,21,5,a
father,154579,155039,460,Argentina,A19,m,21,6,a
mother,156419,156979,560,Argentina,A19,f,21,7,a
father,157009,158239,1230,Argentina,A19,m,21,8,a
mother,158409,162019,3610,Argentina,A19,f,21,9,a
father,161059,165419,4360,Argentina,A19,m,21,10,a
mother,163659,166089,2430,Argentina,A19,f,21,11,a
mother,175289,176449,1160,Argentina,A19,c,22,1,a
father,185049,185659,610,Argentina,A19,m,22,2,q
mother,187969,188539,570,Argentina,A19,f,22,3,a
father,188919,203069,14150,Argentina,A19,m,23,1,a
mother,190349,190939,590,Argentina,A19,f,23,2,a
mother,193049,195309,2260,Argentina,A19,f,23,3,a
mother,197049,203619,6570,Argentina,A19,f,23,4,a
father,205239,209559,4320,Argentina,A19,m,23,5,a
mother,209169,214609,5440,Argentina,A19,f,23,6,a
father,214569,215029,460,Argentina,A19,m,23,7,a
mother,215889,216529,640,Argentina,A19,f,23,8,a
father,218899,219389,490,Argentina,A19,m,23,9,a
mother,219449,219979,530,Argentina,A19,f,23,10,a
mother,223759,227339,3580,Argentina,A19,f,23,11,a
father,233879,238509,4630,Argentina,A19,m,24,1,a
mother,238679,239289,610,Argentina,A19,f,24,2,q
father,239379,240699,1320,Argentina,A19,m,24,3,a
child,241919,244079,2160,Argentina,A19,m,25,1,i
mother,244299,244909,610,Argentina,A19,c,25,2,a
mother,245929,246999,1070,Argentina,A19,f,26,1,a
father,247549,274969,27420,Argentina,A19,m,27,1,a
mother,248499,248989,490,Argentina,A19,f,27,2,a
mother,253289,253889,600,Argentina,A19,f,27,3,a
mother,260339,260959,620,Argentina,A19,f,27,4,a
mother,264459,265609,1150,Argentina,A19,f,27,5,a
mother,274589,281289,6700,Argentina,A19,f,27,6,a
mother,285619,289779,4160,Argentina,A19,f,28,1,a
father,289229,289879,650,Argentina,A19,m,28,2,a
father,292359,295589,3230,Argentina,A19,m,28,3,a
father,298309,300179,1870,Argentina,A19,m,28,4,a
mother,295849,297689,1840,Argentina,A19,c,29,1,q
mother,299149,300519,1370,Argentina,A19,c,29,2,q
child,300949,301549,600,Argentina,A19,m,29,3,a
mother,301839,303079,1240,Argentina,A19,c,29,4,a
father,302989,303559,570,Argentina,A19,m,29,5,q
mother,303679,304259,580,Argentina,A19,f,29,6,a
father,306969,308459,1490,Argentina,A19,m,29,7,q
mother,308999,311559,2560,Argentina,A19,f,29,8,a
father,318439,319259,820,Argentina,A19,m,29,9,a
mother,333549,334169,620,Argentina,A19,f,29,10,a
father,334329,340639,6310,Argentina,A19,m,30,1,q
mother,336779,341529,4750,Argentina,A19,f,30,2,a
father,341559,342289,730,Argentina,A19,m,30,3,a
mother,341999,347019,5020,Argentina,A19,f,30,4,a
father,343289,346559,3270,Argentina,A19,m,30,5,a
father,350749,360949,10200,Argentina,A19,m,30,6,a
mother,354569,357589,3020,Argentina,A19,f,30,7,a
mother,380199,381509,1310,Argentina,A19,f,31,1,a
father,383829,384679,850,Argentina,A19,m,31,2,q
mother,384809,388319,3510,Argentina,A19,f,31,3,a
father,391769,404199,12430,Argentina,A19,m,32,1,a
mother,403439,405669,2230,Argentina,A19,c,33,1,q
child,406239,407119,880,Argentina,A19,m,33,2,a
father,407119,407629,510,Argentina,A19,b,33,3,a
mother,407839,408479,640,Argentina,A19,c,33,4,q
child,408859,409309,450,Argentina,A19,m,33,5,a
mother,409529,410609,1080,Argentina,A19,c,33,6,q
child,410829,411649,820,Argentina,A19,m,33,7,a
father,411129,412709,1580,Argentina,A19,c,33,8,q
mother,412239,414469,2230,Argentina,A19,f,33,9,q
father,414549,417139,2590,Argentina,A19,m,33,10,q
mother,416559,418099,1540,Argentina,A19,c,33,11,a
father,427369,428409,1040,Argentina,A19,m,33,12,a
mother,428659,431549,2890,Argentina,A19,c,33,13,q
father,431529,431899,370,Argentina,A19,b,33,14,a
mother,432509,439449,6940,Argentina,A19,c,33,15,q
father,435809,438929,3120,Argentina,A19,m,33,16,a
child,439979,442679,2700,Argentina,A19,b,33,17,a
father,445649,448989,3340,Argentina,A19,m,33,18,q
mother,449569,449939,370,Argentina,A19,f,33,19,a
father,450079,450529,450,Argentina,A19,m,33,20,q
mother,450629,451129,500,Argentina,A19,f,33,21,a
mother,453499,454629,1130,Argentina,A19,c,33,22,q
child,455929,456429,500,Argentina,A19,m,33,23,a
mother,461079,466559,5480,Argentina,A19,c,33,24,a
father,469159,470229,1070,Argentina,A19,m,33,25,a
mother,457899,458869,970,Argentina,A19,c,34,1,i
child,458999,465175,6176,Argentina,A19,m,34,2,a
father,479169,485729,6560,Argentina,A19,m,35,1,a
mother,485769,486389,620,Argentina,A19,f,35,2,a
father,487849,489149,1300,Argentina,A19,m,35,3,a
mother,489859,490549,690,Argentina,A19,f,35,4,q
father,492479,499059,6580,Argentina,A19,m,35,5,a
mother,496849,497489,640,Argentina,A19,f,35,6,a
mother,500539,501229,690,Argentina,A19,f,35,7,a
father,501479,502589,1110,Argentina,A19,m,35,8,a
mother,502689,508329,5640,Argentina,A19,f,35,9,q
father,507719,509229,1510,Argentina,A19,m,35,10,q
mother,509229,510149,920,Argentina,A19,f,35,11,a
father,510489,511509,1020,Argentina,A19,m,35,12,q
mother,511249,512089,840,Argentina,A19,f,35,13,a
father,512149,513659,1510,Argentina,A19,m,35,14,a
mother,513719,514399,680,Argentina,A19,f,35,15,a
father,514799,515969,1170,Argentina,A19,m,35,16,a
mother,520229,522929,2700,Argentina,A19,f,35,17,a
father,522889,525809,2920,Argentina,A19,m,35,18,a
mother,526769,527689,920,Argentina,A19,f,35,19,a
father,528109,528969,860,Argentina,A19,m,35,20,a
mother,532009,534529,2520,Argentina,A19,c,36,1,a
child,537199,538739,1540,Argentina,A19,m,36,2,a
mother,538729,542259,3530,Argentina,A19,c,36,3,a
mother,544539,545309,770,Argentina,A19,c,36,4,a
mother,548919,549639,720,Argentina,A19,c,36,5,a
mother,552719,553539,820,Argentina,A19,c,36,6,a
child,562869,564409,1540,Argentina,A19,m,37,1,a
mother,563879,565859,1980,Argentina,A19,c,37,2,a
mother,566009,566799,790,Argentina,A19,c,38,1,i
child,568159,569139,980,Argentina,A19,m,39,1,q
mother,569209,574559,5350,Argentina,A19,c,39,2,a
child,577239,579489,2250,Argentina,A19,m,39,3,a
mother,578529,582469,3940,Argentina,A19,c,39,4,a
father,587679,589069,1390,Argentina,A19,m,39,5,a
mother,587709,589359,1650,Argentina,A19,f,39,6,a
child,593439,595079,1640,Argentina,A19,m,39,7,a
silence,2959,3009,50,Argentina,A19,NA,NA,NA,NA
silence,11649,13539,1890,Argentina,A19,NA,NA,NA,NA
silence,16529,21499,4970,Argentina,A19,NA,NA,NA,NA
silence,23439,24159,720,Argentina,A19,NA,NA,NA,NA
silence,27299,27439,140,Argentina,A19,NA,NA,NA,NA
silence,28869,29039,170,Argentina,A19,NA,NA,NA,NA
silence,29509,33469,3960,Argentina,A19,NA,NA,NA,NA
silence,39499,39809,310,Argentina,A19,NA,NA,NA,NA
silence,40799,42079,1280,Argentina,A19,NA,NA,NA,NA
silence,42669,42979,310,Argentina,A19,NA,NA,NA,NA
child_gesture,46982,48159,1177,Argentina,A19,NA,NA,NA,NA
silence,49539,50849,1310,Argentina,A19,NA,NA,NA,NA
silence,61299,62449,1150,Argentina,A19,NA,NA,NA,NA
silence,63819,63859,40,Argentina,A19,NA,NA,NA,NA
silence,68849,70599,1750,Argentina,A19,NA,NA,NA,NA
silence,71769,72619,850,Argentina,A19,NA,NA,NA,NA
silence,75863,78819,2956,Argentina,A19,NA,NA,NA,NA
silence,80159,82839,2680,Argentina,A19,NA,NA,NA,NA
silence,88269,88329,60,Argentina,A19,NA,NA,NA,NA
silence,88899,89719,820,Argentina,A19,NA,NA,NA,NA
silence,91219,93709,2490,Argentina,A19,NA,NA,NA,NA
child_gesture,96014,97630,1616,Argentina,A19,NA,NA,NA,NA
silence,98279,99159,880,Argentina,A19,NA,NA,NA,NA
silence,100019,102289,2270,Argentina,A19,NA,NA,NA,NA
silence,103619,103939,320,Argentina,A19,NA,NA,NA,NA
silence,105479,106669,1190,Argentina,A19,NA,NA,NA,NA
silence,108899,113739,4840,Argentina,A19,NA,NA,NA,NA
silence,115479,115889,410,Argentina,A19,NA,NA,NA,NA
silence,116439,120579,4140,Argentina,A19,NA,NA,NA,NA
silence,122039,124459,2420,Argentina,A19,NA,NA,NA,NA
silence,125669,131769,6100,Argentina,A19,NA,NA,NA,NA
silence,132589,135029,2440,Argentina,A19,NA,NA,NA,NA
mother_gesture,136549,137249,700,Argentina,A19,NA,NA,NA,NA
mother_gesture,137309,138089,780,Argentina,A19,NA,NA,NA,NA
mother_gesture,139569,141699,2130,Argentina,A19,NA,NA,NA,NA
father_gesture,144869,145979,1110,Argentina,A19,NA,NA,NA,NA
silence,150479,151469,990,Argentina,A19,NA,NA,NA,NA
silence,154079,154579,500,Argentina,A19,NA,NA,NA,NA
silence,155039,156419,1380,Argentina,A19,NA,NA,NA,NA
father_gesture,156664,157596,932,Argentina,A19,NA,NA,NA,NA
silence,156979,157009,30,Argentina,A19,NA,NA,NA,NA
silence,158239,158409,170,Argentina,A19,NA,NA,NA,NA
mother_gesture,159508,160573,1065,Argentina,A19,NA,NA,NA,NA
silence,166089,175289,9200,Argentina,A19,NA,NA,NA,NA
silence,176449,185049,8600,Argentina,A19,NA,NA,NA,NA
silence,185659,187969,2310,Argentina,A19,NA,NA,NA,NA
silence,188539,188919,380,Argentina,A19,NA,NA,NA,NA
father_gesture,197093,197985,892,Argentina,A19,NA,NA,NA,NA
father_gesture,199296,200915,1619,Argentina,A19,NA,NA,NA,NA
silence,203619,205239,1620,Argentina,A19,NA,NA,NA,NA
silence,215029,215889,860,Argentina,A19,NA,NA,NA,NA
silence,216529,218899,2370,Argentina,A19,NA,NA,NA,NA
silence,219389,219449,60,Argentina,A19,NA,NA,NA,NA
silence,219979,223759,3780,Argentina,A19,NA,NA,NA,NA
silence,227339,233879,6540,Argentina,A19,NA,NA,NA,NA
silence,238509,238679,170,Argentina,A19,NA,NA,NA,NA
silence,239289,239379,90,Argentina,A19,NA,NA,NA,NA
silence,240699,241919,1220,Argentina,A19,NA,NA,NA,NA
child_gesture,242459,243737,1278,Argentina,A19,NA,NA,NA,NA
silence,244079,244299,220,Argentina,A19,NA,NA,NA,NA
silence,244909,245929,1020,Argentina,A19,NA,NA,NA,NA
silence,246999,247549,550,Argentina,A19,NA,NA,NA,NA
father_gesture,253872,255123,1251,Argentina,A19,NA,NA,NA,NA
father_gesture,272140,273472,1332,Argentina,A19,NA,NA,NA,NA
silence,281289,285619,4330,Argentina,A19,NA,NA,NA,NA
silence,289879,292359,2480,Argentina,A19,NA,NA,NA,NA
mother_gesture,295400,296769,1369,Argentina,A19,NA,NA,NA,NA
silence,295589,295849,260,Argentina,A19,NA,NA,NA,NA
mother_gesture,297149,298418,1269,Argentina,A19,NA,NA,NA,NA
silence,297689,298309,620,Argentina,A19,NA,NA,NA,NA
father_gesture,298905,300398,1493,Argentina,A19,NA,NA,NA,NA
mother_gesture,299870,301002,1132,Argentina,A19,NA,NA,NA,NA
silence,300519,300949,430,Argentina,A19,NA,NA,NA,NA
silence,301549,301839,290,Argentina,A19,NA,NA,NA,NA
silence,303559,303679,120,Argentina,A19,NA,NA,NA,NA
silence,304259,306969,2710,Argentina,A19,NA,NA,NA,NA
silence,308459,308999,540,Argentina,A19,NA,NA,NA,NA
silence,311559,318439,6880,Argentina,A19,NA,NA,NA,NA
silence,319259,333549,14290,Argentina,A19,NA,NA,NA,NA
father_gesture,332129,339698,7569,Argentina,A19,NA,NA,NA,NA
silence,334169,334329,160,Argentina,A19,NA,NA,NA,NA
father_gesture,339919,341104,1185,Argentina,A19,NA,NA,NA,NA
mother_gesture,340608,342626,2018,Argentina,A19,NA,NA,NA,NA
silence,341529,341559,30,Argentina,A19,NA,NA,NA,NA
mother_gesture,343299,344812,1513,Argentina,A19,NA,NA,NA,NA
silence,347019,350749,3730,Argentina,A19,NA,NA,NA,NA
father_gesture,352733,353466,733,Argentina,A19,NA,NA,NA,NA
father_gesture,354664,355355,691,Argentina,A19,NA,NA,NA,NA
father_gesture,355709,356767,1058,Argentina,A19,NA,NA,NA,NA
silence,360949,380199,19250,Argentina,A19,NA,NA,NA,NA
silence,381509,383829,2320,Argentina,A19,NA,NA,NA,NA
silence,384679,384809,130,Argentina,A19,NA,NA,NA,NA
silence,388319,391769,3450,Argentina,A19,NA,NA,NA,NA
father_gesture,391379,393094,1715,Argentina,A19,NA,NA,NA,NA
silence,405669,406239,570,Argentina,A19,NA,NA,NA,NA
silence,407629,407839,210,Argentina,A19,NA,NA,NA,NA
silence,408479,408859,380,Argentina,A19,NA,NA,NA,NA
silence,409309,409529,220,Argentina,A19,NA,NA,NA,NA
silence,410609,410829,220,Argentina,A19,NA,NA,NA,NA
silence,414469,414549,80,Argentina,A19,NA,NA,NA,NA
silence,418099,427369,9270,Argentina,A19,NA,NA,NA,NA
silence,428409,428659,250,Argentina,A19,NA,NA,NA,NA
silence,431899,432509,610,Argentina,A19,NA,NA,NA,NA
silence,439449,439979,530,Argentina,A19,NA,NA,NA,NA
silence,442679,445649,2970,Argentina,A19,NA,NA,NA,NA
silence,448989,449569,580,Argentina,A19,NA,NA,NA,NA
silence,449939,450079,140,Argentina,A19,NA,NA,NA,NA
silence,450529,450629,100,Argentina,A19,NA,NA,NA,NA
silence,451129,453499,2370,Argentina,A19,NA,NA,NA,NA
silence,454629,455929,1300,Argentina,A19,NA,NA,NA,NA
silence,456429,457899,1470,Argentina,A19,NA,NA,NA,NA
silence,458869,458999,130,Argentina,A19,NA,NA,NA,NA
silence,466559,469159,2600,Argentina,A19,NA,NA,NA,NA
silence,470229,479169,8940,Argentina,A19,NA,NA,NA,NA
silence,485729,485769,40,Argentina,A19,NA,NA,NA,NA
silence,486389,487849,1460,Argentina,A19,NA,NA,NA,NA
silence,489149,489859,710,Argentina,A19,NA,NA,NA,NA
silence,490549,492479,1930,Argentina,A19,NA,NA,NA,NA
father_gesture,494682,495967,1285,Argentina,A19,NA,NA,NA,NA
silence,499059,500539,1480,Argentina,A19,NA,NA,NA,NA
silence,501229,501479,250,Argentina,A19,NA,NA,NA,NA
silence,502589,502689,100,Argentina,A19,NA,NA,NA,NA
silence,510149,510489,340,Argentina,A19,NA,NA,NA,NA
silence,512089,512149,60,Argentina,A19,NA,NA,NA,NA
silence,513659,513719,60,Argentina,A19,NA,NA,NA,NA
silence,514399,514799,400,Argentina,A19,NA,NA,NA,NA
silence,515969,520229,4260,Argentina,A19,NA,NA,NA,NA
silence,525809,526769,960,Argentina,A19,NA,NA,NA,NA
silence,527689,528109,420,Argentina,A19,NA,NA,NA,NA
silence,528969,532009,3040,Argentina,A19,NA,NA,NA,NA
silence,534529,537199,2670,Argentina,A19,NA,NA,NA,NA
silence,542259,544539,2280,Argentina,A19,NA,NA,NA,NA
silence,545309,548919,3610,Argentina,A19,NA,NA,NA,NA
silence,549639,552719,3080,Argentina,A19,NA,NA,NA,NA
silence,553539,562869,9330,Argentina,A19,NA,NA,NA,NA
silence,565859,566009,150,Argentina,A19,NA,NA,NA,NA
silence,566799,568159,1360,Argentina,A19,NA,NA,NA,NA
silence,569139,569209,70,Argentina,A19,NA,NA,NA,NA
mother_gesture,573079,574521,1442,Argentina,A19,NA,NA,NA,NA
silence,574559,577239,2680,Argentina,A19,NA,NA,NA,NA
mother_gesture,580678,581913,1235,Argentina,A19,NA,NA,NA,NA
silence,582469,587679,5210,Argentina,A19,NA,NA,NA,NA
silence,589359,593439,4080,Argentina,A19,NA,NA,NA,NA
father,5280,6220,940,Argentina,A20,c,1,1,a
father,12290,15110,2820,Argentina,A20,c,2,1,q
child,15900,16710,810,Argentina,A20,f,2,2,a
father,20530,22729,2199,Argentina,A20,m,2,3,i
father,33483,34371,888,Argentina,A20,m,3,1,a
mother,39570,40910,1340,Argentina,A20,f,3,2,q
father,41430,42540,1110,Argentina,A20,m,3,3,a
mother,42740,43280,540,Argentina,A20,b,3,4,a
father,65230,67200,1970,Argentina,A20,m,4,1,a
mother,87140,88650,1510,Argentina,A20,f,5,1,q
father,90340,90810,470,Argentina,A20,m,5,2,q
mother,90860,91970,1110,Argentina,A20,f,5,3,q
father,92420,93130,710,Argentina,A20,m,5,4,a
mother,94350,96110,1760,Argentina,A20,b,6,1,a
father,97320,98540,1220,Argentina,A20,m,6,2,a
father,104530,105460,930,Argentina,A20,m,8,1,a
mother,109400,110500,1100,Argentina,A20,f,9,1,q
mother,119590,122860,3270,Argentina,A20,c,10,1,q
child,123560,124360,800,Argentina,A20,m,10,2,a
father,129500,131080,1580,Argentina,A20,c,11,1,q
child,130910,132550,1640,Argentina,A20,f,11,2,a
father,133080,134110,1030,Argentina,A20,c,11,3,q
child,134360,135820,1460,Argentina,A20,f,11,4,a
mother,135760,140960,5200,Argentina,A20,c,11,5,q
child,144270,145330,1060,Argentina,A20,f,11,6,a
father,145400,146210,810,Argentina,A20,c,11,7,a
child,147910,148440,530,Argentina,A20,b,11,8,a
mother,150730,152230,1500,Argentina,A20,c,11,9,a
father,153180,154370,1190,Argentina,A20,c,11,10,q
father,144080,144640,560,Argentina,A20,m,12,1,a
child,151480,153300,1820,Argentina,A20,m,13,1,a
mother,153460,154330,870,Argentina,A20,c,13,2,a
child,154710,155390,680,Argentina,A20,f,13,3,a
mother,160080,161530,1450,Argentina,A20,c,14,1,a
mother,167110,168430,1320,Argentina,A20,c,14,2,a
father,168740,172750,4010,Argentina,A20,m,15,1,q
mother,172760,173700,940,Argentina,A20,f,15,2,a
father,176050,176920,870,Argentina,A20,c,16,1,q
father,179380,181430,2050,Argentina,A20,m,17,1,i
mother,187530,189510,1980,Argentina,A20,f,17,2,a
child,184750,185720,970,Argentina,A20,b,18,1,a
child,188730,189760,1030,Argentina,A20,b,19,1,a
mother,189880,191050,1170,Argentina,A20,c,19,2,a
child,192060,193340,1280,Argentina,A20,b,19,3,a
mother,194040,196200,2160,Argentina,A20,c,19,4,a
father,210580,211150,570,Argentina,A20,m,20,1,a
father,214690,215220,530,Argentina,A20,m,20,2,q
mother,217180,220550,3370,Argentina,A20,f,20,3,a
child,226220,226960,740,Argentina,A20,b,21,1,a
child,229240,230310,1070,Argentina,A20,b,21,2,a
mother,230730,231440,710,Argentina,A20,c,21,3,a
mother,233900,238360,4460,Argentina,A20,c,22,1,q
father,239290,240030,740,Argentina,A20,c,22,2,q
child,242320,244630,2310,Argentina,A20,b,22,3,a
father,247400,248820,1420,Argentina,A20,c,22,4,q
child,249370,250060,690,Argentina,A20,f,22,5,a
father,251210,251770,560,Argentina,A20,c,22,6,q
child,252200,253900,1700,Argentina,A20,f,22,7,a
mother,254910,258430,3520,Argentina,A20,f,23,1,q
mother,261190,262800,1610,Argentina,A20,f,23,2,a
father,264830,265700,870,Argentina,A20,m,23,3,a
father,276730,277590,860,Argentina,A20,m,23,4,a
mother,277290,278560,1270,Argentina,A20,c,24,1,q
child,278940,279590,650,Argentina,A20,m,24,2,a
mother,282360,283120,760,Argentina,A20,f,24,3,q
father,283110,283700,590,Argentina,A20,m,24,4,a
father,302460,303740,1280,Argentina,A20,b,25,1,a
father,305940,309650,3710,Argentina,A20,m,25,2,a
child,309180,310460,1280,Argentina,A20,b,25,3,a
mother,310650,311530,880,Argentina,A20,c,25,4,q
child,311500,311890,390,Argentina,A20,m,25,5,a
father,321010,322970,1960,Argentina,A20,m,26,1,a
mother,323200,323760,560,Argentina,A20,f,26,2,a
mother,333250,335130,1880,Argentina,A20,f,26,3,a
father,335230,337970,2740,Argentina,A20,m,26,4,a
mother,338010,340160,2150,Argentina,A20,f,26,5,a
mother,342870,344390,1520,Argentina,A20,f,26,6,q
father,344610,345080,470,Argentina,A20,m,26,7,a
child,325240,325790,550,Argentina,A20,b,27,1,a
father,349190,351990,2800,Argentina,A20,m,27,2,a
father,354650,357610,2960,Argentina,A20,m,27,3,a
mother,357590,358070,480,Argentina,A20,f,27,4,q
father,358070,358600,530,Argentina,A20,m,27,5,a
father,361280,363060,1780,Argentina,A20,m,27,6,q
father,331140,332290,1150,Argentina,A20,m,28,1,a
child,362570,363550,980,Argentina,A20,m,29,1,a
child,367510,368810,1300,Argentina,A20,m,29,2,q
mother,369160,371820,2660,Argentina,A20,c,29,3,i
mother,374680,376780,2100,Argentina,A20,f,30,1,a
mother,386830,388740,1910,Argentina,A20,f,31,1,a
father,390840,391700,860,Argentina,A20,m,31,2,a
mother,391800,392300,500,Argentina,A20,f,31,3,q
father,392290,393090,800,Argentina,A20,m,31,4,a
father,395270,396860,1590,Argentina,A20,m,31,5,a
father,399760,402200,2440,Argentina,A20,m,31,6,a
mother,402970,403560,590,Argentina,A20,f,31,7,q
father,403670,404540,870,Argentina,A20,m,31,8,a
mother,404950,405950,1000,Argentina,A20,f,31,9,a
father,406090,406670,580,Argentina,A20,m,31,10,a
mother,406590,407560,970,Argentina,A20,f,31,11,a
child,402120,402950,830,Argentina,A20,b,32,1,a
mother,410070,413053,2983,Argentina,A20,c,33,1,i
child,415070,415990,920,Argentina,A20,m,33,2,a
mother,416330,417780,1450,Argentina,A20,c,33,3,q
father,421890,425080,3190,Argentina,A20,m,34,1,a
father,425510,429730,4220,Argentina,A20,m,35,1,a
mother,430960,432240,1280,Argentina,A20,f,35,2,a
father,439970,450410,10440,Argentina,A20,m,35,3,a
mother,449610,450550,940,Argentina,A20,f,35,4,q
father,454730,459030,4300,Argentina,A20,m,35,5,a
mother,459100,459870,770,Argentina,A20,f,35,6,q
father,460040,460650,610,Argentina,A20,m,35,7,a
father,462930,465260,2330,Argentina,A20,m,35,8,a
mother,465200,466370,1170,Argentina,A20,f,35,9,q
father,467260,468290,1030,Argentina,A20,m,35,10,a
father,472490,473630,1140,Argentina,A20,m,35,11,a
mother,473670,474330,660,Argentina,A20,f,35,12,a
father,475266,476480,1214,Argentina,A20,m,35,13,a
mother,476860,478640,1780,Argentina,A20,f,35,14,q
father,478890,479530,640,Argentina,A20,m,35,15,a
child,476000,479350,3350,Argentina,A20,m,36,1,i
father,482330,483100,770,Argentina,A20,c,36,2,q
mother,482470,484250,1780,Argentina,A20,c,36,3,a
child,484530,485100,570,Argentina,A20,m,36,4,a
mother,486400,489970,3570,Argentina,A20,c,36,5,a
child,490840,491460,620,Argentina,A20,m,36,6,q
mother,491500,495500,4000,Argentina,A20,c,36,7,i
mother,498990,500560,1570,Argentina,A20,f,37,1,q
father,514390,514990,600,Argentina,A20,m,37,2,a
mother,516890,518660,1770,Argentina,A20,f,37,3,a
father,520500,521080,580,Argentina,A20,m,37,4,a
father,530170,534000,3830,Argentina,A20,m,38,1,a
father,545240,546050,810,Argentina,A20,m,39,1,a
mother,547020,547760,740,Argentina,A20,f,39,2,a
mother,550150,551930,1780,Argentina,A20,c,40,1,q
child,555190,556010,820,Argentina,A20,m,40,2,a
mother,559150,560360,1210,Argentina,A20,c,40,3,q
child,560430,564290,3860,Argentina,A20,m,40,4,a
mother,563890,565350,1460,Argentina,A20,c,40,5,q
child,565600,566190,590,Argentina,A20,m,40,6,a
mother,567030,569770,2740,Argentina,A20,c,40,7,q
father,570280,574930,4650,Argentina,A20,c,40,8,a
father,581560,582150,590,Argentina,A20,c,40,9,a
child,587600,588210,610,Argentina,A20,f,40,10,a
father,588340,589150,810,Argentina,A20,c,40,11,a
father,592780,593800,1020,Argentina,A20,c,40,12,q
child,595530,599250,3720,Argentina,A20,o,41,1,a
child,42780,43930,1150,Argentina,A20,m,45,1,a
mother,45940,59590,13650,Argentina,A20,c,45,2,q
mother,70740,75980,5240,Argentina,A20,c,45,3,a
child,79120,79890,770,Argentina,A20,m,45,4,a
mother,80770,81570,800,Argentina,A20,m,45,5,a
mother,183910,184850,940,Argentina,A20,f,46,1,a
mother,352040,353450,1410,Argentina,A20,c,47,1,a
silence,6220,12290,6070,Argentina,A20,NA,NA,NA,NA
silence,15110,15900,790,Argentina,A20,NA,NA,NA,NA
silence,16710,20530,3820,Argentina,A20,NA,NA,NA,NA
silence,22729,33483,10754,Argentina,A20,NA,NA,NA,NA
silence,34371,39570,5199,Argentina,A20,NA,NA,NA,NA
silence,40910,41430,520,Argentina,A20,NA,NA,NA,NA
silence,42540,42740,200,Argentina,A20,NA,NA,NA,NA
silence,43930,45940,2010,Argentina,A20,NA,NA,NA,NA
silence,59590,65230,5640,Argentina,A20,NA,NA,NA,NA
silence,67200,70740,3540,Argentina,A20,NA,NA,NA,NA
silence,75980,79120,3140,Argentina,A20,NA,NA,NA,NA
silence,79890,80770,880,Argentina,A20,NA,NA,NA,NA
silence,81570,87140,5570,Argentina,A20,NA,NA,NA,NA
silence,88650,90340,1690,Argentina,A20,NA,NA,NA,NA
silence,90810,90860,50,Argentina,A20,NA,NA,NA,NA
silence,91970,92420,450,Argentina,A20,NA,NA,NA,NA
silence,93130,94350,1220,Argentina,A20,NA,NA,NA,NA
silence,96110,97320,1210,Argentina,A20,NA,NA,NA,NA
silence,98540,104530,5990,Argentina,A20,NA,NA,NA,NA
silence,105460,109400,3940,Argentina,A20,NA,NA,NA,NA
silence,110500,119590,9090,Argentina,A20,NA,NA,NA,NA
silence,122860,123560,700,Argentina,A20,NA,NA,NA,NA
silence,124360,129500,5140,Argentina,A20,NA,NA,NA,NA
silence,132550,133080,530,Argentina,A20,NA,NA,NA,NA
silence,134110,134360,250,Argentina,A20,NA,NA,NA,NA
silence,140960,144080,3120,Argentina,A20,NA,NA,NA,NA
silence,145330,145400,70,Argentina,A20,NA,NA,NA,NA
silence,146210,147910,1700,Argentina,A20,NA,NA,NA,NA
silence,148440,150730,2290,Argentina,A20,NA,NA,NA,NA
silence,154370,154710,340,Argentina,A20,NA,NA,NA,NA
silence,155390,160080,4690,Argentina,A20,NA,NA,NA,NA
silence,161530,167110,5580,Argentina,A20,NA,NA,NA,NA
silence,168430,168740,310,Argentina,A20,NA,NA,NA,NA
silence,172750,172760,10,Argentina,A20,NA,NA,NA,NA
silence,173700,176050,2350,Argentina,A20,NA,NA,NA,NA
silence,176920,179380,2460,Argentina,A20,NA,NA,NA,NA
father_gesture,178930,180676,1746,Argentina,A20,NA,NA,NA,NA
silence,181430,183910,2480,Argentina,A20,NA,NA,NA,NA
silence,185720,187530,1810,Argentina,A20,NA,NA,NA,NA
silence,189760,189880,120,Argentina,A20,NA,NA,NA,NA
silence,191050,192060,1010,Argentina,A20,NA,NA,NA,NA
silence,193340,194040,700,Argentina,A20,NA,NA,NA,NA
silence,196200,210580,14380,Argentina,A20,NA,NA,NA,NA
silence,211150,214690,3540,Argentina,A20,NA,NA,NA,NA
silence,215220,217180,1960,Argentina,A20,NA,NA,NA,NA
mother_gesture,219150,220295,1145,Argentina,A20,NA,NA,NA,NA
silence,220550,226220,5670,Argentina,A20,NA,NA,NA,NA
silence,226960,229240,2280,Argentina,A20,NA,NA,NA,NA
silence,230310,230730,420,Argentina,A20,NA,NA,NA,NA
silence,231440,233900,2460,Argentina,A20,NA,NA,NA,NA
silence,238360,239290,930,Argentina,A20,NA,NA,NA,NA
silence,240030,242320,2290,Argentina,A20,NA,NA,NA,NA
silence,244630,247400,2770,Argentina,A20,NA,NA,NA,NA
silence,248820,249370,550,Argentina,A20,NA,NA,NA,NA
silence,250060,251210,1150,Argentina,A20,NA,NA,NA,NA
silence,251770,252200,430,Argentina,A20,NA,NA,NA,NA
silence,253900,254910,1010,Argentina,A20,NA,NA,NA,NA
silence,258430,261190,2760,Argentina,A20,NA,NA,NA,NA
silence,262800,264830,2030,Argentina,A20,NA,NA,NA,NA
silence,265700,276730,11030,Argentina,A20,NA,NA,NA,NA
silence,278560,278940,380,Argentina,A20,NA,NA,NA,NA
silence,279590,282360,2770,Argentina,A20,NA,NA,NA,NA
silence,283700,302460,18760,Argentina,A20,NA,NA,NA,NA
silence,303740,305940,2200,Argentina,A20,NA,NA,NA,NA
silence,310460,310650,190,Argentina,A20,NA,NA,NA,NA
silence,311890,321010,9120,Argentina,A20,NA,NA,NA,NA
silence,322970,323200,230,Argentina,A20,NA,NA,NA,NA
silence,323760,325240,1480,Argentina,A20,NA,NA,NA,NA
silence,325790,331140,5350,Argentina,A20,NA,NA,NA,NA
silence,332290,333250,960,Argentina,A20,NA,NA,NA,NA
silence,335130,335230,100,Argentina,A20,NA,NA,NA,NA
silence,337970,338010,40,Argentina,A20,NA,NA,NA,NA
silence,340160,342870,2710,Argentina,A20,NA,NA,NA,NA
silence,344390,344610,220,Argentina,A20,NA,NA,NA,NA
silence,345080,349190,4110,Argentina,A20,NA,NA,NA,NA
silence,351990,352040,50,Argentina,A20,NA,NA,NA,NA
silence,353450,354650,1200,Argentina,A20,NA,NA,NA,NA
silence,358600,361280,2680,Argentina,A20,NA,NA,NA,NA
silence,363550,367510,3960,Argentina,A20,NA,NA,NA,NA
silence,368810,369160,350,Argentina,A20,NA,NA,NA,NA
silence,371820,374680,2860,Argentina,A20,NA,NA,NA,NA
silence,376780,386830,10050,Argentina,A20,NA,NA,NA,NA
silence,388740,390840,2100,Argentina,A20,NA,NA,NA,NA
silence,391700,391800,100,Argentina,A20,NA,NA,NA,NA
silence,393090,395270,2180,Argentina,A20,NA,NA,NA,NA
silence,396860,399760,2900,Argentina,A20,NA,NA,NA,NA
silence,402950,402970,20,Argentina,A20,NA,NA,NA,NA
silence,403560,403670,110,Argentina,A20,NA,NA,NA,NA
silence,404540,404950,410,Argentina,A20,NA,NA,NA,NA
silence,405950,406090,140,Argentina,A20,NA,NA,NA,NA
silence,407560,410070,2510,Argentina,A20,NA,NA,NA,NA
silence,413053,415070,2017,Argentina,A20,NA,NA,NA,NA
silence,415990,416330,340,Argentina,A20,NA,NA,NA,NA
silence,417780,421890,4110,Argentina,A20,NA,NA,NA,NA
silence,425080,425510,430,Argentina,A20,NA,NA,NA,NA
silence,429730,430960,1230,Argentina,A20,NA,NA,NA,NA
silence,432240,439970,7730,Argentina,A20,NA,NA,NA,NA
silence,450550,454730,4180,Argentina,A20,NA,NA,NA,NA
silence,459030,459100,70,Argentina,A20,NA,NA,NA,NA
silence,459870,460040,170,Argentina,A20,NA,NA,NA,NA
silence,460650,462930,2280,Argentina,A20,NA,NA,NA,NA
silence,466370,467260,890,Argentina,A20,NA,NA,NA,NA
silence,468290,472490,4200,Argentina,A20,NA,NA,NA,NA
silence,473630,473670,40,Argentina,A20,NA,NA,NA,NA
silence,474330,475266,936,Argentina,A20,NA,NA,NA,NA
silence,479530,482330,2800,Argentina,A20,NA,NA,NA,NA
silence,484250,484530,280,Argentina,A20,NA,NA,NA,NA
silence,485100,486400,1300,Argentina,A20,NA,NA,NA,NA
silence,489970,490840,870,Argentina,A20,NA,NA,NA,NA
silence,491460,491500,40,Argentina,A20,NA,NA,NA,NA
silence,495500,498990,3490,Argentina,A20,NA,NA,NA,NA
silence,500560,514390,13830,Argentina,A20,NA,NA,NA,NA
silence,514990,516890,1900,Argentina,A20,NA,NA,NA,NA
silence,518660,520500,1840,Argentina,A20,NA,NA,NA,NA
silence,521080,530170,9090,Argentina,A20,NA,NA,NA,NA
silence,534000,545240,11240,Argentina,A20,NA,NA,NA,NA
silence,546050,547020,970,Argentina,A20,NA,NA,NA,NA
silence,547760,550150,2390,Argentina,A20,NA,NA,NA,NA
silence,551930,555190,3260,Argentina,A20,NA,NA,NA,NA
silence,556010,559150,3140,Argentina,A20,NA,NA,NA,NA
silence,560360,560430,70,Argentina,A20,NA,NA,NA,NA
silence,565350,565600,250,Argentina,A20,NA,NA,NA,NA
silence,566190,567030,840,Argentina,A20,NA,NA,NA,NA
silence,569770,570280,510,Argentina,A20,NA,NA,NA,NA
silence,574930,581560,6630,Argentina,A20,NA,NA,NA,NA
silence,582150,587600,5450,Argentina,A20,NA,NA,NA,NA
silence,588210,588340,130,Argentina,A20,NA,NA,NA,NA
silence,589150,592780,3630,Argentina,A20,NA,NA,NA,NA
silence,593800,595530,1730,Argentina,A20,NA,NA,NA,NA
mother,14,4030,4016,Brazil,B01,f,1,1,a
father,4024,5034,1010,Brazil,B01,m,1,2,a
mother,8700,10300,1600,Brazil,B01,f,1,3,a
mother,12650,13900,1250,Brazil,B01,b,2,1,a
child,16810,18520,1710,Brazil,B01,b,3,1,a
mother,28020,29510,1490,Brazil,B01,f,4,1,a
mother,32400,34020,1620,Brazil,B01,f,4,2,a
father,33720,35500,1780,Brazil,B01,c,4,3,i
father,41200,42310,1110,Brazil,B01,c,4,4,a
father,44360,45000,640,Brazil,B01,c,4,5,a
father,48110,49620,1510,Brazil,B01,c,4,6,a
mother,54420,56300,1880,Brazil,B01,f,4,7,a
father,69100,69910,810,Brazil,B01,c,5,1,q
father,72310,73110,800,Brazil,B01,c,5,2,q
child,73320,74000,680,Brazil,B01,f,5,3,a
mother,88300,89685,1385,Brazil,B01,c,6,1,q
father,92010,92900,890,Brazil,B01,c,6,2,q
father,95400,96086,686,Brazil,B01,c,6,3,q
child,96010,97360,1350,Brazil,B01,f,6,4,i
father,98510,100620,2110,Brazil,B01,c,6,5,q
child,99710,100210,500,Brazil,B01,f,6,6,q
mother,100920,102410,1490,Brazil,B01,f,6,7,a
child,108410,109310,900,Brazil,B01,m,7,1,a
mother,109610,110280,670,Brazil,B01,c,7,2,q
child,110720,113210,2490,Brazil,B01,m,7,3,q
mother,117820,118920,1100,Brazil,B01,c,7,4,a
child,119220,124480,5260,Brazil,B01,m,7,5,q
mother,124610,125420,810,Brazil,B01,c,7,6,a
father,126510,129200,2690,Brazil,B01,c,7,7,a
mother,140910,142020,1110,Brazil,B01,c,8,1,a
father,141820,144300,2480,Brazil,B01,m,9,1,q
mother,144150,148110,3960,Brazil,B01,f,9,2,q
father,151410,152810,1400,Brazil,B01,m,9,3,a
mother,152910,154610,1700,Brazil,B01,f,9,4,a
child,156230,158324,2094,Brazil,B01,m,10,1,q
mother,158590,160349,1759,Brazil,B01,c,10,2,a
child,161310,162210,900,Brazil,B01,m,10,3,a
mother,163410,164700,1290,Brazil,B01,c,10,4,a
father,164500,165380,880,Brazil,B01,c,10,5,a
father,174460,175200,740,Brazil,B01,c,10,6,a
child,194820,196310,1490,Brazil,B01,m,11,1,q
mother,196800,197630,830,Brazil,B01,c,11,2,a
mother,202210,203410,1200,Brazil,B01,c,12,1,a
child,204920,207910,2990,Brazil,B01,b,12,2,q
father,208110,208840,730,Brazil,B01,c,12,3,a
mother,209510,210760,1250,Brazil,B01,c,12,4,a
child,211310,212520,1210,Brazil,B01,m,12,5,a
child,218110,219210,1100,Brazil,B01,f,13,1,q
child,222610,224010,1400,Brazil,B01,f,13,2,a
father,224050,224658,608,Brazil,B01,c,13,3,q
child,224710,225480,770,Brazil,B01,f,13,4,a
father,226020,227000,980,Brazil,B01,c,13,5,a
child,227320,228620,1300,Brazil,B01,f,13,6,a
father,229200,229630,430,Brazil,B01,c,13,7,q
child,229970,230820,850,Brazil,B01,f,13,8,q
father,231910,233104,1194,Brazil,B01,c,13,9,a
child,233320,234110,790,Brazil,B01,f,13,10,a
mother,233900,235020,1120,Brazil,B01,c,13,11,i
father,236020,237720,1700,Brazil,B01,c,13,12,i
mother,242210,243734,1524,Brazil,B01,c,13,13,i
child,246620,248050,1430,Brazil,B01,b,13,14,a
mother,276730,277900,1170,Brazil,B01,b,14,1,q
child,300110,308020,7910,Brazil,B01,f,15,1,a
father,310255,310745,490,Brazil,B01,c,15,2,q
child,310950,311620,670,Brazil,B01,f,15,3,a
child,313200,314610,1410,Brazil,B01,m,16,1,a
child,315310,317060,1750,Brazil,B01,m,16,2,a
mother,317190,317900,710,Brazil,B01,b,17,1,a
child,318700,323700,5000,Brazil,B01,m,18,1,a
mother,323490,324320,830,Brazil,B01,c,18,2,a
child,324990,337310,12320,Brazil,B01,m,18,3,q
father,336100,340616,4516,Brazil,B01,c,19,1,q
child,340960,341840,880,Brazil,B01,f,19,2,a
father,341910,342710,800,Brazil,B01,c,19,3,a
child,343140,343570,430,Brazil,B01,f,19,4,q
mother,343620,347620,4000,Brazil,B01,f,20,1,i
father,348480,349000,520,Brazil,B01,m,20,2,i
mother,365590,368379,2789,Brazil,B01,c,21,1,q
father,378750,380020,1270,Brazil,B01,m,21,2,a
mother,384300,385110,810,Brazil,B01,f,22,1,i
father,385460,386010,550,Brazil,B01,m,22,2,q
mother,385960,386670,710,Brazil,B01,f,22,3,i
mother,388000,390860,2860,Brazil,B01,c,22,4,i
father,393490,394100,610,Brazil,B01,c,22,5,i
mother,393920,395640,1720,Brazil,B01,c,22,6,i
child,396800,399500,2700,Brazil,B01,b,22,7,a
mother,407310,408190,880,Brazil,B01,c,23,1,a
mother,412860,415413,2553,Brazil,B01,f,23,2,a
child,422480,423710,1230,Brazil,B01,m,24,1,a
child,427510,430210,2700,Brazil,B01,m,24,2,q
father,432310,433910,1600,Brazil,B01,b,24,3,a
child,434410,435310,900,Brazil,B01,b,24,4,a
father,438410,439110,700,Brazil,B01,c,24,5,i
child,452320,454010,1690,Brazil,B01,f,25,1,i
child,470880,472320,1440,Brazil,B01,b,26,1,a
mother,475300,476200,900,Brazil,B01,b,27,1,i
child,492610,494800,2190,Brazil,B01,m,28,1,a
mother,494240,495900,1660,Brazil,B01,b,28,2,a
father,499520,501510,1990,Brazil,B01,c,29,1,a
child,506350,507840,1490,Brazil,B01,b,29,2,a
mother,509200,511167,1967,Brazil,B01,o,30,1,q
child,517610,519620,2010,Brazil,B01,b,31,1,q
mother,520910,523310,2400,Brazil,B01,c,31,2,a
father,524510,525280,770,Brazil,B01,c,31,3,a
mother,525220,526800,1580,Brazil,B01,c,31,4,i
child,527160,527920,760,Brazil,B01,m,31,5,a
mother,527620,529020,1400,Brazil,B01,c,31,6,a
father,537570,538610,1040,Brazil,B01,c,31,7,i
child,539620,540810,1190,Brazil,B01,f,31,8,a
father,541080,541550,470,Brazil,B01,c,31,9,a
father,544200,545310,1110,Brazil,B01,c,31,10,i
mother,550310,553489,3179,Brazil,B01,c,32,1,i
father,554600,557190,2590,Brazil,B01,c,32,2,i
father,558000,558940,940,Brazil,B01,c,32,3,i
father,562950,565610,2660,Brazil,B01,c,32,4,i
father,566320,567810,1490,Brazil,B01,c,32,5,a
mother,568010,573100,5090,Brazil,B01,c,32,6,i
child,572590,575290,2700,Brazil,B01,o,32,7,a
mother,575310,576290,980,Brazil,B01,c,32,8,a
child,576000,577050,1050,Brazil,B01,o,32,9,a
father,576410,577600,1190,Brazil,B01,b,32,10,a
mother,578110,579410,1300,Brazil,B01,c,32,11,a
child,579310,581420,2110,Brazil,B01,m,32,12,a
mother,582010,584390,2380,Brazil,B01,c,32,13,i
child,584800,585840,1040,Brazil,B01,m,32,14,a
child,588000,589500,1500,Brazil,B01,m,32,15,i
mother,590400,591410,1010,Brazil,B01,c,32,16,q
child,592130,600190,8060,Brazil,B01,m,32,17,a
mother,556520,557820,1300,Brazil,B01,b,33,1,a
silence,5034,8700,3666,Brazil,B01,NA,NA,NA,NA
silence,10300,12650,2350,Brazil,B01,NA,NA,NA,NA
silence,13900,16810,2910,Brazil,B01,NA,NA,NA,NA
silence,18520,28020,9500,Brazil,B01,NA,NA,NA,NA
mother_gesture,27995,29515,1520,Brazil,B01,NA,NA,NA,NA
silence,29510,32400,2890,Brazil,B01,NA,NA,NA,NA
silence,35500,41200,5700,Brazil,B01,NA,NA,NA,NA
silence,42310,44360,2050,Brazil,B01,NA,NA,NA,NA
silence,45000,48110,3110,Brazil,B01,NA,NA,NA,NA
silence,49620,54420,4800,Brazil,B01,NA,NA,NA,NA
silence,56300,69100,12800,Brazil,B01,NA,NA,NA,NA
silence,69910,72310,2400,Brazil,B01,NA,NA,NA,NA
silence,73110,73320,210,Brazil,B01,NA,NA,NA,NA
silence,74000,88300,14300,Brazil,B01,NA,NA,NA,NA
silence,89685,92010,2325,Brazil,B01,NA,NA,NA,NA
silence,92900,95400,2500,Brazil,B01,NA,NA,NA,NA
silence,97360,98510,1150,Brazil,B01,NA,NA,NA,NA
silence,100620,100920,300,Brazil,B01,NA,NA,NA,NA
silence,102410,108410,6000,Brazil,B01,NA,NA,NA,NA
silence,109310,109610,300,Brazil,B01,NA,NA,NA,NA
silence,110280,110720,440,Brazil,B01,NA,NA,NA,NA
child_gesture,110715,113195,2480,Brazil,B01,NA,NA,NA,NA
silence,113210,117820,4610,Brazil,B01,NA,NA,NA,NA
silence,118920,119220,300,Brazil,B01,NA,NA,NA,NA
silence,124480,124610,130,Brazil,B01,NA,NA,NA,NA
silence,125420,126510,1090,Brazil,B01,NA,NA,NA,NA
silence,129200,140910,11710,Brazil,B01,NA,NA,NA,NA
silence,148110,151410,3300,Brazil,B01,NA,NA,NA,NA
silence,152810,152910,100,Brazil,B01,NA,NA,NA,NA
silence,154610,156230,1620,Brazil,B01,NA,NA,NA,NA
silence,158324,158590,266,Brazil,B01,NA,NA,NA,NA
silence,160349,161310,961,Brazil,B01,NA,NA,NA,NA
silence,162210,163410,1200,Brazil,B01,NA,NA,NA,NA
mother_gesture,163405,164025,620,Brazil,B01,NA,NA,NA,NA
silence,165380,174460,9080,Brazil,B01,NA,NA,NA,NA
silence,175200,194820,19620,Brazil,B01,NA,NA,NA,NA
silence,196310,196800,490,Brazil,B01,NA,NA,NA,NA
silence,197630,202210,4580,Brazil,B01,NA,NA,NA,NA
silence,203410,204920,1510,Brazil,B01,NA,NA,NA,NA
silence,207910,208110,200,Brazil,B01,NA,NA,NA,NA
silence,208840,209510,670,Brazil,B01,NA,NA,NA,NA
silence,210760,211310,550,Brazil,B01,NA,NA,NA,NA
silence,212520,218110,5590,Brazil,B01,NA,NA,NA,NA
silence,219210,222610,3400,Brazil,B01,NA,NA,NA,NA
silence,224010,224050,40,Brazil,B01,NA,NA,NA,NA
silence,224658,224710,52,Brazil,B01,NA,NA,NA,NA
silence,225480,226020,540,Brazil,B01,NA,NA,NA,NA
silence,227000,227320,320,Brazil,B01,NA,NA,NA,NA
silence,228620,229200,580,Brazil,B01,NA,NA,NA,NA
silence,229630,229970,340,Brazil,B01,NA,NA,NA,NA
silence,230820,231910,1090,Brazil,B01,NA,NA,NA,NA
silence,233104,233320,216,Brazil,B01,NA,NA,NA,NA
silence,235020,236020,1000,Brazil,B01,NA,NA,NA,NA
silence,237720,242210,4490,Brazil,B01,NA,NA,NA,NA
silence,243734,246620,2886,Brazil,B01,NA,NA,NA,NA
silence,248050,276730,28680,Brazil,B01,NA,NA,NA,NA
silence,277900,300110,22210,Brazil,B01,NA,NA,NA,NA
silence,308020,310255,2235,Brazil,B01,NA,NA,NA,NA
father_gesture,310265,310755,490,Brazil,B01,NA,NA,NA,NA
silence,310745,310950,205,Brazil,B01,NA,NA,NA,NA
silence,311620,313200,1580,Brazil,B01,NA,NA,NA,NA
silence,314610,315310,700,Brazil,B01,NA,NA,NA,NA
silence,317060,317190,130,Brazil,B01,NA,NA,NA,NA
silence,317900,318700,800,Brazil,B01,NA,NA,NA,NA
child_gesture,322740,323690,950,Brazil,B01,NA,NA,NA,NA
silence,324320,324990,670,Brazil,B01,NA,NA,NA,NA
child_gesture,334295,335915,1620,Brazil,B01,NA,NA,NA,NA
silence,340616,340960,344,Brazil,B01,NA,NA,NA,NA
silence,341840,341910,70,Brazil,B01,NA,NA,NA,NA
silence,342710,343140,430,Brazil,B01,NA,NA,NA,NA
silence,343570,343620,50,Brazil,B01,NA,NA,NA,NA
silence,347620,348480,860,Brazil,B01,NA,NA,NA,NA
silence,349000,365590,16590,Brazil,B01,NA,NA,NA,NA
silence,368379,378750,10371,Brazil,B01,NA,NA,NA,NA
silence,380020,384300,4280,Brazil,B01,NA,NA,NA,NA
silence,385110,385460,350,Brazil,B01,NA,NA,NA,NA
silence,386670,388000,1330,Brazil,B01,NA,NA,NA,NA
silence,390860,393490,2630,Brazil,B01,NA,NA,NA,NA
silence,395640,396800,1160,Brazil,B01,NA,NA,NA,NA
child,399500,399510,10,Brazil,B01,NA,NA,NA,NA
silence,399510,407310,7800,Brazil,B01,NA,NA,NA,NA
silence,408190,412860,4670,Brazil,B01,NA,NA,NA,NA
silence,415413,422480,7067,Brazil,B01,NA,NA,NA,NA
silence,423710,427510,3800,Brazil,B01,NA,NA,NA,NA
silence,430210,432310,2100,Brazil,B01,NA,NA,NA,NA
silence,433910,434410,500,Brazil,B01,NA,NA,NA,NA
silence,435310,438410,3100,Brazil,B01,NA,NA,NA,NA
silence,439110,452320,13210,Brazil,B01,NA,NA,NA,NA
child_gesture,453185,454005,820,Brazil,B01,NA,NA,NA,NA
silence,454010,470880,16870,Brazil,B01,NA,NA,NA,NA
silence,472320,475300,2980,Brazil,B01,NA,NA,NA,NA
silence,476200,492610,16410,Brazil,B01,NA,NA,NA,NA
silence,495900,499520,3620,Brazil,B01,NA,NA,NA,NA
silence,501510,506350,4840,Brazil,B01,NA,NA,NA,NA
silence,507840,509200,1360,Brazil,B01,NA,NA,NA,NA
silence,511167,517610,6443,Brazil,B01,NA,NA,NA,NA
silence,519620,520910,1290,Brazil,B01,NA,NA,NA,NA
silence,523310,524510,1200,Brazil,B01,NA,NA,NA,NA
silence,526800,527160,360,Brazil,B01,NA,NA,NA,NA
silence,529020,537570,8550,Brazil,B01,NA,NA,NA,NA
silence,538610,539620,1010,Brazil,B01,NA,NA,NA,NA
child_gesture,539905,540795,890,Brazil,B01,NA,NA,NA,NA
silence,540810,541080,270,Brazil,B01,NA,NA,NA,NA
silence,541550,544200,2650,Brazil,B01,NA,NA,NA,NA
silence,545310,550310,5000,Brazil,B01,NA,NA,NA,NA
silence,553489,554600,1111,Brazil,B01,NA,NA,NA,NA
silence,557820,558000,180,Brazil,B01,NA,NA,NA,NA
silence,558940,562950,4010,Brazil,B01,NA,NA,NA,NA
silence,565610,566320,710,Brazil,B01,NA,NA,NA,NA
silence,567810,568010,200,Brazil,B01,NA,NA,NA,NA
silence,575290,575310,20,Brazil,B01,NA,NA,NA,NA
silence,577600,578110,510,Brazil,B01,NA,NA,NA,NA
silence,581420,582010,590,Brazil,B01,NA,NA,NA,NA
silence,584390,584800,410,Brazil,B01,NA,NA,NA,NA
silence,585840,588000,2160,Brazil,B01,NA,NA,NA,NA
silence,589500,590400,900,Brazil,B01,NA,NA,NA,NA
silence,591410,592130,720,Brazil,B01,NA,NA,NA,NA
silence,600190,605600,5410,Brazil,B01,NA,NA,NA,NA
child,376,1376,1000,Brazil,B02,b,1,1,a
father,1976,2476,500,Brazil,B02,c,1,2,a
child,3576,4076,500,Brazil,B02,b,1,3,q
mother,3986,4526,540,Brazil,B02,b,1,4,i
child,12066,15776,3710,Brazil,B02,b,1,5,a
mother,15376,20286,4910,Brazil,B02,c,1,6,a
father,21176,22276,1100,Brazil,B02,c,1,7,q
father,26566,27756,1190,Brazil,B02,c,1,8,q
child,27876,28476,600,Brazil,B02,f,1,9,a
child,29476,30776,1300,Brazil,B02,b,1,10,a
father,30886,31566,680,Brazil,B02,c,1,11,q
child,31976,32976,1000,Brazil,B02,f,1,12,a
father,33106,33696,590,Brazil,B02,c,1,13,a
father,43476,47514,4038,Brazil,B02,c,1,14,a
father,49676,51276,1600,Brazil,B02,m,1,15,a
mother,52166,53676,1510,Brazil,B02,f,1,16,a
child,56037,59646,3609,Brazil,B02,b,1,17,a
father,60276,64036,3760,Brazil,B02,c,1,18,a
father,66386,71666,5280,Brazil,B02,c,1,19,q
mother,76556,78966,2410,Brazil,B02,c,1,20,i
child,79576,81576,2000,Brazil,B02,m,1,21,a
father,82076,86469,4393,Brazil,B02,c,1,22,a
child,87266,87966,700,Brazil,B02,m,1,23,a
child,92076,93176,1100,Brazil,B02,b,1,24,q
father,94276,96416,2140,Brazil,B02,c,1,25,i
child,97066,97736,670,Brazil,B02,f,1,26,a
father,97776,98756,980,Brazil,B02,c,1,27,a
father,106276,106876,600,Brazil,B02,m,1,28,a
mother,110166,115286,5120,Brazil,B02,f,1,29,a
father,117176,118266,1090,Brazil,B02,m,1,30,a
mother,120836,123876,3040,Brazil,B02,c,1,31,i
father,127076,127976,900,Brazil,B02,m,1,32,a
child,127866,130956,3090,Brazil,B02,b,1,33,a
child,135813,139297,3484,Brazil,B02,b,1,34,a
father,136076,137266,1190,Brazil,B02,m,1,35,a
mother,137486,138137,651,Brazil,B02,f,1,36,q
father,138376,139366,990,Brazil,B02,m,1,37,a
father,140466,141746,1280,Brazil,B02,c,1,38,a
father,145025,147392,2367,Brazil,B02,c,1,39,a
child,147076,147976,900,Brazil,B02,f,1,40,a
father,201066,202076,1010,Brazil,B02,m,2,1,i
mother,202476,204076,1600,Brazil,B02,c,2,2,i
child,203876,204506,630,Brazil,B02,m,2,3,a
mother,206666,207976,1310,Brazil,B02,c,2,4,a
father,208476,209436,960,Brazil,B02,m,2,5,a
father,212776,213816,1040,Brazil,B02,m,2,6,a
mother,217576,218576,1000,Brazil,B02,c,2,7,a
child,220176,222376,2200,Brazil,B02,m,2,8,a
child,224866,227317,2451,Brazil,B02,m,2,9,i
mother,227076,229076,2000,Brazil,B02,c,2,10,i
father,229566,231106,1540,Brazil,B02,c,2,11,a
father,233376,237256,3880,Brazil,B02,c,2,12,q
child,238076,239096,1020,Brazil,B02,f,2,13,a
child,252866,253876,1010,Brazil,B02,b,3,1,a
child,262776,265076,2300,Brazil,B02,m,3,2,a
mother,265676,267466,1790,Brazil,B02,c,3,3,a
child,268266,269386,1120,Brazil,B02,m,3,4,a
mother,269676,271076,1400,Brazil,B02,c,3,5,q
father,270776,272076,1300,Brazil,B02,c,3,6,a
mother,272486,273986,1500,Brazil,B02,c,3,7,a
child,277876,278756,880,Brazil,B02,m,3,8,a
mother,280290,280924,634,Brazil,B02,c,3,9,a
child,282076,282876,800,Brazil,B02,m,3,10,i
mother,283576,284376,800,Brazil,B02,c,3,11,a
child,284076,285536,1460,Brazil,B02,m,3,12,i
mother,285926,287076,1150,Brazil,B02,c,3,13,a
child,286176,290976,4800,Brazil,B02,m,3,14,a
father,288766,289976,1210,Brazil,B02,c,3,15,a
mother,291366,294176,2810,Brazil,B02,c,3,16,q
father,296776,300176,3400,Brazil,B02,b,3,17,a
child,299376,307076,7700,Brazil,B02,m,3,18,i
father,307166,308316,1150,Brazil,B02,c,3,19,i
mother,313786,315296,1510,Brazil,B02,c,3,20,a
child,317167,318081,914,Brazil,B02,m,3,21,a
child,321156,321966,810,Brazil,B02,m,3,22,a
mother,322176,323446,1270,Brazil,B02,c,3,23,i
child,323776,325666,1890,Brazil,B02,m,3,24,a
mother,329976,330776,800,Brazil,B02,c,3,25,a
father,331076,332276,1200,Brazil,B02,m,3,26,a
mother,333416,349186,15770,Brazil,B02,c,3,27,a
mother,351176,353156,1980,Brazil,B02,c,4,1,q
mother,362876,364176,1300,Brazil,B02,c,5,1,a
child,367166,369166,2000,Brazil,B02,b,5,2,a
mother,370476,373076,2600,Brazil,B02,c,5,3,a
child,374666,375766,1100,Brazil,B02,m,6,1,a
mother,376576,378276,1700,Brazil,B02,c,6,2,a
child,378366,379936,1570,Brazil,B02,m,6,3,a
child,383076,383886,810,Brazil,B02,f,6,4,a
mother,384266,385576,1310,Brazil,B02,c,6,5,a
father,380176,382876,2700,Brazil,B02,c,7,1,a
father,385276,386176,900,Brazil,B02,c,7,2,a
father,389766,391386,1620,Brazil,B02,c,7,3,a
child,392776,393616,840,Brazil,B02,f,7,4,a
mother,409376,410149,773,Brazil,B02,b,8,1,a
child,416876,418376,1500,Brazil,B02,m,8,2,a
mother,418576,419676,1100,Brazil,B02,c,8,3,i
mother,426176,427066,890,Brazil,B02,c,8,4,i
father,477676,478676,1000,Brazil,B02,m,9,1,a
mother,479176,479966,790,Brazil,B02,f,9,2,q
father,479976,480486,510,Brazil,B02,m,9,3,q
mother,481058,482076,1018,Brazil,B02,f,9,4,a
father,482576,484096,1520,Brazil,B02,c,9,5,i
child,484476,484976,500,Brazil,B02,f,9,6,a
father,487076,488576,1500,Brazil,B02,c,10,1,a
father,490611,491390,779,Brazil,B02,c,10,2,a
child,494676,495386,710,Brazil,B02,f,10,3,a
father,495106,496676,1570,Brazil,B02,c,10,4,a
child,496376,498406,2030,Brazil,B02,f,10,5,a
father,498376,499316,940,Brazil,B02,c,10,6,a
child,500766,501466,700,Brazil,B02,f,10,7,a
father,500886,501676,790,Brazil,B02,c,10,8,i
father,503966,504506,540,Brazil,B02,c,10,9,a
child,506086,506676,590,Brazil,B02,f,10,10,a
child,561586,562786,1200,Brazil,B02,m,11,1,a
mother,562576,566276,3700,Brazil,B02,c,11,2,a
child,569876,572066,2190,Brazil,B02,m,11,3,a
mother,572832,573817,985,Brazil,B02,c,11,4,a
mother,577276,579336,2060,Brazil,B02,c,11,5,a
mother,635676,637176,1500,Brazil,B02,c,12,1,a
mother,659776,660686,910,Brazil,B02,c,13,1,q
child,661686,662376,690,Brazil,B02,m,13,2,a
mother,663776,665676,1900,Brazil,B02,c,13,3,q
child,667491,668776,1285,Brazil,B02,m,13,4,q
silence,1376,1976,600,Brazil,B02,NA,NA,NA,NA
silence,2476,3576,1100,Brazil,B02,NA,NA,NA,NA
silence,4526,12066,7540,Brazil,B02,NA,NA,NA,NA
silence,20276,21176,900,Brazil,B02,NA,NA,NA,NA
silence,22276,26566,4290,Brazil,B02,NA,NA,NA,NA
silence,27756,27876,120,Brazil,B02,NA,NA,NA,NA
silence,28476,29476,1000,Brazil,B02,NA,NA,NA,NA
silence,30776,30886,110,Brazil,B02,NA,NA,NA,NA
silence,31566,31976,410,Brazil,B02,NA,NA,NA,NA
silence,32976,33106,130,Brazil,B02,NA,NA,NA,NA
silence,33696,43476,9780,Brazil,B02,NA,NA,NA,NA
silence,47514,49676,2162,Brazil,B02,NA,NA,NA,NA
silence,51276,52166,890,Brazil,B02,NA,NA,NA,NA
silence,53676,56037,2361,Brazil,B02,NA,NA,NA,NA
silence,59646,60276,630,Brazil,B02,NA,NA,NA,NA
silence,64027,66386,2359,Brazil,B02,NA,NA,NA,NA
silence,71666,76556,4890,Brazil,B02,NA,NA,NA,NA
silence,78966,79576,610,Brazil,B02,NA,NA,NA,NA
silence,81576,82076,500,Brazil,B02,NA,NA,NA,NA
silence,86469,87266,797,Brazil,B02,NA,NA,NA,NA
silence,87966,92076,4110,Brazil,B02,NA,NA,NA,NA
silence,93176,94276,1100,Brazil,B02,NA,NA,NA,NA
silence,96416,97066,650,Brazil,B02,NA,NA,NA,NA
silence,97736,97776,40,Brazil,B02,NA,NA,NA,NA
silence,98756,106276,7520,Brazil,B02,NA,NA,NA,NA
silence,106876,110166,3290,Brazil,B02,NA,NA,NA,NA
silence,115286,117176,1890,Brazil,B02,NA,NA,NA,NA
silence,118266,120836,2570,Brazil,B02,NA,NA,NA,NA
silence,123876,127076,3200,Brazil,B02,NA,NA,NA,NA
silence,130956,135813,4857,Brazil,B02,NA,NA,NA,NA
silence,139366,140466,1100,Brazil,B02,NA,NA,NA,NA
silence,141746,145025,3279,Brazil,B02,NA,NA,NA,NA
silence,147976,201066,53090,Brazil,B02,NA,NA,NA,NA
silence,202076,202476,400,Brazil,B02,NA,NA,NA,NA
silence,204506,206666,2160,Brazil,B02,NA,NA,NA,NA
silence,207976,208476,500,Brazil,B02,NA,NA,NA,NA
silence,209436,212776,3340,Brazil,B02,NA,NA,NA,NA
silence,213816,217576,3760,Brazil,B02,NA,NA,NA,NA
silence,218576,220176,1600,Brazil,B02,NA,NA,NA,NA
silence,222376,224866,2490,Brazil,B02,NA,NA,NA,NA
silence,229076,229566,490,Brazil,B02,NA,NA,NA,NA
silence,231106,233376,2270,Brazil,B02,NA,NA,NA,NA
silence,237256,238076,820,Brazil,B02,NA,NA,NA,NA
silence,239096,252866,13770,Brazil,B02,NA,NA,NA,NA
silence,253876,262776,8900,Brazil,B02,NA,NA,NA,NA
silence,265076,265676,600,Brazil,B02,NA,NA,NA,NA
silence,267466,268266,800,Brazil,B02,NA,NA,NA,NA
silence,269386,269676,290,Brazil,B02,NA,NA,NA,NA
silence,272076,272486,410,Brazil,B02,NA,NA,NA,NA
silence,273986,277876,3890,Brazil,B02,NA,NA,NA,NA
silence,278756,280290,1534,Brazil,B02,NA,NA,NA,NA
silence,280924,282076,1152,Brazil,B02,NA,NA,NA,NA
silence,282876,283576,700,Brazil,B02,NA,NA,NA,NA
silence,285536,285926,390,Brazil,B02,NA,NA,NA,NA
silence,290976,291366,390,Brazil,B02,NA,NA,NA,NA
silence,294176,296776,2600,Brazil,B02,NA,NA,NA,NA
silence,307076,307166,90,Brazil,B02,NA,NA,NA,NA
silence,308316,313786,5470,Brazil,B02,NA,NA,NA,NA
silence,315296,317167,1871,Brazil,B02,NA,NA,NA,NA
silence,318081,321156,3075,Brazil,B02,NA,NA,NA,NA
silence,321966,322176,210,Brazil,B02,NA,NA,NA,NA
silence,323446,323776,330,Brazil,B02,NA,NA,NA,NA
silence,325666,329976,4310,Brazil,B02,NA,NA,NA,NA
silence,330776,331076,300,Brazil,B02,NA,NA,NA,NA
silence,332276,333416,1140,Brazil,B02,NA,NA,NA,NA
silence,349186,351176,1990,Brazil,B02,NA,NA,NA,NA
silence,353156,362876,9720,Brazil,B02,NA,NA,NA,NA
silence,364176,367166,2990,Brazil,B02,NA,NA,NA,NA
silence,369166,370476,1310,Brazil,B02,NA,NA,NA,NA
silence,373076,374666,1590,Brazil,B02,NA,NA,NA,NA
silence,375766,376576,810,Brazil,B02,NA,NA,NA,NA
silence,378276,378366,90,Brazil,B02,NA,NA,NA,NA
silence,379936,380176,240,Brazil,B02,NA,NA,NA,NA
silence,382876,383076,200,Brazil,B02,NA,NA,NA,NA
silence,383886,384266,380,Brazil,B02,NA,NA,NA,NA
silence,386176,389766,3590,Brazil,B02,NA,NA,NA,NA
silence,391386,392776,1390,Brazil,B02,NA,NA,NA,NA
silence,393616,409376,15760,Brazil,B02,NA,NA,NA,NA
silence,410149,416876,6727,Brazil,B02,NA,NA,NA,NA
silence,418376,418576,200,Brazil,B02,NA,NA,NA,NA
silence,419676,426176,6500,Brazil,B02,NA,NA,NA,NA
silence,427066,477676,50610,Brazil,B02,NA,NA,NA,NA
silence,478676,479176,500,Brazil,B02,NA,NA,NA,NA
silence,479966,479976,10,Brazil,B02,NA,NA,NA,NA
silence,480486,481058,572,Brazil,B02,NA,NA,NA,NA
silence,482076,482576,500,Brazil,B02,NA,NA,NA,NA
silence,484096,484476,380,Brazil,B02,NA,NA,NA,NA
silence,484976,487076,2100,Brazil,B02,NA,NA,NA,NA
silence,488576,490611,2035,Brazil,B02,NA,NA,NA,NA
silence,491390,494676,3286,Brazil,B02,NA,NA,NA,NA
silence,499316,500766,1450,Brazil,B02,NA,NA,NA,NA
silence,501676,503966,2290,Brazil,B02,NA,NA,NA,NA
silence,504506,506086,1580,Brazil,B02,NA,NA,NA,NA
silence,506676,561586,54910,Brazil,B02,NA,NA,NA,NA
silence,566276,569876,3600,Brazil,B02,NA,NA,NA,NA
silence,572066,572832,766,Brazil,B02,NA,NA,NA,NA
silence,573817,577276,3459,Brazil,B02,NA,NA,NA,NA
silence,579336,635676,56340,Brazil,B02,NA,NA,NA,NA
silence,637176,659776,22600,Brazil,B02,NA,NA,NA,NA
silence,660686,661686,1000,Brazil,B02,NA,NA,NA,NA
silence,662376,663776,1400,Brazil,B02,NA,NA,NA,NA
silence,665676,667491,1815,Brazil,B02,NA,NA,NA,NA
father,3251,3881,630,Brazil,B03,c,1,1,i
child,3971,5361,1390,Brazil,B03,m,1,2,a
father,4861,5901,1040,Brazil,B03,c,1,3,a
mother,5551,7451,1900,Brazil,B03,c,1,4,a
child,7161,8271,1110,Brazil,B03,m,1,5,a
father,11361,13241,1880,Brazil,B03,c,1,6,i
mother,12661,14371,1710,Brazil,B03,c,1,7,i
child,13671,15761,2090,Brazil,B03,b,1,8,a
father,13961,14761,800,Brazil,B03,c,1,9,i
child,19761,20671,910,Brazil,B03,b,1,10,a
mother,24661,27061,2400,Brazil,B03,f,1,11,a
father,27151,30281,3130,Brazil,B03,c,1,12,i
child,28951,30803,1852,Brazil,B03,f,1,13,a
father,31551,33161,1610,Brazil,B03,c,1,14,i
mother,34961,38411,3450,Brazil,B03,b,1,15,a
child,44671,46461,1790,Brazil,B03,b,1,16,a
father,45451,46191,740,Brazil,B03,c,1,17,i
father,51961,53061,1100,Brazil,B03,c,1,18,i
father,67751,71931,4180,Brazil,B03,c,1,19,i
child,73861,75311,1450,Brazil,B03,m,1,20,a
father,76361,77651,1290,Brazil,B03,c,1,21,a
father,79971,82031,2060,Brazil,B03,c,1,22,q
mother,10471,11751,1280,Brazil,B03,f,2,1,a
mother,62061,64961,2900,Brazil,B03,b,3,1,a
mother,65881,66791,910,Brazil,B03,b,3,2,a
father,95751,98061,2310,Brazil,B03,c,4,1,q
child,100461,102861,2400,Brazil,B03,m,4,2,a
father,105461,106431,970,Brazil,B03,c,4,3,q
child,106661,107661,1000,Brazil,B03,f,4,4,a
mother,106761,107861,1100,Brazil,B03,f,4,5,a
mother,99161,100541,1380,Brazil,B03,c,5,1,i
father,114461,115361,900,Brazil,B03,c,5,2,a
mother,117251,121771,4520,Brazil,B03,c,5,3,i
child,117851,118541,690,Brazil,B03,f,5,4,a
father,124551,125301,750,Brazil,B03,c,5,5,i
mother,126871,128041,1170,Brazil,B03,c,5,6,i
child,128146,129046,900,Brazil,B03,m,5,7,a
mother,129461,132341,2880,Brazil,B03,c,5,8,i
father,130761,131861,1100,Brazil,B03,c,5,9,a
father,133651,134331,680,Brazil,B03,c,5,10,i
mother,135061,136661,1600,Brazil,B03,f,6,1,a
father,141261,144464,3203,Brazil,B03,c,6,2,a
mother,141751,142861,1110,Brazil,B03,f,6,3,i
father,147161,147961,800,Brazil,B03,c,7,1,q
mother,148761,150701,1940,Brazil,B03,c,7,2,q
father,171051,174651,3600,Brazil,B03,c,8,1,i
child,174761,176391,1630,Brazil,B03,b,8,2,a
mother,75491,79081,3590,Brazil,B03,c,9,1,q
mother,184361,187951,3590,Brazil,B03,f,9,2,a
father,194661,196761,2100,Brazil,B03,c,9,3,i
child,196961,200941,3980,Brazil,B03,f,9,4,a
child,203081,205211,2130,Brazil,B03,o,9,5,a
mother,207751,209101,1350,Brazil,B03,f,9,6,i
father,211151,212161,1010,Brazil,B03,c,9,7,i
father,216641,217761,1120,Brazil,B03,c,9,8,q
father,220071,221061,990,Brazil,B03,c,9,9,q
mother,221251,222751,1500,Brazil,B03,f,9,10,a
mother,228161,229261,1100,Brazil,B03,b,10,1,a
mother,234481,237761,3280,Brazil,B03,c,10,2,q
mother,242861,244961,2100,Brazil,B03,c,10,3,a
mother,265671,266351,680,Brazil,B03,c,11,1,a
father,266471,268581,2110,Brazil,B03,c,11,2,i
mother,270561,273701,3140,Brazil,B03,c,11,3,i
father,271861,273171,1310,Brazil,B03,m,11,4,a
mother,279471,281441,1970,Brazil,B03,f,11,5,a
father,281951,282651,700,Brazil,B03,m,11,6,q
mother,282681,284261,1580,Brazil,B03,f,11,7,a
father,306261,306961,700,Brazil,B03,c,12,1,q
mother,309051,310421,1370,Brazil,B03,c,12,2,i
father,322771,323591,820,Brazil,B03,c,13,1,i
father,357261,362381,5120,Brazil,B03,c,14,1,i
child,364761,367751,2990,Brazil,B03,m,14,2,i
father,366761,367861,1100,Brazil,B03,c,14,3,a
mother,367181,368671,1490,Brazil,B03,c,14,4,q
father,369261,371491,2230,Brazil,B03,c,14,5,a
child,371551,376341,4790,Brazil,B03,f,14,6,a
father,379151,383061,3910,Brazil,B03,c,14,7,a
child,380361,388051,7690,Brazil,B03,f,14,8,a
father,388221,391622,3401,Brazil,B03,c,14,9,i
child,391522,394471,2949,Brazil,B03,o,14,10,a
child,396506,398710,2204,Brazil,B03,b,14,11,a
father,398951,401421,2470,Brazil,B03,m,14,12,a
child,401421,401481,60,Brazil,B03,o,14,13,a
mother,406971,410831,3860,Brazil,B03,c,14,14,a
child,409771,412061,2290,Brazil,B03,m,14,15,a
mother,412141,412851,710,Brazil,B03,c,14,16,a
father,413111,414061,950,Brazil,B03,c,14,17,i
child,416461,420551,4090,Brazil,B03,m,14,18,a
mother,420591,429181,8590,Brazil,B03,c,14,19,i
child,428561,429851,1290,Brazil,B03,b,14,20,a
child,437871,439661,1790,Brazil,B03,b,14,21,a
mother,443361,445271,1910,Brazil,B03,c,14,22,i
mother,436261,438171,1910,Brazil,B03,f,15,1,q
mother,456561,457571,1010,Brazil,B03,c,16,1,q
mother,459661,461341,1680,Brazil,B03,c,16,2,i
father,460711,462861,2150,Brazil,B03,c,16,3,i
child,465771,467861,2090,Brazil,B03,o,16,4,a
father,466851,467881,1030,Brazil,B03,c,16,5,i
father,475061,477651,2590,Brazil,B03,c,16,6,i
child,477941,478941,1000,Brazil,B03,f,16,7,a
child,481408,488117,6709,Brazil,B03,f,16,8,a
father,482971,485671,2700,Brazil,B03,c,16,9,i
father,494551,495901,1350,Brazil,B03,c,16,10,i
mother,504911,507531,2620,Brazil,B03,c,16,11,q
mother,519071,522811,3740,Brazil,B03,c,17,1,i
father,539161,540861,1700,Brazil,B03,c,17,2,i
father,544261,548661,4400,Brazil,B03,c,17,3,a
mother,548261,550371,2110,Brazil,B03,c,17,4,a
father,550261,552701,2440,Brazil,B03,c,17,5,i
child,551661,553871,2210,Brazil,B03,o,17,6,a
father,523961,529071,5110,Brazil,B03,m,18,1,a
mother,530061,534641,4580,Brazil,B03,f,18,2,a
mother,568261,569681,1420,Brazil,B03,f,18,3,a
father,590161,592861,2700,Brazil,B03,c,18,4,q
child,591661,593481,1820,Brazil,B03,f,19,1,a
father,593571,597061,3490,Brazil,B03,c,19,2,i
child,597271,598161,890,Brazil,B03,f,19,3,a
father,601261,602251,990,Brazil,B03,c,19,4,i
silence,3881,3971,90,Brazil,B03,NA,NA,NA,NA
silence,8271,10471,2200,Brazil,B03,NA,NA,NA,NA
silence,15761,19761,4000,Brazil,B03,NA,NA,NA,NA
silence,20671,24661,3990,Brazil,B03,NA,NA,NA,NA
silence,27061,27151,90,Brazil,B03,NA,NA,NA,NA
silence,30803,31551,748,Brazil,B03,NA,NA,NA,NA
silence,33161,34961,1800,Brazil,B03,NA,NA,NA,NA
silence,38411,44671,6260,Brazil,B03,NA,NA,NA,NA
silence,46461,51961,5500,Brazil,B03,NA,NA,NA,NA
silence,53061,62061,9000,Brazil,B03,NA,NA,NA,NA
silence,64961,65881,920,Brazil,B03,NA,NA,NA,NA
silence,66791,67751,960,Brazil,B03,NA,NA,NA,NA
silence,71931,73861,1930,Brazil,B03,NA,NA,NA,NA
silence,75311,75491,180,Brazil,B03,NA,NA,NA,NA
silence,79081,79971,890,Brazil,B03,NA,NA,NA,NA
silence,82031,95751,13720,Brazil,B03,NA,NA,NA,NA
silence,98061,99161,1100,Brazil,B03,NA,NA,NA,NA
mother_gesture,99308,99704,396,Brazil,B03,NA,NA,NA,NA
silence,102861,105461,2600,Brazil,B03,NA,NA,NA,NA
silence,106431,106661,230,Brazil,B03,NA,NA,NA,NA
silence,107861,114461,6600,Brazil,B03,NA,NA,NA,NA
silence,115361,117251,1890,Brazil,B03,NA,NA,NA,NA
silence,121791,124551,2760,Brazil,B03,NA,NA,NA,NA
silence,125301,126871,1570,Brazil,B03,NA,NA,NA,NA
silence,128041,128146,105,Brazil,B03,NA,NA,NA,NA
silence,129046,129461,415,Brazil,B03,NA,NA,NA,NA
silence,132341,133651,1310,Brazil,B03,NA,NA,NA,NA
silence,134331,135061,730,Brazil,B03,NA,NA,NA,NA
mother_gesture,135395,135758,363,Brazil,B03,NA,NA,NA,NA
silence,136661,141261,4600,Brazil,B03,NA,NA,NA,NA
silence,144464,147161,2697,Brazil,B03,NA,NA,NA,NA
silence,147961,148761,800,Brazil,B03,NA,NA,NA,NA
silence,150701,171051,20350,Brazil,B03,NA,NA,NA,NA
silence,174651,174761,110,Brazil,B03,NA,NA,NA,NA
silence,176391,184361,7970,Brazil,B03,NA,NA,NA,NA
silence,187951,194661,6710,Brazil,B03,NA,NA,NA,NA
silence,196761,196961,200,Brazil,B03,NA,NA,NA,NA
silence,200941,203081,2140,Brazil,B03,NA,NA,NA,NA
silence,205211,207751,2540,Brazil,B03,NA,NA,NA,NA
silence,209101,211151,2050,Brazil,B03,NA,NA,NA,NA
silence,212161,216641,4480,Brazil,B03,NA,NA,NA,NA
silence,217761,220071,2310,Brazil,B03,NA,NA,NA,NA
silence,221061,221251,190,Brazil,B03,NA,NA,NA,NA
mother_gesture,221331,221991,660,Brazil,B03,NA,NA,NA,NA
silence,222751,228161,5410,Brazil,B03,NA,NA,NA,NA
silence,229261,234481,5220,Brazil,B03,NA,NA,NA,NA
silence,237761,242861,5100,Brazil,B03,NA,NA,NA,NA
silence,244961,265671,20710,Brazil,B03,NA,NA,NA,NA
silence,266351,266471,120,Brazil,B03,NA,NA,NA,NA
silence,268590,270561,1971,Brazil,B03,NA,NA,NA,NA
silence,273701,279471,5770,Brazil,B03,NA,NA,NA,NA
silence,281441,281951,510,Brazil,B03,NA,NA,NA,NA
silence,282651,282681,30,Brazil,B03,NA,NA,NA,NA
silence,284261,306261,22000,Brazil,B03,NA,NA,NA,NA
silence,306961,309051,2090,Brazil,B03,NA,NA,NA,NA
silence,310421,322771,12350,Brazil,B03,NA,NA,NA,NA
silence,323591,357261,33670,Brazil,B03,NA,NA,NA,NA
silence,362381,364761,2380,Brazil,B03,NA,NA,NA,NA
silence,368671,369261,590,Brazil,B03,NA,NA,NA,NA
silence,371491,371551,60,Brazil,B03,NA,NA,NA,NA
silence,376341,379151,2810,Brazil,B03,NA,NA,NA,NA
silence,388051,388221,170,Brazil,B03,NA,NA,NA,NA
silence,394471,396506,2035,Brazil,B03,NA,NA,NA,NA
child_gesture,396651,399111,2460,Brazil,B03,NA,NA,NA,NA
silence,398710,398951,241,Brazil,B03,NA,NA,NA,NA
child_gesture,400271,401761,1490,Brazil,B03,NA,NA,NA,NA
silence,401481,406971,5490,Brazil,B03,NA,NA,NA,NA
child_gesture,410887,412541,1654,Brazil,B03,NA,NA,NA,NA
silence,412061,412141,80,Brazil,B03,NA,NA,NA,NA
silence,412851,413111,260,Brazil,B03,NA,NA,NA,NA
silence,414061,416461,2400,Brazil,B03,NA,NA,NA,NA
silence,420551,420591,40,Brazil,B03,NA,NA,NA,NA
silence,429851,436261,6410,Brazil,B03,NA,NA,NA,NA
child_gesture,437276,442767,5491,Brazil,B03,NA,NA,NA,NA
silence,439661,443361,3700,Brazil,B03,NA,NA,NA,NA
silence,445271,456561,11290,Brazil,B03,NA,NA,NA,NA
silence,457571,459661,2090,Brazil,B03,NA,NA,NA,NA
silence,462861,465771,2910,Brazil,B03,NA,NA,NA,NA
silence,467881,475061,7180,Brazil,B03,NA,NA,NA,NA
silence,477651,477941,290,Brazil,B03,NA,NA,NA,NA
silence,478941,481408,2467,Brazil,B03,NA,NA,NA,NA
silence,488117,494551,6434,Brazil,B03,NA,NA,NA,NA
silence,495901,504911,9010,Brazil,B03,NA,NA,NA,NA
silence,507531,519071,11540,Brazil,B03,NA,NA,NA,NA
silence,522811,523961,1150,Brazil,B03,NA,NA,NA,NA
silence,529071,530061,990,Brazil,B03,NA,NA,NA,NA
silence,534641,539161,4520,Brazil,B03,NA,NA,NA,NA
silence,540861,544261,3400,Brazil,B03,NA,NA,NA,NA
silence,553871,568261,14390,Brazil,B03,NA,NA,NA,NA
silence,569681,590161,20480,Brazil,B03,NA,NA,NA,NA
silence,593481,593571,90,Brazil,B03,NA,NA,NA,NA
silence,597061,597271,210,Brazil,B03,NA,NA,NA,NA
silence,598161,601261,3100,Brazil,B03,NA,NA,NA,NA
father,1264,5854,4590,Brazil,B04,c,1,1,a
child,4574,6874,2300,Brazil,B04,f,1,2,a
father,7361,10774,3413,Brazil,B04,c,1,3,a
child,10354,14684,4330,Brazil,B04,f,1,4,a
mother,17084,17974,890,Brazil,B04,c,1,5,q
child,18164,18964,800,Brazil,B04,m,1,6,a
father,18274,20764,2490,Brazil,B04,b,1,7,a
father,22484,31064,8580,Brazil,B04,c,1,8,a
child,31064,32084,1020,Brazil,B04,f,1,9,a
father,32374,39674,7300,Brazil,B04,c,1,10,a
mother,32584,33284,700,Brazil,B04,c,1,11,a
child,38396,38933,537,Brazil,B04,f,1,12,a
father,44234,48174,3940,Brazil,B04,c,1,13,i
father,52774,56774,4000,Brazil,B04,c,1,14,a
child,58354,59044,690,Brazil,B04,f,1,15,a
father,59874,61274,1400,Brazil,B04,f,1,16,a
child,61264,62314,1050,Brazil,B04,f,1,17,a
child,64044,66754,2710,Brazil,B04,f,1,18,a
child,69564,71044,1480,Brazil,B04,f,1,19,q
father,70874,74084,3210,Brazil,B04,c,1,20,a
mother,75184,76364,1180,Brazil,B04,b,2,1,a
child,82354,84474,2120,Brazil,B04,b,2,2,a
father,87896,89454,1558,Brazil,B04,m,2,3,a
child,90574,91974,1400,Brazil,B04,o,2,4,i
mother,92174,94064,1890,Brazil,B04,f,2,5,a
father,94674,96024,1350,Brazil,B04,m,2,6,a
mother,96084,97834,1750,Brazil,B04,f,2,7,a
father,97874,99964,2090,Brazil,B04,c,2,8,i
father,100974,102274,1300,Brazil,B04,c,2,9,a
mother,102274,103451,1177,Brazil,B04,c,2,10,a
father,106584,107674,1090,Brazil,B04,c,2,11,a
mother,117874,120174,2300,Brazil,B04,b,3,1,a
child,121874,122864,990,Brazil,B04,f,3,2,a
father,122984,124034,1050,Brazil,B04,c,3,3,a
child,124444,125664,1220,Brazil,B04,f,3,4,a
child,147974,152474,4500,Brazil,B04,m,4,1,a
mother,152464,153084,620,Brazil,B04,c,4,2,a
child,156784,158714,1930,Brazil,B04,m,4,3,a
child,161010,162835,1825,Brazil,B04,m,4,4,a
father,163274,164804,1530,Brazil,B04,c,4,5,a
child,164994,173084,8090,Brazil,B04,f,4,6,a
father,173364,174044,680,Brazil,B04,c,4,7,i
child,179454,182874,3420,Brazil,B04,f,4,8,a
father,180674,186474,5800,Brazil,B04,c,4,9,q
child,187075,192618,5543,Brazil,B04,f,4,10,a
father,194574,200874,6300,Brazil,B04,c,4,11,a
father,203374,206974,3600,Brazil,B04,c,4,12,a
child,229607,230391,784,Brazil,B04,b,5,1,a
father,230674,231674,1000,Brazil,B04,c,5,2,a
mother,232624,233374,750,Brazil,B04,c,5,3,q
child,233564,234374,810,Brazil,B04,m,5,4,a
mother,234344,235074,730,Brazil,B04,c,5,5,a
father,234915,240574,5659,Brazil,B04,m,5,6,a
child,241594,242964,1370,Brazil,B04,f,5,7,a
father,242830,245084,2254,Brazil,B04,c,5,8,i
child,244762,246764,2002,Brazil,B04,f,5,9,a
child,248274,253074,4800,Brazil,B04,o,6,1,i
father,248984,250164,1180,Brazil,B04,m,7,1,a
mother,251134,252124,990,Brazil,B04,f,7,2,a
father,253274,254814,1540,Brazil,B04,m,7,3,a
child,254749,256474,1725,Brazil,B04,o,8,1,a
mother,271914,272794,880,Brazil,B04,c,8,2,q
father,256474,258234,1760,Brazil,B04,m,9,1,a
mother,259424,260284,860,Brazil,B04,c,9,2,i
child,264384,272274,7890,Brazil,B04,m,9,3,a
father,273264,276484,3220,Brazil,B04,b,9,4,a
child,273274,277364,4090,Brazil,B04,m,9,5,a
child,279554,293654,14100,Brazil,B04,b,9,6,a
mother,293784,294381,597,Brazil,B04,c,9,7,i
child,294464,295344,880,Brazil,B04,m,9,8,a
mother,297429,298280,851,Brazil,B04,c,9,9,i
child,298984,300884,1900,Brazil,B04,m,9,10,a
child,303564,304584,1020,Brazil,B04,m,9,11,q
mother,305874,307094,1220,Brazil,B04,c,9,12,a
child,309054,315094,6040,Brazil,B04,m,9,13,a
mother,320384,320974,590,Brazil,B04,c,9,14,i
child,321674,327784,6110,Brazil,B04,b,9,15,a
mother,333174,334184,1010,Brazil,B04,c,9,16,i
mother,340584,342074,1490,Brazil,B04,c,9,17,a
mother,374774,376674,1900,Brazil,B04,b,10,1,a
child,379004,380214,1210,Brazil,B04,b,10,2,a
mother,384574,385784,1210,Brazil,B04,b,10,3,a
child,386314,394294,7980,Brazil,B04,c,10,4,a
child,398784,399864,1080,Brazil,B04,b,10,5,a
mother,412344,414564,2220,Brazil,B04,c,11,1,q
child,420734,422564,1830,Brazil,B04,o,12,1,i
mother,424464,425091,627,Brazil,B04,c,12,2,a
child,425374,427474,2100,Brazil,B04,m,12,3,a
mother,427674,428544,870,Brazil,B04,c,12,4,a
child,435174,444874,9700,Brazil,B04,f,13,1,a
mother,445164,446744,1580,Brazil,B04,c,13,2,a
child,448144,450064,1920,Brazil,B04,m,13,3,a
mother,450174,450949,775,Brazil,B04,c,13,4,i
child,451174,452086,912,Brazil,B04,m,13,5,a
mother,452874,454244,1370,Brazil,B04,c,13,6,a
mother,458974,459774,800,Brazil,B04,c,13,7,i
child,464883,467399,2516,Brazil,B04,m,13,8,a
mother,467354,468234,880,Brazil,B04,c,13,9,a
child,468714,470554,1840,Brazil,B04,m,13,10,a
child,473445,474874,1429,Brazil,B04,m,13,11,a
child,486474,487974,1500,Brazil,B04,b,14,1,q
mother,491174,492474,1300,Brazil,B04,c,14,2,a
mother,495064,496084,1020,Brazil,B04,c,14,3,a
child,497674,498873,1199,Brazil,B04,b,14,4,a
child,506714,512874,6160,Brazil,B04,b,14,5,q
child,514404,515764,1360,Brazil,B04,b,14,6,a
mother,515764,516974,1210,Brazil,B04,c,14,7,q
child,518464,520764,2300,Brazil,B04,b,14,8,a
mother,520774,522974,2200,Brazil,B04,c,14,9,q
child,522084,525974,3890,Brazil,B04,m,14,10,a
child,528774,534174,5400,Brazil,B04,b,14,11,a
mother,534184,535106,922,Brazil,B04,c,14,12,q
child,535545,551884,16339,Brazil,B04,m,14,13,a
father,547254,548674,1420,Brazil,B04,c,14,14,i
child,559458,568574,9116,Brazil,B04,f,14,15,i
father,569174,570084,910,Brazil,B04,c,14,16,a
child,572574,574184,1610,Brazil,B04,f,14,17,a
mother,576174,577047,873,Brazil,B04,c,14,18,a
child,584054,585933,1879,Brazil,B04,m,14,19,a
child,615874,618074,2200,Brazil,B04,b,15,1,a
silence,6874,7361,487,Brazil,B04,NA,NA,NA,NA
silence,14684,17084,2400,Brazil,B04,NA,NA,NA,NA
silence,17974,18164,190,Brazil,B04,NA,NA,NA,NA
silence,20764,22484,1720,Brazil,B04,NA,NA,NA,NA
silence,32084,32374,290,Brazil,B04,NA,NA,NA,NA
silence,39674,44234,4560,Brazil,B04,NA,NA,NA,NA
silence,48174,52774,4600,Brazil,B04,NA,NA,NA,NA
silence,56774,58354,1580,Brazil,B04,NA,NA,NA,NA
silence,59044,59874,830,Brazil,B04,NA,NA,NA,NA
silence,62314,64044,1730,Brazil,B04,NA,NA,NA,NA
silence,66754,69564,2810,Brazil,B04,NA,NA,NA,NA
silence,74084,75184,1100,Brazil,B04,NA,NA,NA,NA
silence,76364,82354,5990,Brazil,B04,NA,NA,NA,NA
child_gesture,83451,84243,792,Brazil,B04,NA,NA,NA,NA
silence,84474,87964,3490,Brazil,B04,NA,NA,NA,NA
silence,89524,90574,1050,Brazil,B04,NA,NA,NA,NA
silence,91974,92174,200,Brazil,B04,NA,NA,NA,NA
silence,94064,94674,610,Brazil,B04,NA,NA,NA,NA
silence,96024,96084,60,Brazil,B04,NA,NA,NA,NA
silence,97834,97874,40,Brazil,B04,NA,NA,NA,NA
silence,99964,100974,1010,Brazil,B04,NA,NA,NA,NA
silence,103451,106584,3133,Brazil,B04,NA,NA,NA,NA
silence,107674,117874,10200,Brazil,B04,NA,NA,NA,NA
silence,120174,121874,1700,Brazil,B04,NA,NA,NA,NA
silence,122864,122984,120,Brazil,B04,NA,NA,NA,NA
silence,124034,124444,410,Brazil,B04,NA,NA,NA,NA
silence,125664,147974,22310,Brazil,B04,NA,NA,NA,NA
silence,153084,156784,3700,Brazil,B04,NA,NA,NA,NA
silence,158714,161010,2296,Brazil,B04,NA,NA,NA,NA
child_gesture,161614,162008,394,Brazil,B04,NA,NA,NA,NA
silence,162835,163274,439,Brazil,B04,NA,NA,NA,NA
silence,164804,164994,190,Brazil,B04,NA,NA,NA,NA
silence,173084,173364,280,Brazil,B04,NA,NA,NA,NA
silence,174044,179454,5410,Brazil,B04,NA,NA,NA,NA
silence,186474,187075,601,Brazil,B04,NA,NA,NA,NA
child_gesture,187235,194404,7169,Brazil,B04,NA,NA,NA,NA
silence,192618,194574,1956,Brazil,B04,NA,NA,NA,NA
silence,200874,203374,2500,Brazil,B04,NA,NA,NA,NA
silence,206974,229607,22633,Brazil,B04,NA,NA,NA,NA
child_gesture,229462,231045,1583,Brazil,B04,NA,NA,NA,NA
silence,230391,230674,283,Brazil,B04,NA,NA,NA,NA
silence,231674,232624,950,Brazil,B04,NA,NA,NA,NA
silence,233374,233564,190,Brazil,B04,NA,NA,NA,NA
silence,240574,241594,1020,Brazil,B04,NA,NA,NA,NA
silence,246764,248274,1510,Brazil,B04,NA,NA,NA,NA
silence,253074,253274,200,Brazil,B04,NA,NA,NA,NA
silence,258234,259424,1190,Brazil,B04,NA,NA,NA,NA
silence,260284,264384,4100,Brazil,B04,NA,NA,NA,NA
silence,272794,273264,470,Brazil,B04,NA,NA,NA,NA
silence,277364,279554,2190,Brazil,B04,NA,NA,NA,NA
silence,293654,293784,130,Brazil,B04,NA,NA,NA,NA
silence,294381,294464,83,Brazil,B04,NA,NA,NA,NA
silence,295344,297429,2085,Brazil,B04,NA,NA,NA,NA
silence,298280,298984,704,Brazil,B04,NA,NA,NA,NA
silence,300884,303564,2680,Brazil,B04,NA,NA,NA,NA
silence,304584,305874,1290,Brazil,B04,NA,NA,NA,NA
silence,307094,309054,1960,Brazil,B04,NA,NA,NA,NA
silence,315094,320384,5290,Brazil,B04,NA,NA,NA,NA
silence,320974,321674,700,Brazil,B04,NA,NA,NA,NA
silence,327784,333174,5390,Brazil,B04,NA,NA,NA,NA
silence,334184,340584,6400,Brazil,B04,NA,NA,NA,NA
silence,342074,374774,32700,Brazil,B04,NA,NA,NA,NA
silence,376674,379004,2330,Brazil,B04,NA,NA,NA,NA
silence,380214,384574,4360,Brazil,B04,NA,NA,NA,NA
silence,385784,386314,530,Brazil,B04,NA,NA,NA,NA
silence,394294,398784,4490,Brazil,B04,NA,NA,NA,NA
silence,399864,412344,12480,Brazil,B04,NA,NA,NA,NA
silence,414564,420734,6170,Brazil,B04,NA,NA,NA,NA
child_gesture,420907,422501,1594,Brazil,B04,NA,NA,NA,NA
silence,422564,424464,1900,Brazil,B04,NA,NA,NA,NA
silence,425091,425374,283,Brazil,B04,NA,NA,NA,NA
child_gesture,425443,426471,1028,Brazil,B04,NA,NA,NA,NA
silence,427474,427674,200,Brazil,B04,NA,NA,NA,NA
silence,428544,435174,6630,Brazil,B04,NA,NA,NA,NA
child_gesture,434993,437925,2932,Brazil,B04,NA,NA,NA,NA
child_gesture,441535,445340,3805,Brazil,B04,NA,NA,NA,NA
silence,444874,445164,290,Brazil,B04,NA,NA,NA,NA
silence,446744,448144,1400,Brazil,B04,NA,NA,NA,NA
silence,450064,450174,110,Brazil,B04,NA,NA,NA,NA
silence,450949,451174,225,Brazil,B04,NA,NA,NA,NA
silence,452086,452874,788,Brazil,B04,NA,NA,NA,NA
silence,454244,458974,4730,Brazil,B04,NA,NA,NA,NA
silence,459774,464883,5109,Brazil,B04,NA,NA,NA,NA
silence,468234,468714,480,Brazil,B04,NA,NA,NA,NA
silence,470554,473445,2891,Brazil,B04,NA,NA,NA,NA
silence,474874,486474,11600,Brazil,B04,NA,NA,NA,NA
silence,487974,491174,3200,Brazil,B04,NA,NA,NA,NA
silence,492474,495064,2590,Brazil,B04,NA,NA,NA,NA
silence,496084,497674,1590,Brazil,B04,NA,NA,NA,NA
silence,498873,506714,7841,Brazil,B04,NA,NA,NA,NA
silence,512874,514404,1530,Brazil,B04,NA,NA,NA,NA
silence,516974,518464,1490,Brazil,B04,NA,NA,NA,NA
silence,520764,520774,10,Brazil,B04,NA,NA,NA,NA
silence,525974,528774,2800,Brazil,B04,NA,NA,NA,NA
child_gesture,529622,538575,8953,Brazil,B04,NA,NA,NA,NA
silence,534174,534184,10,Brazil,B04,NA,NA,NA,NA
silence,535106,535545,439,Brazil,B04,NA,NA,NA,NA
child_gesture,543906,547608,3702,Brazil,B04,NA,NA,NA,NA
silence,551884,559458,7574,Brazil,B04,NA,NA,NA,NA
silence,568574,569174,600,Brazil,B04,NA,NA,NA,NA
silence,570084,572574,2490,Brazil,B04,NA,NA,NA,NA
silence,574184,576174,1990,Brazil,B04,NA,NA,NA,NA
silence,577047,584054,7007,Brazil,B04,NA,NA,NA,NA
silence,585933,615874,29941,Brazil,B04,NA,NA,NA,NA
child,180,4060,3880,Brazil,B05,b,1,1,a
mother,2460,6220,3760,Brazil,B05,f,2,1,a
child,20360,24700,4340,Brazil,B05,f,3,1,a
child,35191,35675,484,Brazil,B05,b,3,2,a
mother,36140,38590,2450,Brazil,B05,c,3,3,i
child,45010,46470,1460,Brazil,B05,m,3,4,a
mother,46990,47660,670,Brazil,B05,c,3,5,q
child,48670,50070,1400,Brazil,B05,m,3,6,a
mother,51970,52440,470,Brazil,B05,c,3,7,i
mother,55320,59550,4230,Brazil,B05,c,3,8,i
mother,20468,28030,7562,Brazil,B05,c,4,1,i
father,59770,61520,1750,Brazil,B05,m,4,2,i
child,65852,67199,1347,Brazil,B05,b,5,1,a
father,67107,71000,3893,Brazil,B05,c,5,2,q
child,71700,72820,1120,Brazil,B05,f,5,3,a
father,73213,74130,917,Brazil,B05,c,5,4,i
child,74990,77110,2120,Brazil,B05,f,5,5,a
father,75950,76400,450,Brazil,B05,c,5,6,i
child,84628,87980,3352,Brazil,B05,b,5,7,a
mother,93090,94161,1071,Brazil,B05,f,6,1,q
father,94692,95147,455,Brazil,B05,m,6,2,a
mother,95971,100550,4579,Brazil,B05,f,6,3,a
father,102090,102800,710,Brazil,B05,m,6,4,a
mother,106417,109930,3513,Brazil,B05,f,6,5,a
mother,114028,115500,1472,Brazil,B05,f,6,6,a
mother,128758,129853,1095,Brazil,B05,c,7,1,i
father,132530,132920,390,Brazil,B05,b,8,1,a
mother,148170,149690,1520,Brazil,B05,f,9,1,a
father,156168,156801,633,Brazil,B05,c,9,2,i
child,156560,157945,1385,Brazil,B05,m,9,3,i
mother,158006,158601,595,Brazil,B05,c,9,4,q
child,158689,173490,14801,Brazil,B05,b,9,5,a
mother,168430,168810,380,Brazil,B05,f,9,6,i
father,173552,175950,2398,Brazil,B05,c,9,7,i
mother,165080,165620,540,Brazil,B05,f,10,1,a
father,166554,167170,616,Brazil,B05,m,10,2,a
father,196972,197262,290,Brazil,B05,c,11,1,i
mother,197818,198798,980,Brazil,B05,c,11,2,i
father,204456,205780,1324,Brazil,B05,c,11,3,a
child,205667,207540,1873,Brazil,B05,f,11,4,a
mother,223640,224690,1050,Brazil,B05,c,12,1,i
mother,228399,231980,3581,Brazil,B05,c,12,2,i
child,230291,230577,286,Brazil,B05,b,12,3,a
child,254350,257860,3510,Brazil,B05,m,13,1,a
mother,265380,268330,2950,Brazil,B05,f,13,2,a
mother,281560,282650,1090,Brazil,B05,f,14,1,q
mother,295026,296221,1195,Brazil,B05,f,15,1,q
father,297478,298443,965,Brazil,B05,m,15,2,i
mother,298031,299027,996,Brazil,B05,f,15,3,a
father,300127,300769,642,Brazil,B05,m,15,4,a
mother,306365,307047,682,Brazil,B05,f,15,5,a
father,307690,308027,337,Brazil,B05,m,15,6,a
mother,308760,310200,1440,Brazil,B05,f,15,7,a
father,310340,312390,2050,Brazil,B05,m,15,8,a
mother,312200,312700,500,Brazil,B05,f,15,9,q
father,314136,315070,934,Brazil,B05,m,15,10,a
mother,316390,319230,2840,Brazil,B05,f,15,11,q
father,317594,318476,882,Brazil,B05,m,15,12,a
child,317918,319600,1682,Brazil,B05,b,15,13,a
mother,320601,325049,4448,Brazil,B05,f,15,14,a
father,325590,326099,509,Brazil,B05,m,15,15,a
father,329041,329965,924,Brazil,B05,m,15,16,a
mother,332080,342610,10530,Brazil,B05,f,15,17,a
mother,344883,349360,4477,Brazil,B05,f,15,18,a
mother,356010,357660,1650,Brazil,B05,f,15,19,q
father,359780,361000,1220,Brazil,B05,m,15,20,a
mother,362356,363907,1551,Brazil,B05,f,15,21,a
child,364540,365231,691,Brazil,B05,b,15,22,a
mother,366923,376080,9157,Brazil,B05,c,15,23,i
father,367690,368300,610,Brazil,B05,c,15,24,a
mother,384562,385271,709,Brazil,B05,c,15,25,i
father,385050,390740,5690,Brazil,B05,c,15,26,i
mother,390980,392836,1856,Brazil,B05,c,15,27,a
child,393540,395270,1730,Brazil,B05,m,15,28,a
mother,394690,395813,1123,Brazil,B05,c,15,29,a
father,395130,396428,1298,Brazil,B05,c,15,30,a
child,397538,399048,1510,Brazil,B05,f,15,31,a
father,399150,400310,1160,Brazil,B05,c,15,32,i
child,405983,409130,3147,Brazil,B05,b,15,33,a
mother,410720,411480,760,Brazil,B05,c,15,34,i
father,411844,412564,720,Brazil,B05,c,15,35,a
mother,412687,415640,2953,Brazil,B05,b,15,36,a
father,416368,417130,762,Brazil,B05,c,15,37,i
mother,417939,419011,1072,Brazil,B05,b,15,38,a
child,418578,420132,1554,Brazil,B05,m,15,39,a
mother,420110,420620,510,Brazil,B05,c,15,40,i
father,432190,433360,1170,Brazil,B05,m,16,1,q
mother,433733,439070,5337,Brazil,B05,f,16,2,a
father,438787,440502,1715,Brazil,B05,m,16,3,q
mother,441596,449200,7604,Brazil,B05,f,16,4,a
child,457650,460550,2900,Brazil,B05,f,17,1,a
father,458686,461140,2454,Brazil,B05,c,17,2,q
child,461550,462604,1054,Brazil,B05,f,17,3,a
father,462524,462773,249,Brazil,B05,c,17,4,a
mother,466963,472990,6027,Brazil,B05,f,18,1,a
mother,477582,484250,6668,Brazil,B05,f,18,2,a
child,487200,494400,7200,Brazil,B05,m,19,1,a
child,496553,498787,2234,Brazil,B05,m,19,2,a
mother,497980,498860,880,Brazil,B05,c,19,3,a
child,499630,501860,2230,Brazil,B05,m,19,4,a
mother,503650,505900,2250,Brazil,B05,c,19,5,a
child,505847,506432,585,Brazil,B05,m,19,6,a
father,507980,508630,650,Brazil,B05,m,19,7,a
mother,510287,511520,1233,Brazil,B05,c,19,8,i
father,510970,511795,825,Brazil,B05,c,19,9,a
mother,513090,514033,943,Brazil,B05,c,19,10,i
father,514720,516678,1958,Brazil,B05,c,19,11,a
mother,516382,516845,463,Brazil,B05,c,19,12,a
child,523270,524473,1203,Brazil,B05,m,19,13,a
mother,524088,528260,4172,Brazil,B05,c,19,14,a
father,529049,529921,872,Brazil,B05,b,19,15,a
child,530154,534130,3976,Brazil,B05,b,19,16,a
mother,530440,531567,1127,Brazil,B05,f,19,17,i
child,537420,541670,4250,Brazil,B05,f,19,18,a
mother,541780,542830,1050,Brazil,B05,f,19,19,a
father,542683,543731,1048,Brazil,B05,c,19,20,a
mother,543970,544930,960,Brazil,B05,c,19,21,a
father,544580,545830,1250,Brazil,B05,c,19,22,a
mother,545593,550950,5357,Brazil,B05,f,19,23,a
child,545990,547283,1293,Brazil,B05,b,19,24,a
father,551590,554190,2600,Brazil,B05,c,19,25,a
child,553480,554490,1010,Brazil,B05,b,19,26,a
father,556230,557030,800,Brazil,B05,c,19,27,i
father,559110,560230,1120,Brazil,B05,c,19,28,i
mother,563911,567800,3889,Brazil,B05,c,19,29,i
child,568750,570420,1670,Brazil,B05,m,19,30,q
mother,570091,572080,1989,Brazil,B05,c,19,31,a
child,581960,582920,960,Brazil,B05,m,19,32,a
mother,584791,585202,411,Brazil,B05,c,19,33,a
mother,593642,595880,2238,Brazil,B05,o,20,1,i
mother,598206,598543,337,Brazil,B05,o,20,2,a
child_gesture,1059,3476,2417,Brazil,B05,NA,NA,NA,NA
silence,6220,20360,14140,Brazil,B05,NA,NA,NA,NA
silence,28032,35191,7159,Brazil,B05,NA,NA,NA,NA
silence,35675,36140,465,Brazil,B05,NA,NA,NA,NA
silence,38590,45010,6420,Brazil,B05,NA,NA,NA,NA
child_gesture,45478,47228,1750,Brazil,B05,NA,NA,NA,NA
silence,46470,46990,520,Brazil,B05,NA,NA,NA,NA
silence,47660,48670,1010,Brazil,B05,NA,NA,NA,NA
silence,50070,51970,1900,Brazil,B05,NA,NA,NA,NA
silence,52440,55320,2880,Brazil,B05,NA,NA,NA,NA
silence,59530,59770,240,Brazil,B05,NA,NA,NA,NA
father_gesture,60134,60959,825,Brazil,B05,NA,NA,NA,NA
silence,61520,65852,4332,Brazil,B05,NA,NA,NA,NA
silence,71000,71700,700,Brazil,B05,NA,NA,NA,NA
silence,72820,73213,393,Brazil,B05,NA,NA,NA,NA
father_gesture,73143,73531,388,Brazil,B05,NA,NA,NA,NA
silence,74130,74990,860,Brazil,B05,NA,NA,NA,NA
silence,77110,84628,7518,Brazil,B05,NA,NA,NA,NA
silence,87980,93090,5110,Brazil,B05,NA,NA,NA,NA
silence,94161,94692,531,Brazil,B05,NA,NA,NA,NA
silence,95147,95971,824,Brazil,B05,NA,NA,NA,NA
silence,100550,102090,1540,Brazil,B05,NA,NA,NA,NA
silence,102800,106417,3617,Brazil,B05,NA,NA,NA,NA
silence,109930,114028,4098,Brazil,B05,NA,NA,NA,NA
silence,115500,128758,13258,Brazil,B05,NA,NA,NA,NA
silence,129853,132530,2677,Brazil,B05,NA,NA,NA,NA
silence,132920,148170,15250,Brazil,B05,NA,NA,NA,NA
silence,149690,156168,6478,Brazil,B05,NA,NA,NA,NA
father_gesture,156535,156799,264,Brazil,B05,NA,NA,NA,NA
silence,157945,158006,61,Brazil,B05,NA,NA,NA,NA
silence,158601,158689,88,Brazil,B05,NA,NA,NA,NA
silence,173500,173552,52,Brazil,B05,NA,NA,NA,NA
silence,175950,196972,21022,Brazil,B05,NA,NA,NA,NA
silence,197262,197818,556,Brazil,B05,NA,NA,NA,NA
silence,198798,204456,5658,Brazil,B05,NA,NA,NA,NA
silence,207540,223640,16100,Brazil,B05,NA,NA,NA,NA
silence,224690,228399,3709,Brazil,B05,NA,NA,NA,NA
mother_gesture,230917,231577,660,Brazil,B05,NA,NA,NA,NA
silence,231980,254350,22370,Brazil,B05,NA,NA,NA,NA
mother_gesture,233084,233414,330,Brazil,B05,NA,NA,NA,NA
silence,257860,265380,7520,Brazil,B05,NA,NA,NA,NA
silence,268330,281560,13230,Brazil,B05,NA,NA,NA,NA
silence,282650,295026,12376,Brazil,B05,NA,NA,NA,NA
silence,296221,297478,1257,Brazil,B05,NA,NA,NA,NA
silence,299027,300127,1100,Brazil,B05,NA,NA,NA,NA
silence,300769,306365,5596,Brazil,B05,NA,NA,NA,NA
silence,307047,307690,643,Brazil,B05,NA,NA,NA,NA
silence,308027,308760,733,Brazil,B05,NA,NA,NA,NA
silence,310200,310340,140,Brazil,B05,NA,NA,NA,NA
silence,312700,314136,1436,Brazil,B05,NA,NA,NA,NA
silence,315070,316390,1320,Brazil,B05,NA,NA,NA,NA
silence,319600,320601,1001,Brazil,B05,NA,NA,NA,NA
silence,325049,325590,541,Brazil,B05,NA,NA,NA,NA
silence,326099,329041,2942,Brazil,B05,NA,NA,NA,NA
silence,329965,332080,2115,Brazil,B05,NA,NA,NA,NA
silence,342610,344883,2273,Brazil,B05,NA,NA,NA,NA
silence,349360,356010,6650,Brazil,B05,NA,NA,NA,NA
silence,357660,359780,2120,Brazil,B05,NA,NA,NA,NA
silence,361000,362356,1356,Brazil,B05,NA,NA,NA,NA
silence,363907,364540,633,Brazil,B05,NA,NA,NA,NA
silence,365231,366923,1692,Brazil,B05,NA,NA,NA,NA
mother_gesture,374912,375907,995,Brazil,B05,NA,NA,NA,NA
silence,376080,384562,8482,Brazil,B05,NA,NA,NA,NA
silence,390740,390980,240,Brazil,B05,NA,NA,NA,NA
silence,392836,393540,704,Brazil,B05,NA,NA,NA,NA
silence,396428,397538,1110,Brazil,B05,NA,NA,NA,NA
silence,399048,399150,102,Brazil,B05,NA,NA,NA,NA
father_gesture,399780,400242,462,Brazil,B05,NA,NA,NA,NA
silence,400310,405983,5673,Brazil,B05,NA,NA,NA,NA
child_gesture,405970,409136,3166,Brazil,B05,NA,NA,NA,NA
silence,409130,410720,1590,Brazil,B05,NA,NA,NA,NA
silence,411480,411844,364,Brazil,B05,NA,NA,NA,NA
silence,412564,412687,123,Brazil,B05,NA,NA,NA,NA
silence,415640,416368,728,Brazil,B05,NA,NA,NA,NA
silence,417130,417939,809,Brazil,B05,NA,NA,NA,NA
child_gesture,418467,420581,2114,Brazil,B05,NA,NA,NA,NA
silence,420620,432190,11570,Brazil,B05,NA,NA,NA,NA
silence,433360,433733,373,Brazil,B05,NA,NA,NA,NA
silence,440502,441596,1094,Brazil,B05,NA,NA,NA,NA
silence,449200,457650,8450,Brazil,B05,NA,NA,NA,NA
child_gesture,458115,464120,6005,Brazil,B05,NA,NA,NA,NA
silence,461140,461550,410,Brazil,B05,NA,NA,NA,NA
silence,462773,466963,4190,Brazil,B05,NA,NA,NA,NA
silence,472990,477582,4592,Brazil,B05,NA,NA,NA,NA
silence,484250,487200,2950,Brazil,B05,NA,NA,NA,NA
silence,494392,496553,2161,Brazil,B05,NA,NA,NA,NA
silence,498860,499630,770,Brazil,B05,NA,NA,NA,NA
silence,501860,503650,1790,Brazil,B05,NA,NA,NA,NA
silence,506432,507980,1548,Brazil,B05,NA,NA,NA,NA
silence,508630,510287,1657,Brazil,B05,NA,NA,NA,NA
silence,511795,513090,1295,Brazil,B05,NA,NA,NA,NA
silence,514033,514720,687,Brazil,B05,NA,NA,NA,NA
silence,516845,523270,6425,Brazil,B05,NA,NA,NA,NA
mother_gesture,526225,528073,1848,Brazil,B05,NA,NA,NA,NA
silence,528260,529049,789,Brazil,B05,NA,NA,NA,NA
silence,529921,530154,233,Brazil,B05,NA,NA,NA,NA
silence,534130,537420,3290,Brazil,B05,NA,NA,NA,NA
silence,541670,541780,110,Brazil,B05,NA,NA,NA,NA
silence,543731,543970,239,Brazil,B05,NA,NA,NA,NA
silence,550940,551590,650,Brazil,B05,NA,NA,NA,NA
silence,554490,556230,1740,Brazil,B05,NA,NA,NA,NA
silence,557030,559110,2080,Brazil,B05,NA,NA,NA,NA
silence,560230,563911,3681,Brazil,B05,NA,NA,NA,NA
silence,567800,568750,950,Brazil,B05,NA,NA,NA,NA
silence,572080,581960,9880,Brazil,B05,NA,NA,NA,NA
silence,582920,584791,1871,Brazil,B05,NA,NA,NA,NA
silence,585202,593642,8440,Brazil,B05,NA,NA,NA,NA
silence,595880,598206,2326,Brazil,B05,NA,NA,NA,NA
mother,260,1746,1486,Brazil,B06,c,1,1,a
child,2357,2598,241,Brazil,B06,m,1,2,a
mother,2902,6440,3538,Brazil,B06,c,1,3,i
child,5641,5964,323,Brazil,B06,m,1,4,a
father,6000,8020,2020,Brazil,B06,c,1,5,a
child,8440,9360,920,Brazil,B06,b,1,6,a
father,13220,14070,850,Brazil,B06,c,1,7,i
child,14405,15288,883,Brazil,B06,f,1,8,a
father,16039,16980,941,Brazil,B06,c,1,9,q
father,19004,19701,697,Brazil,B06,c,1,10,a
mother,20000,20950,950,Brazil,B06,c,1,11,a
mother,22804,23195,391,Brazil,B06,c,1,12,i
child,24120,25180,1060,Brazil,B06,m,1,13,i
father,25970,29250,3280,Brazil,B06,c,1,14,a
child,29851,31102,1251,Brazil,B06,m,1,15,a
mother,30720,31490,770,Brazil,B06,c,1,16,i
child,31520,36482,4962,Brazil,B06,m,1,17,a
child,38990,47290,8300,Brazil,B06,f,1,18,a
mother,47270,48330,1060,Brazil,B06,b,1,19,a
father,51630,53100,1470,Brazil,B06,m,2,1,q
mother,53250,53700,450,Brazil,B06,f,2,2,a
father,56790,58290,1500,Brazil,B06,m,2,3,a
child,59895,61890,1995,Brazil,B06,f,3,1,i
father,61770,65400,3630,Brazil,B06,c,3,2,a
child,76370,77720,1350,Brazil,B06,f,4,1,q
father,77782,78094,312,Brazil,B06,c,4,2,a
father,81541,82478,937,Brazil,B06,b,4,3,a
child,83320,85210,1890,Brazil,B06,f,4,4,a
child,88209,90365,2156,Brazil,B06,f,4,5,a
father,90200,95930,5730,Brazil,B06,c,4,6,a
mother,96159,96842,683,Brazil,B06,c,4,7,i
child,97560,98360,800,Brazil,B06,b,4,8,a
father,98000,99240,1240,Brazil,B06,c,4,9,i
child,100154,102720,2566,Brazil,B06,b,4,10,a
father,109800,112640,2840,Brazil,B06,m,5,1,a
mother,128718,129610,892,Brazil,B06,b,6,1,a
mother,138930,140427,1497,Brazil,B06,f,6,2,a
father,141480,142600,1120,Brazil,B06,m,6,3,i
mother,143040,146300,3260,Brazil,B06,f,6,4,a
child,136850,137470,620,Brazil,B06,m,7,1,a
mother,153540,157280,3740,Brazil,B06,f,7,2,i
father,156670,157687,1017,Brazil,B06,m,7,3,q
mother,158058,159548,1490,Brazil,B06,f,7,4,a
child,172014,173628,1614,Brazil,B06,m,8,1,a
father,174720,175529,809,Brazil,B06,c,8,2,a
father,178956,179856,900,Brazil,B06,b,8,3,a
mother,183920,184979,1059,Brazil,B06,c,8,4,q
child,184900,189434,4534,Brazil,B06,f,9,1,a
father,190150,191545,1395,Brazil,B06,c,9,2,a
child,192440,192990,550,Brazil,B06,f,9,3,a
father,193070,194234,1164,Brazil,B06,c,9,4,i
child,194627,198240,3613,Brazil,B06,f,9,5,a
mother,197310,202650,5340,Brazil,B06,b,9,6,a
father,202397,204460,2063,Brazil,B06,c,9,7,i
child,204853,207434,2581,Brazil,B06,m,9,8,a
mother,207140,208940,1800,Brazil,B06,c,9,9,a
child,208640,209310,670,Brazil,B06,b,9,10,a
father,208740,211790,3050,Brazil,B06,c,9,11,a
mother,211697,212450,753,Brazil,B06,f,9,12,a
child,212682,216410,3728,Brazil,B06,f,9,13,i
father,214615,215134,519,Brazil,B06,c,9,14,a
child,217760,219090,1330,Brazil,B06,f,9,15,a
father,218996,219872,876,Brazil,B06,c,9,16,i
child,221366,225340,3974,Brazil,B06,f,9,17,a
mother,225003,225436,433,Brazil,B06,c,9,18,a
child,226930,229430,2500,Brazil,B06,f,9,19,a
child,232260,236080,3820,Brazil,B06,f,9,20,i
father,234730,235270,540,Brazil,B06,c,9,21,a
child,237023,239870,2847,Brazil,B06,m,9,22,q
mother,240376,240905,529,Brazil,B06,c,9,23,i
child,240932,241760,828,Brazil,B06,m,9,24,a
child,247097,248331,1234,Brazil,B06,b,9,25,a
father,248183,249634,1451,Brazil,B06,c,9,26,i
mother,249389,252660,3271,Brazil,B06,f,9,27,a
father,251758,253710,1952,Brazil,B06,c,9,28,a
father,257500,258750,1250,Brazil,B06,m,9,29,a
father,277680,281170,3490,Brazil,B06,m,10,1,a
child,284532,287320,2788,Brazil,B06,b,11,1,a
child,291168,292725,1557,Brazil,B06,b,11,2,a
father,293900,294610,710,Brazil,B06,m,12,1,q
mother,298000,306983,8983,Brazil,B06,f,12,2,a
father,308850,309289,439,Brazil,B06,c,13,1,i
child,312059,313568,1509,Brazil,B06,f,13,2,a
child,317060,317687,627,Brazil,B06,f,13,3,a
father,317070,317750,680,Brazil,B06,c,13,4,i
child,318563,320210,1647,Brazil,B06,f,13,5,q
father,320343,321232,889,Brazil,B06,c,13,6,i
child,321250,329651,8401,Brazil,B06,m,13,7,q
mother,338910,339850,940,Brazil,B06,c,13,8,q
child,340129,341194,1065,Brazil,B06,m,13,9,a
father,342970,343812,842,Brazil,B06,c,13,10,q
child,343659,344712,1053,Brazil,B06,f,13,11,a
father,345550,346180,630,Brazil,B06,b,13,12,q
mother,346380,353800,7420,Brazil,B06,c,13,13,a
child,350670,351270,600,Brazil,B06,m,13,14,a
child,353448,353800,352,Brazil,B06,m,13,15,a
mother,357240,357810,570,Brazil,B06,c,13,16,a
child,360460,362050,1590,Brazil,B06,b,13,17,a
mother,362050,363470,1420,Brazil,B06,f,13,18,a
child,365010,365850,840,Brazil,B06,b,13,19,a
mother,366260,367310,1050,Brazil,B06,f,13,20,a
mother,370490,372005,1515,Brazil,B06,f,14,1,q
father,371840,372360,520,Brazil,B06,m,14,2,a
child,374100,375070,970,Brazil,B06,b,14,3,q
mother,375370,381360,5990,Brazil,B06,f,14,4,a
mother,395180,396440,1260,Brazil,B06,c,15,1,q
child,397880,398860,980,Brazil,B06,m,15,2,a
mother,399829,401003,1174,Brazil,B06,c,15,3,a
child,401118,402012,894,Brazil,B06,m,15,4,a
mother,410730,411950,1220,Brazil,B06,c,15,5,q
father,419300,419770,470,Brazil,B06,c,15,6,i
child,433933,436297,2364,Brazil,B06,m,16,1,q
mother,436130,437740,1610,Brazil,B06,c,16,2,a
child,442610,445030,2420,Brazil,B06,m,16,3,a
father,448730,450210,1480,Brazil,B06,b,16,4,a
mother,450165,451811,1646,Brazil,B06,c,16,5,i
child,463160,464260,1100,Brazil,B06,m,17,1,a
mother,464565,466610,2045,Brazil,B06,c,17,2,a
father,469530,469610,80,Brazil,B06,b,17,3,a
mother,469760,470170,410,Brazil,B06,b,17,4,a
child,471680,480960,9280,Brazil,B06,m,17,5,a
mother,480681,482467,1786,Brazil,B06,c,17,6,a
child,483786,487020,3234,Brazil,B06,m,17,7,a
mother,486619,487530,911,Brazil,B06,c,17,8,a
child,487950,488350,400,Brazil,B06,c,17,9,q
mother,488480,489890,1410,Brazil,B06,c,17,10,a
child,492752,494074,1322,Brazil,B06,b,17,11,a
child,499108,502490,3382,Brazil,B06,b,17,12,a
child,505910,507250,1340,Brazil,B06,b,17,13,a
mother,494514,495990,1476,Brazil,B06,f,18,1,a
father,498180,499150,970,Brazil,B06,m,18,2,a
mother,507880,510540,2660,Brazil,B06,f,18,3,a
father,519627,520349,722,Brazil,B06,c,18,4,q
father,525940,528454,2514,Brazil,B06,m,18,5,a
mother,512350,519750,7400,Brazil,B06,o,19,1,a
mother,522220,526730,4510,Brazil,B06,o,19,2,a
child,521070,522200,1130,Brazil,B06,f,20,1,a
child,529000,531770,2770,Brazil,B06,f,20,2,i
mother,532089,533079,990,Brazil,B06,c,20,3,a
mother,539110,539805,695,Brazil,B06,b,20,4,a
child,539352,544680,5328,Brazil,B06,b,20,5,a
child,551350,551970,620,Brazil,B06,b,20,6,a
father,554520,555120,600,Brazil,B06,c,20,7,i
child,555440,559910,4470,Brazil,B06,b,20,8,a
child,564550,565684,1134,Brazil,B06,b,20,9,a
child,569870,570754,884,Brazil,B06,b,20,10,a
child,574760,575460,700,Brazil,B06,b,20,11,a
child,577800,579415,1615,Brazil,B06,b,20,12,a
mother,580110,581360,1250,Brazil,B06,f,20,13,a
child,589420,589960,540,Brazil,B06,b,20,14,a
mother,594168,595785,1617,Brazil,B06,b,20,15,a
silence,1746,2357,611,Brazil,B06,NA,NA,NA,NA
silence,2598,2902,304,Brazil,B06,NA,NA,NA,NA
silence,8020,8440,420,Brazil,B06,NA,NA,NA,NA
silence,9360,13220,3860,Brazil,B06,NA,NA,NA,NA
silence,14070,14405,335,Brazil,B06,NA,NA,NA,NA
silence,15288,16039,751,Brazil,B06,NA,NA,NA,NA
silence,16980,19004,2024,Brazil,B06,NA,NA,NA,NA
silence,19701,20000,299,Brazil,B06,NA,NA,NA,NA
silence,20950,22804,1854,Brazil,B06,NA,NA,NA,NA
silence,23195,24120,925,Brazil,B06,NA,NA,NA,NA
silence,25180,25970,790,Brazil,B06,NA,NA,NA,NA
silence,29250,29851,601,Brazil,B06,NA,NA,NA,NA
silence,31490,31520,30,Brazil,B06,NA,NA,NA,NA
silence,36482,38990,2508,Brazil,B06,NA,NA,NA,NA
child_gesture,42090,43263,1173,Brazil,B06,NA,NA,NA,NA
silence,48330,51630,3300,Brazil,B06,NA,NA,NA,NA
silence,53100,53250,150,Brazil,B06,NA,NA,NA,NA
silence,53700,56790,3090,Brazil,B06,NA,NA,NA,NA
silence,58290,59895,1605,Brazil,B06,NA,NA,NA,NA
silence,65400,76370,10970,Brazil,B06,NA,NA,NA,NA
silence,77720,77782,62,Brazil,B06,NA,NA,NA,NA
silence,78094,81541,3447,Brazil,B06,NA,NA,NA,NA
silence,82478,83320,842,Brazil,B06,NA,NA,NA,NA
silence,85210,88209,2999,Brazil,B06,NA,NA,NA,NA
father_gesture,92614,93774,1160,Brazil,B06,NA,NA,NA,NA
silence,95930,96159,229,Brazil,B06,NA,NA,NA,NA
silence,96842,97560,718,Brazil,B06,NA,NA,NA,NA
silence,99240,100154,914,Brazil,B06,NA,NA,NA,NA
silence,102720,109800,7080,Brazil,B06,NA,NA,NA,NA
silence,112640,128718,16078,Brazil,B06,NA,NA,NA,NA
silence,129610,136850,7240,Brazil,B06,NA,NA,NA,NA
silence,137470,138930,1460,Brazil,B06,NA,NA,NA,NA
mother_gesture,138360,139362,1002,Brazil,B06,NA,NA,NA,NA
silence,140427,141480,1053,Brazil,B06,NA,NA,NA,NA
silence,142600,143040,440,Brazil,B06,NA,NA,NA,NA
silence,146300,153540,7240,Brazil,B06,NA,NA,NA,NA
silence,157687,158058,371,Brazil,B06,NA,NA,NA,NA
mother_gesture,158782,159128,346,Brazil,B06,NA,NA,NA,NA
silence,159548,172014,12466,Brazil,B06,NA,NA,NA,NA
silence,173628,174720,1092,Brazil,B06,NA,NA,NA,NA
silence,175529,178956,3427,Brazil,B06,NA,NA,NA,NA
silence,179856,183920,4064,Brazil,B06,NA,NA,NA,NA
mother_gesture,184072,184402,330,Brazil,B06,NA,NA,NA,NA
silence,189434,190150,716,Brazil,B06,NA,NA,NA,NA
silence,191545,192440,895,Brazil,B06,NA,NA,NA,NA
silence,192990,193070,80,Brazil,B06,NA,NA,NA,NA
silence,194234,194627,393,Brazil,B06,NA,NA,NA,NA
silence,204460,204853,393,Brazil,B06,NA,NA,NA,NA
child_gesture,207198,211080,3882,Brazil,B06,NA,NA,NA,NA
silence,212450,212682,232,Brazil,B06,NA,NA,NA,NA
child_gesture,213830,214320,490,Brazil,B06,NA,NA,NA,NA
silence,216410,217760,1350,Brazil,B06,NA,NA,NA,NA
silence,219872,221366,1494,Brazil,B06,NA,NA,NA,NA
silence,225436,226930,1494,Brazil,B06,NA,NA,NA,NA
silence,229430,232260,2830,Brazil,B06,NA,NA,NA,NA
silence,236080,237023,943,Brazil,B06,NA,NA,NA,NA
silence,239870,240376,506,Brazil,B06,NA,NA,NA,NA
silence,240905,240932,27,Brazil,B06,NA,NA,NA,NA
silence,241760,247097,5337,Brazil,B06,NA,NA,NA,NA
silence,253710,257500,3790,Brazil,B06,NA,NA,NA,NA
silence,258750,277680,18930,Brazil,B06,NA,NA,NA,NA
silence,281170,284532,3362,Brazil,B06,NA,NA,NA,NA
silence,287320,291168,3848,Brazil,B06,NA,NA,NA,NA
silence,292725,293900,1175,Brazil,B06,NA,NA,NA,NA
silence,294610,298000,3390,Brazil,B06,NA,NA,NA,NA
silence,306983,308850,1867,Brazil,B06,NA,NA,NA,NA
father_gesture,308889,309632,743,Brazil,B06,NA,NA,NA,NA
silence,309289,312059,2770,Brazil,B06,NA,NA,NA,NA
silence,313568,317060,3492,Brazil,B06,NA,NA,NA,NA
silence,317750,318563,813,Brazil,B06,NA,NA,NA,NA
silence,320210,320343,133,Brazil,B06,NA,NA,NA,NA
father_gesture,320518,320857,339,Brazil,B06,NA,NA,NA,NA
silence,321232,321250,18,Brazil,B06,NA,NA,NA,NA
silence,329651,338910,9259,Brazil,B06,NA,NA,NA,NA
silence,339850,340129,279,Brazil,B06,NA,NA,NA,NA
silence,341194,342970,1776,Brazil,B06,NA,NA,NA,NA
father_gesture,343044,343758,714,Brazil,B06,NA,NA,NA,NA
silence,344712,345550,838,Brazil,B06,NA,NA,NA,NA
silence,346180,346380,200,Brazil,B06,NA,NA,NA,NA
silence,353800,357240,3440,Brazil,B06,NA,NA,NA,NA
mother_gesture,356814,357738,924,Brazil,B06,NA,NA,NA,NA
silence,357810,360460,2650,Brazil,B06,NA,NA,NA,NA
mother_gesture,363020,364679,1659,Brazil,B06,NA,NA,NA,NA
silence,363470,365010,1540,Brazil,B06,NA,NA,NA,NA
silence,365850,366260,410,Brazil,B06,NA,NA,NA,NA
silence,367310,370490,3180,Brazil,B06,NA,NA,NA,NA
silence,372360,374100,1740,Brazil,B06,NA,NA,NA,NA
silence,375070,375370,300,Brazil,B06,NA,NA,NA,NA
silence,381360,395180,13820,Brazil,B06,NA,NA,NA,NA
silence,396440,397880,1440,Brazil,B06,NA,NA,NA,NA
silence,398860,399829,969,Brazil,B06,NA,NA,NA,NA
silence,401003,401118,115,Brazil,B06,NA,NA,NA,NA
silence,402012,410730,8718,Brazil,B06,NA,NA,NA,NA
silence,411950,419300,7350,Brazil,B06,NA,NA,NA,NA
child_gesture,417036,421564,4528,Brazil,B06,NA,NA,NA,NA
silence,419770,433933,14163,Brazil,B06,NA,NA,NA,NA
silence,437740,442610,4870,Brazil,B06,NA,NA,NA,NA
silence,445030,448730,3700,Brazil,B06,NA,NA,NA,NA
silence,451811,463160,11349,Brazil,B06,NA,NA,NA,NA
silence,464260,464565,305,Brazil,B06,NA,NA,NA,NA
silence,466610,469530,2920,Brazil,B06,NA,NA,NA,NA
silence,469610,469760,150,Brazil,B06,NA,NA,NA,NA
silence,470170,471680,1510,Brazil,B06,NA,NA,NA,NA
child_gesture,471721,486766,15045,Brazil,B06,NA,NA,NA,NA
mother_gesture,481444,481994,550,Brazil,B06,NA,NA,NA,NA
silence,482467,483786,1319,Brazil,B06,NA,NA,NA,NA
silence,487530,487950,420,Brazil,B06,NA,NA,NA,NA
silence,488350,488480,130,Brazil,B06,NA,NA,NA,NA
silence,489890,492752,2862,Brazil,B06,NA,NA,NA,NA
silence,494074,494514,440,Brazil,B06,NA,NA,NA,NA
silence,495990,498180,2190,Brazil,B06,NA,NA,NA,NA
silence,502490,505910,3420,Brazil,B06,NA,NA,NA,NA
silence,507250,507880,630,Brazil,B06,NA,NA,NA,NA
silence,510540,512350,1810,Brazil,B06,NA,NA,NA,NA
silence,520349,521070,721,Brazil,B06,NA,NA,NA,NA
silence,522200,522220,20,Brazil,B06,NA,NA,NA,NA
silence,528454,529000,546,Brazil,B06,NA,NA,NA,NA
silence,531770,532089,319,Brazil,B06,NA,NA,NA,NA
silence,533079,539110,6031,Brazil,B06,NA,NA,NA,NA
silence,544680,551350,6670,Brazil,B06,NA,NA,NA,NA
silence,551970,554520,2550,Brazil,B06,NA,NA,NA,NA
silence,555120,555440,320,Brazil,B06,NA,NA,NA,NA
silence,559910,564550,4640,Brazil,B06,NA,NA,NA,NA
silence,565684,569870,4186,Brazil,B06,NA,NA,NA,NA
silence,570754,574760,4006,Brazil,B06,NA,NA,NA,NA
silence,575460,577800,2340,Brazil,B06,NA,NA,NA,NA
silence,579415,580110,695,Brazil,B06,NA,NA,NA,NA
silence,581360,589420,8060,Brazil,B06,NA,NA,NA,NA
silence,589960,594168,4208,Brazil,B06,NA,NA,NA,NA
child,182,1309,1127,Brazil,B07,b,1,1,q
mother,1850,3060,1210,Brazil,B07,f,2,1,q
father,3017,5870,2853,Brazil,B07,b,2,2,q
mother,6056,8090,2034,Brazil,B07,f,2,3,q
father,8670,9330,660,Brazil,B07,m,2,4,a
child,10070,11840,1770,Brazil,B07,f,3,1,i
father,15384,16243,859,Brazil,B07,c,3,2,a
father,33000,33657,657,Brazil,B07,c,4,1,i
father,38760,39310,550,Brazil,B07,c,4,2,a
mother,40130,43290,3160,Brazil,B07,c,4,3,a
father,43750,49670,5920,Brazil,B07,c,4,4,a
mother,56810,57770,960,Brazil,B07,b,4,5,a
mother,62450,64280,1830,Brazil,B07,b,4,6,a
father,66410,68460,2050,Brazil,B07,c,4,7,a
mother,69820,70530,710,Brazil,B07,b,4,8,a
father,79320,81571,2251,Brazil,B07,c,4,9,i
mother,84060,84870,810,Brazil,B07,f,4,10,q
father,85570,85930,360,Brazil,B07,m,4,11,q
father,89150,89640,490,Brazil,B07,c,4,12,q
child,89950,90150,200,Brazil,B07,f,4,13,a
father,90729,92400,1671,Brazil,B07,c,4,14,q
mother,93510,95118,1608,Brazil,B07,f,4,15,a
father,95039,95785,746,Brazil,B07,m,4,16,a
father,96700,97290,590,Brazil,B07,b,4,17,a
child,97680,98280,600,Brazil,B07,b,4,18,a
father,99029,99601,572,Brazil,B07,c,4,19,i
father,101010,102350,1340,Brazil,B07,c,4,20,a
father,110020,110890,870,Brazil,B07,b,4,21,a
mother,115600,116220,620,Brazil,B07,f,4,22,a
mother,121810,122350,540,Brazil,B07,c,4,23,i
child,135520,135720,200,Brazil,B07,o,5,1,a
mother,136350,137110,760,Brazil,B07,c,5,2,i
child,137360,142980,5620,Brazil,B07,f,5,3,a
father,138070,140240,2170,Brazil,B07,c,5,4,q
father,143300,145750,2450,Brazil,B07,c,5,5,a
child,147139,147882,743,Brazil,B07,b,5,6,a
father,150310,151310,1000,Brazil,B07,c,5,7,a
child,151940,152580,640,Brazil,B07,f,5,8,a
mother,152180,154760,2580,Brazil,B07,c,5,9,q
child,155370,156010,640,Brazil,B07,m,5,10,a
mother,156320,156870,550,Brazil,B07,c,5,11,q
child,157100,157660,560,Brazil,B07,m,5,12,a
mother,157560,157880,320,Brazil,B07,c,5,13,q
child,158347,159257,910,Brazil,B07,c,5,14,a
mother,159520,163360,3840,Brazil,B07,f,5,15,a
child,160150,161980,1830,Brazil,B07,m,5,16,a
father,160910,161630,720,Brazil,B07,c,5,17,a
father,163063,163445,382,Brazil,B07,m,5,18,a
father,164530,164980,450,Brazil,B07,c,5,19,a
child,165320,166130,810,Brazil,B07,f,5,20,a
mother,165670,166870,1200,Brazil,B07,f,5,21,i
child,167890,168900,1010,Brazil,B07,b,5,22,a
mother,167958,173800,5842,Brazil,B07,b,5,23,a
mother,180680,181450,770,Brazil,B07,c,5,24,i
child,182950,183670,720,Brazil,B07,m,5,25,q
mother,183500,187310,3810,Brazil,B07,c,5,26,a
child,187782,190750,2968,Brazil,B07,m,5,27,a
mother,189963,191510,1547,Brazil,B07,c,5,28,a
child,192430,193150,720,Brazil,B07,m,5,29,a
mother,193396,193960,564,Brazil,B07,c,5,30,a
father,193925,195570,1645,Brazil,B07,c,5,31,a
child,195677,196590,913,Brazil,B07,f,5,32,q
mother,196590,197210,620,Brazil,B07,c,5,33,a
father,196970,197820,850,Brazil,B07,c,5,34,a
father,217260,220000,2740,Brazil,B07,c,5,35,q
child,203007,206370,3363,Brazil,B07,b,6,1,a
father,208290,209850,1560,Brazil,B07,c,6,2,a
mother,222950,224860,1910,Brazil,B07,c,6,3,i
father,226180,226721,541,Brazil,B07,c,6,4,a
mother,226280,227250,970,Brazil,B07,c,6,5,q
child,229520,231117,1597,Brazil,B07,m,6,6,a
mother,229530,231200,1670,Brazil,B07,c,6,7,a
mother,231500,232080,580,Brazil,B07,c,6,8,a
child,245280,246370,1090,Brazil,B07,b,7,1,a
mother,248550,249210,660,Brazil,B07,c,7,2,q
father,250310,250746,436,Brazil,B07,c,7,3,a
child,250932,252270,1338,Brazil,B07,f,7,4,a
mother,253590,255580,1990,Brazil,B07,f,7,5,a
father,255684,257320,1636,Brazil,B07,m,7,6,a
child,260865,261680,815,Brazil,B07,b,7,7,a
father,262520,265540,3020,Brazil,B07,c,7,8,i
mother,270223,271710,1487,Brazil,B07,c,7,9,a
father,345590,346300,710,Brazil,B07,c,8,1,i
mother,349960,351077,1117,Brazil,B07,c,8,2,a
father,352150,353503,1353,Brazil,B07,c,8,3,i
father,357652,358150,498,Brazil,B07,c,8,4,q
father,452990,458590,5600,Brazil,B07,c,9,1,i
father,460570,461600,1030,Brazil,B07,c,9,2,i
father,473450,476320,2870,Brazil,B07,c,10,1,i
mother,476770,477920,1150,Brazil,B07,b,10,2,a
father,480280,481727,1447,Brazil,B07,m,10,3,a
mother,481678,482310,632,Brazil,B07,f,10,4,a
father,482620,483480,860,Brazil,B07,c,10,5,i
mother,487263,489076,1813,Brazil,B07,b,10,6,a
father,487606,488630,1024,Brazil,B07,c,10,7,i
father,489730,490420,690,Brazil,B07,c,10,8,i
father,504950,507060,2110,Brazil,B07,c,11,1,i
father,512070,517150,5080,Brazil,B07,c,11,2,i
mother,519080,519334,254,Brazil,B07,c,11,3,a
father,519760,520170,410,Brazil,B07,c,11,4,a
mother,524340,525330,990,Brazil,B07,c,11,5,i
father,525370,526130,760,Brazil,B07,c,11,6,a
child,527010,527420,410,Brazil,B07,f,11,7,a
father,527830,531200,3370,Brazil,B07,c,11,8,i
mother,529920,530320,400,Brazil,B07,b,11,9,a
child,530610,531111,501,Brazil,B07,b,11,10,a
mother,532530,533130,600,Brazil,B07,c,11,11,q
child,532950,533560,610,Brazil,B07,b,11,12,a
father,535850,539590,3740,Brazil,B07,c,11,13,a
mother,540600,542010,1410,Brazil,B07,c,11,14,q
mother,552700,553240,540,Brazil,B07,c,12,1,q
child,555000,556579,1579,Brazil,B07,m,12,2,a
father,556336,558000,1664,Brazil,B07,c,12,3,a
child,559280,559814,534,Brazil,B07,f,12,4,q
father,560400,560805,405,Brazil,B07,c,12,5,q
silence,1309,1850,541,Brazil,B07,NA,NA,NA,NA
silence,5870,6056,186,Brazil,B07,NA,NA,NA,NA
silence,8090,8670,580,Brazil,B07,NA,NA,NA,NA
silence,9330,10070,740,Brazil,B07,NA,NA,NA,NA
silence,11840,15384,3544,Brazil,B07,NA,NA,NA,NA
silence,16243,33000,16757,Brazil,B07,NA,NA,NA,NA
silence,33657,38760,5103,Brazil,B07,NA,NA,NA,NA
silence,39310,40130,820,Brazil,B07,NA,NA,NA,NA
silence,43290,43750,460,Brazil,B07,NA,NA,NA,NA
silence,49670,56810,7140,Brazil,B07,NA,NA,NA,NA
silence,57770,62450,4680,Brazil,B07,NA,NA,NA,NA
silence,64280,66410,2130,Brazil,B07,NA,NA,NA,NA
silence,68460,69820,1360,Brazil,B07,NA,NA,NA,NA
silence,70530,79320,8790,Brazil,B07,NA,NA,NA,NA
silence,81571,84060,2489,Brazil,B07,NA,NA,NA,NA
silence,84870,85570,700,Brazil,B07,NA,NA,NA,NA
silence,85930,89150,3220,Brazil,B07,NA,NA,NA,NA
silence,89640,89950,310,Brazil,B07,NA,NA,NA,NA
silence,90150,90729,579,Brazil,B07,NA,NA,NA,NA
silence,92400,93510,1110,Brazil,B07,NA,NA,NA,NA
silence,95785,96700,915,Brazil,B07,NA,NA,NA,NA
silence,97290,97680,390,Brazil,B07,NA,NA,NA,NA
silence,98280,99029,749,Brazil,B07,NA,NA,NA,NA
silence,99601,101010,1409,Brazil,B07,NA,NA,NA,NA
silence,102350,110020,7670,Brazil,B07,NA,NA,NA,NA
silence,110890,115600,4710,Brazil,B07,NA,NA,NA,NA
silence,116220,121810,5590,Brazil,B07,NA,NA,NA,NA
silence,122350,135520,13170,Brazil,B07,NA,NA,NA,NA
silence,135720,136350,630,Brazil,B07,NA,NA,NA,NA
silence,137110,137360,250,Brazil,B07,NA,NA,NA,NA
silence,142980,143300,320,Brazil,B07,NA,NA,NA,NA
silence,145750,147139,1389,Brazil,B07,NA,NA,NA,NA
silence,147882,150310,2428,Brazil,B07,NA,NA,NA,NA
silence,151310,151940,630,Brazil,B07,NA,NA,NA,NA
silence,154760,155370,610,Brazil,B07,NA,NA,NA,NA
silence,156010,156320,310,Brazil,B07,NA,NA,NA,NA
silence,156870,157100,230,Brazil,B07,NA,NA,NA,NA
silence,157880,158347,467,Brazil,B07,NA,NA,NA,NA
silence,159257,159520,263,Brazil,B07,NA,NA,NA,NA
silence,163445,164530,1085,Brazil,B07,NA,NA,NA,NA
silence,164980,165320,340,Brazil,B07,NA,NA,NA,NA
silence,166870,167890,1020,Brazil,B07,NA,NA,NA,NA
silence,173800,180680,6880,Brazil,B07,NA,NA,NA,NA
silence,181450,182950,1500,Brazil,B07,NA,NA,NA,NA
silence,187310,187782,472,Brazil,B07,NA,NA,NA,NA
silence,191510,192430,920,Brazil,B07,NA,NA,NA,NA
silence,193150,193396,246,Brazil,B07,NA,NA,NA,NA
silence,195570,195677,107,Brazil,B07,NA,NA,NA,NA
silence,197820,203007,5187,Brazil,B07,NA,NA,NA,NA
silence,206370,208290,1920,Brazil,B07,NA,NA,NA,NA
silence,209850,217260,7410,Brazil,B07,NA,NA,NA,NA
silence,220000,222950,2950,Brazil,B07,NA,NA,NA,NA
silence,224860,226180,1320,Brazil,B07,NA,NA,NA,NA
silence,227250,229520,2270,Brazil,B07,NA,NA,NA,NA
silence,231200,231500,300,Brazil,B07,NA,NA,NA,NA
silence,232080,245280,13200,Brazil,B07,NA,NA,NA,NA
silence,246370,248550,2180,Brazil,B07,NA,NA,NA,NA
silence,249210,250310,1100,Brazil,B07,NA,NA,NA,NA
silence,250746,250932,186,Brazil,B07,NA,NA,NA,NA
silence,252270,253590,1320,Brazil,B07,NA,NA,NA,NA
silence,255580,255684,104,Brazil,B07,NA,NA,NA,NA
silence,257320,260865,3545,Brazil,B07,NA,NA,NA,NA
silence,261680,262520,840,Brazil,B07,NA,NA,NA,NA
silence,265540,270223,4683,Brazil,B07,NA,NA,NA,NA
silence,271710,345590,73880,Brazil,B07,NA,NA,NA,NA
silence,346300,349960,3660,Brazil,B07,NA,NA,NA,NA
silence,351077,352150,1073,Brazil,B07,NA,NA,NA,NA
silence,353503,357652,4149,Brazil,B07,NA,NA,NA,NA
silence,358150,452990,94840,Brazil,B07,NA,NA,NA,NA
silence,458590,460570,1980,Brazil,B07,NA,NA,NA,NA
silence,461600,473450,11850,Brazil,B07,NA,NA,NA,NA
silence,476320,476770,450,Brazil,B07,NA,NA,NA,NA
silence,477920,480280,2360,Brazil,B07,NA,NA,NA,NA
silence,482310,482620,310,Brazil,B07,NA,NA,NA,NA
silence,483480,487263,3783,Brazil,B07,NA,NA,NA,NA
silence,489076,489730,654,Brazil,B07,NA,NA,NA,NA
silence,490420,504950,14530,Brazil,B07,NA,NA,NA,NA
silence,507060,512070,5010,Brazil,B07,NA,NA,NA,NA
silence,517150,519080,1930,Brazil,B07,NA,NA,NA,NA
silence,519334,519760,426,Brazil,B07,NA,NA,NA,NA
silence,520170,524340,4170,Brazil,B07,NA,NA,NA,NA
silence,525330,525370,40,Brazil,B07,NA,NA,NA,NA
silence,526130,527010,880,Brazil,B07,NA,NA,NA,NA
silence,527420,527830,410,Brazil,B07,NA,NA,NA,NA
silence,531200,532530,1330,Brazil,B07,NA,NA,NA,NA
silence,533560,535850,2290,Brazil,B07,NA,NA,NA,NA
silence,539590,540600,1010,Brazil,B07,NA,NA,NA,NA
silence,542010,552700,10690,Brazil,B07,NA,NA,NA,NA
silence,553240,555000,1760,Brazil,B07,NA,NA,NA,NA
silence,558000,559280,1280,Brazil,B07,NA,NA,NA,NA
silence,559814,560400,586,Brazil,B07,NA,NA,NA,NA
mother,1086,3466,2380,Brazil,B08,c,1,1,a
mother,3260,4680,1420,Brazil,B08,b,1,2,i
father,4701,5828,1127,Brazil,B08,c,1,3,a
father,6876,13486,6610,Brazil,B08,c,1,4,i
child,7511,8284,773,Brazil,B08,f,1,5,q
mother,12030,14610,2580,Brazil,B08,c,1,6,i
mother,13776,15176,1400,Brazil,B08,c,1,7,i
father,14393,15978,1585,Brazil,B08,c,1,8,i
father,15176,16186,1010,Brazil,B08,c,1,9,i
mother,15966,16766,800,Brazil,B08,c,1,10,i
father,16876,19176,2300,Brazil,B08,c,1,11,a
mother,17266,22076,4810,Brazil,B08,c,1,12,a
mother,20951,22020,1069,Brazil,B08,c,1,13,a
father,22666,23616,950,Brazil,B08,b,1,14,a
mother,23476,24826,1350,Brazil,B08,f,1,15,a
child,23860,24326,466,Brazil,B08,m,1,16,a
mother,24821,25866,1045,Brazil,B08,c,1,17,i
father,24876,26146,1270,Brazil,B08,c,1,18,q
child,26150,26602,452,Brazil,B08,f,1,19,a
child,26333,27660,1327,Brazil,B08,m,1,20,a
father,26512,27016,504,Brazil,B08,c,1,21,q
mother,26876,30476,3600,Brazil,B08,c,1,22,q
father,30876,32326,1450,Brazil,B08,c,1,23,a
mother,34151,39220,5069,Brazil,B08,c,1,24,a
father,35346,35886,540,Brazil,B08,c,1,25,a
mother,38476,40196,1720,Brazil,B08,c,1,26,q
mother,44776,45786,1010,Brazil,B08,c,1,27,a
mother,50076,53476,3400,Brazil,B08,c,1,28,a
father,54176,55366,1190,Brazil,B08,c,1,29,i
mother,55456,57166,1710,Brazil,B08,c,1,30,i
father,57576,59866,2290,Brazil,B08,c,1,31,i
father,61066,61966,900,Brazil,B08,c,1,32,a
mother,61966,69596,7630,Brazil,B08,c,1,33,a
child,44560,45330,770,Brazil,B08,f,2,1,a
father,45034,45382,348,Brazil,B08,c,2,2,a
child,46150,46660,510,Brazil,B08,f,2,3,a
father,47740,48145,405,Brazil,B08,c,2,4,a
father,49601,52670,3069,Brazil,B08,c,2,5,i
child,54850,55420,570,Brazil,B08,f,2,6,a
father,55450,55883,433,Brazil,B08,c,2,7,q
child,56090,56780,690,Brazil,B08,f,2,8,a
father,57115,57489,374,Brazil,B08,c,2,9,i
child,58697,59140,443,Brazil,B08,f,2,10,a
mother,58876,59976,1100,Brazil,B08,f,2,11,i
father,59774,60750,976,Brazil,B08,c,2,12,a
child,60742,62312,1570,Brazil,B08,f,2,13,a
child,69606,70266,660,Brazil,B08,m,3,1,a
mother,70476,71916,1440,Brazil,B08,c,3,2,a
father,70991,71730,739,Brazil,B08,c,3,3,a
child,71876,72566,690,Brazil,B08,m,3,4,a
child,72140,72890,750,Brazil,B08,f,3,5,a
child,75865,76393,528,Brazil,B08,b,3,6,a
child,76420,77000,580,Brazil,B08,m,3,7,a
mother,77590,78050,460,Brazil,B08,c,3,8,q
mother,78076,83676,5600,Brazil,B08,c,3,9,q
child,78269,78980,711,Brazil,B08,m,3,10,a
mother,79640,80450,810,Brazil,B08,c,3,11,a
child,82674,83625,951,Brazil,B08,m,3,12,a
mother,83604,84674,1070,Brazil,B08,c,3,13,a
child,83856,84446,590,Brazil,B08,m,3,14,a
child,84715,85750,1035,Brazil,B08,m,3,15,a
mother,85176,86336,1160,Brazil,B08,c,3,16,q
child,86176,86855,679,Brazil,B08,m,3,17,q
child,86683,87277,594,Brazil,B08,m,3,18,a
mother,87170,88370,1200,Brazil,B08,c,3,19,a
mother,87376,88936,1560,Brazil,B08,c,3,20,q
child,88280,90890,2610,Brazil,B08,m,3,21,a
child,88676,89300,624,Brazil,B08,c,3,22,a
father,89076,91076,2000,Brazil,B08,f,3,23,a
mother,90300,93180,2880,Brazil,B08,c,3,24,a
mother,90776,95266,4490,Brazil,B08,c,3,25,q
child,93393,99330,5937,Brazil,B08,m,3,26,a
child,95284,96043,759,Brazil,B08,m,3,27,a
mother,95640,97120,1480,Brazil,B08,c,3,28,a
mother,96776,100376,3600,Brazil,B08,c,3,29,i
mother,98600,101400,2800,Brazil,B08,c,3,30,a
father,105476,106606,1130,Brazil,B08,b,4,1,a
mother,119500,120660,1160,Brazil,B08,f,4,2,i
mother,123970,125180,1210,Brazil,B08,f,4,3,a
child,107076,107676,600,Brazil,B08,b,5,1,a
mother,107776,109176,1400,Brazil,B08,f,5,2,a
child,109511,110083,572,Brazil,B08,b,5,3,a
child,132740,133230,490,Brazil,B08,f,5,4,a
father,133451,135960,2509,Brazil,B08,c,5,5,a
father,138355,139391,1036,Brazil,B08,c,5,6,i
child,139420,140530,1110,Brazil,B08,f,5,7,a
mother,140670,144420,3750,Brazil,B08,c,5,8,i
child,145070,145860,790,Brazil,B08,m,5,9,a
father,146870,148040,1170,Brazil,B08,c,5,10,a
mother,148130,149260,1130,Brazil,B08,c,5,11,a
father,149100,153130,4030,Brazil,B08,c,5,12,i
child,153520,154180,660,Brazil,B08,f,5,13,a
father,154880,155460,580,Brazil,B08,c,5,14,i
mother,157410,158120,710,Brazil,B08,f,5,15,q
child,160865,169290,8425,Brazil,B08,m,5,16,a
mother,164980,166130,1150,Brazil,B08,c,5,17,i
father,109576,111576,2000,Brazil,B08,m,6,1,a
mother,112976,114076,1100,Brazil,B08,f,6,2,q
mother,173960,175220,1260,Brazil,B08,f,6,3,q
father,176780,177510,730,Brazil,B08,m,6,4,a
mother,178240,178740,500,Brazil,B08,f,6,5,q
father,179850,180600,750,Brazil,B08,m,6,6,a
mother,181710,182590,880,Brazil,B08,f,6,7,a
father,183740,184880,1140,Brazil,B08,m,6,8,a
mother,185780,186460,680,Brazil,B08,f,6,9,q
child,114776,115576,800,Brazil,B08,f,7,1,a
father,115576,116836,1260,Brazil,B08,c,7,2,a
child,116836,118176,1340,Brazil,B08,f,7,3,a
child,120076,120896,820,Brazil,B08,m,7,4,a
mother,120876,121516,640,Brazil,B08,c,7,5,q
child,121675,122270,595,Brazil,B08,m,7,6,a
mother,122176,123476,1300,Brazil,B08,c,7,7,a
child,123416,124246,830,Brazil,B08,m,7,8,a
mother,124318,128396,4078,Brazil,B08,c,7,9,a
child,128396,129179,783,Brazil,B08,m,7,10,a
child,188930,195040,6110,Brazil,B08,f,7,11,a
father,193160,195050,1890,Brazil,B08,c,7,12,q
mother,195080,196190,1110,Brazil,B08,f,7,13,a
mother,198740,199660,920,Brazil,B08,c,7,14,i
child,199970,200550,580,Brazil,B08,m,7,15,a
father,200740,201567,827,Brazil,B08,c,7,16,q
child,201471,202210,739,Brazil,B08,f,7,17,a
father,202375,203900,1525,Brazil,B08,c,7,18,i
child,203666,204579,913,Brazil,B08,f,7,19,a
father,205400,206040,640,Brazil,B08,c,7,20,a
child,206914,207706,792,Brazil,B08,f,7,21,a
father,207980,208337,357,Brazil,B08,c,7,22,i
child,208470,212170,3700,Brazil,B08,f,7,23,a
mother,211190,212270,1080,Brazil,B08,f,7,24,a
father,214111,215840,1729,Brazil,B08,m,7,25,i
child,215482,217870,2388,Brazil,B08,b,7,26,a
mother,219814,223170,3356,Brazil,B08,f,7,27,a
child,224536,226174,1638,Brazil,B08,b,7,28,a
father,226160,227490,1330,Brazil,B08,c,7,29,a
child,227384,228530,1146,Brazil,B08,f,7,30,a
child,232601,234165,1564,Brazil,B08,f,7,31,a
child,236260,237150,890,Brazil,B08,f,7,32,a
father,237683,238241,558,Brazil,B08,c,7,33,q
child,238270,238677,407,Brazil,B08,f,7,34,a
mother,241430,242400,970,Brazil,B08,c,7,35,a
father,242399,244345,1946,Brazil,B08,c,7,36,a
child,243300,258930,15630,Brazil,B08,b,7,37,a
mother,248000,249420,1420,Brazil,B08,c,7,38,a
father,132676,134646,1970,Brazil,B08,m,8,1,a
mother,135076,135726,650,Brazil,B08,f,8,2,q
father,136276,137876,1600,Brazil,B08,m,8,3,a
father,254000,259350,5350,Brazil,B08,c,8,4,q
father,260286,263320,3034,Brazil,B08,c,8,5,q
child,264390,265689,1299,Brazil,B08,f,8,6,a
father,264800,265460,660,Brazil,B08,c,8,7,q
child,266810,268549,1739,Brazil,B08,f,8,8,a
father,268850,270470,1620,Brazil,B08,c,8,9,i
child,270405,273350,2945,Brazil,B08,f,8,10,a
father,271669,273920,2251,Brazil,B08,c,8,11,a
mother,274150,276400,2250,Brazil,B08,f,8,12,a
father,277710,278570,860,Brazil,B08,c,8,13,q
child,278970,280060,1090,Brazil,B08,f,8,14,a
father,279650,280482,832,Brazil,B08,c,8,15,a
father,283240,283760,520,Brazil,B08,c,8,16,i
father,287820,289040,1220,Brazil,B08,c,8,17,i
child,290537,292237,1700,Brazil,B08,c,8,18,a
father,300670,302370,1700,Brazil,B08,c,8,19,a
father,305580,306220,640,Brazil,B08,c,8,20,i
father,308360,314970,6610,Brazil,B08,c,8,21,a
child,138516,139091,575,Brazil,B08,b,9,1,q
father,140676,146856,6180,Brazil,B08,c,9,2,a
mother,324919,328330,3411,Brazil,B08,f,9,3,q
father,330320,331250,930,Brazil,B08,m,9,4,q
mother,334050,335447,1397,Brazil,B08,f,9,5,q
father,336540,337040,500,Brazil,B08,f,9,6,a
mother,150876,151796,920,Brazil,B08,f,10,1,q
father,152776,154676,1900,Brazil,B08,m,10,2,a
mother,155276,157085,1809,Brazil,B08,c,10,3,q
child,157826,158426,600,Brazil,B08,m,10,4,a
mother,158676,161176,2500,Brazil,B08,c,10,5,a
child,163511,164072,561,Brazil,B08,m,10,6,q
mother,163676,164816,1140,Brazil,B08,c,10,7,a
mother,166666,167586,920,Brazil,B08,c,10,8,i
child,177076,177686,610,Brazil,B08,b,10,9,a
mother,182096,184186,2090,Brazil,B08,c,10,10,i
child,183105,183676,571,Brazil,B08,m,10,11,q
child,185266,185456,190,Brazil,B08,m,10,12,i
mother,186476,190886,4410,Brazil,B08,c,10,13,a
child,191276,191976,700,Brazil,B08,m,10,14,a
mother,192676,197466,4790,Brazil,B08,c,10,15,i
father,200976,201776,800,Brazil,B08,c,10,16,a
mother,201576,202876,1300,Brazil,B08,c,10,17,q
mother,208176,210276,2100,Brazil,B08,c,10,18,a
mother,213476,214336,860,Brazil,B08,c,10,19,a
mother,216476,222906,6430,Brazil,B08,c,10,20,q
child,224676,225538,862,Brazil,B08,m,10,21,a
mother,225666,226666,1000,Brazil,B08,c,10,22,i
child,226566,227156,590,Brazil,B08,m,10,23,a
mother,227586,228336,750,Brazil,B08,c,10,24,q
child,228336,228966,630,Brazil,B08,m,10,25,q
child,231376,232006,630,Brazil,B08,m,10,26,a
mother,232076,232660,584,Brazil,B08,c,10,27,q
child,232726,233446,720,Brazil,B08,m,10,28,a
father,233574,234128,554,Brazil,B08,c,10,29,a
mother,234276,235346,1070,Brazil,B08,c,10,30,a
child,235717,236676,959,Brazil,B08,m,10,31,a
mother,236676,237476,800,Brazil,B08,c,10,32,a
father,237676,238976,1300,Brazil,B08,b,10,33,a
mother,240776,242476,1700,Brazil,B08,c,10,34,a
child,249276,250176,900,Brazil,B08,b,10,35,a
mother,249976,251276,1300,Brazil,B08,c,10,36,q
child,251873,252575,702,Brazil,B08,m,10,37,a
mother,252617,255366,2749,Brazil,B08,c,10,38,q
child,255497,258544,3047,Brazil,B08,m,10,39,a
father,261086,262576,1490,Brazil,B08,c,10,40,a
mother,262666,263536,870,Brazil,B08,f,10,41,a
child,263840,265063,1223,Brazil,B08,m,10,42,a
mother,265376,266446,1070,Brazil,B08,c,10,43,q
child,266380,268563,2183,Brazil,B08,c,10,44,a
father,274476,276256,1780,Brazil,B08,c,10,45,q
child,276284,277197,913,Brazil,B08,f,10,46,a
father,277266,279116,1850,Brazil,B08,c,10,47,q
child,280501,292776,12275,Brazil,B08,f,10,48,a
father,288476,289196,720,Brazil,B08,c,10,49,q
mother,292876,293686,810,Brazil,B08,c,10,50,q
father,292886,293696,810,Brazil,B08,c,10,51,q
child,293631,294692,1061,Brazil,B08,f,10,52,a
father,294776,298306,3530,Brazil,B08,c,10,53,a
child,298306,299076,770,Brazil,B08,f,10,54,q
father,299466,300406,940,Brazil,B08,c,10,55,q
child,300396,301006,610,Brazil,B08,f,10,56,a
father,363710,366420,2710,Brazil,B08,c,10,57,q
mother,368723,369957,1234,Brazil,B08,f,10,58,a
father,304776,306472,1696,Brazil,B08,c,11,1,q
child,306976,307776,800,Brazil,B08,f,11,2,a
father,307796,309025,1229,Brazil,B08,c,11,3,a
child,309176,309816,640,Brazil,B08,f,11,4,a
father,310147,310610,463,Brazil,B08,c,11,5,q
child,310596,311587,991,Brazil,B08,f,11,6,a
father,311876,313046,1170,Brazil,B08,c,11,7,a
child,313876,314976,1100,Brazil,B08,f,11,8,a
mother,315186,315856,670,Brazil,B08,b,11,9,a
father,315476,316531,1055,Brazil,B08,c,11,10,q
child,317776,318466,690,Brazil,B08,f,11,11,a
father,318463,319076,613,Brazil,B08,c,11,12,q
child,319086,320136,1050,Brazil,B08,f,11,13,a
father,322776,323776,1000,Brazil,B08,c,11,14,a
child,324276,324896,620,Brazil,B08,f,11,15,a
father,325276,326236,960,Brazil,B08,c,11,16,q
child,326476,327176,700,Brazil,B08,f,11,17,a
father,327186,328116,930,Brazil,B08,c,11,18,a
child,328666,329966,1300,Brazil,B08,f,11,19,a
father,329976,330416,440,Brazil,B08,c,11,20,q
child,383150,384056,906,Brazil,B08,f,11,21,q
father,384047,384676,629,Brazil,B08,c,11,22,a
child,384885,385236,351,Brazil,B08,f,11,23,a
father,385609,386432,823,Brazil,B08,c,11,24,a
mother,388190,390209,2019,Brazil,B08,b,11,25,a
father,390210,391870,1660,Brazil,B08,c,11,26,a
mother,391790,393250,1460,Brazil,B08,b,11,27,a
child,397460,398370,910,Brazil,B08,f,11,28,a
father,398130,401100,2970,Brazil,B08,c,11,29,a
child,398740,399120,380,Brazil,B08,f,11,30,a
father,409190,410910,1720,Brazil,B08,c,11,31,a
mother,336576,337876,1300,Brazil,B08,c,12,1,i
child,338676,339576,900,Brazil,B08,m,12,2,a
father,340876,342276,1400,Brazil,B08,c,12,3,q
mother,343176,344976,1800,Brazil,B08,c,12,4,a
father,344976,345716,740,Brazil,B08,c,12,5,a
mother,348776,349676,900,Brazil,B08,c,12,6,i
father,423970,425800,1830,Brazil,B08,c,12,7,q
father,350376,351166,790,Brazil,B08,m,13,1,a
mother,351676,352426,750,Brazil,B08,f,13,2,q
father,352439,352966,527,Brazil,B08,m,13,3,a
mother,426358,426927,569,Brazil,B08,c,13,4,i
mother,429330,430490,1160,Brazil,B08,c,13,5,i
child,433930,435040,1110,Brazil,B08,b,13,6,a
father,435290,435820,530,Brazil,B08,c,13,7,q
mother,435625,436025,400,Brazil,B08,c,13,8,q
child,436190,436590,400,Brazil,B08,m,13,9,q
mother,437230,437970,740,Brazil,B08,c,13,10,a
child,438100,438450,350,Brazil,B08,m,13,11,a
mother,438659,441900,3241,Brazil,B08,c,13,12,a
mother,444120,445050,930,Brazil,B08,c,13,13,i
father,450750,451340,590,Brazil,B08,c,13,14,a
mother,353376,354076,700,Brazil,B08,f,14,1,a
child,353396,357606,4210,Brazil,B08,b,14,2,a
mother,357376,358476,1100,Brazil,B08,c,14,3,i
child,358676,359776,1100,Brazil,B08,m,14,4,a
mother,361776,362606,830,Brazil,B08,f,14,5,i
mother,366876,367836,960,Brazil,B08,c,14,6,a
mother,370676,371776,1100,Brazil,B08,c,14,7,i
child,372076,372916,840,Brazil,B08,c,14,8,a
father,373276,374676,1400,Brazil,B08,m,14,9,q
mother,375676,376876,1200,Brazil,B08,f,14,10,a
child,462241,462978,737,Brazil,B08,f,14,11,a
father,462897,463620,723,Brazil,B08,c,14,12,q
child,463350,464120,770,Brazil,B08,f,14,13,a
father,464130,467760,3630,Brazil,B08,c,14,14,a
child,470920,471939,1019,Brazil,B08,f,14,15,a
father,472175,473067,892,Brazil,B08,c,14,16,q
father,386376,387686,1310,Brazil,B08,c,15,1,a
child,387876,388376,500,Brazil,B08,f,15,2,q
father,388476,389809,1333,Brazil,B08,c,15,3,a
child,390076,390586,510,Brazil,B08,f,15,4,q
father,390676,392306,1630,Brazil,B08,c,15,5,a
child,393176,395676,2500,Brazil,B08,f,15,6,a
mother,473499,477700,4201,Brazil,B08,c,15,7,q
father,478890,481050,2160,Brazil,B08,c,15,8,q
mother,481410,482560,1150,Brazil,B08,b,15,9,a
father,482838,483604,766,Brazil,B08,c,15,10,q
mother,486540,488090,1550,Brazil,B08,c,15,11,i
mother,493220,499900,6680,Brazil,B08,c,15,12,q
father,501110,502590,1480,Brazil,B08,c,15,13,a
child,502650,503030,380,Brazil,B08,f,15,14,a
mother,503580,503980,400,Brazil,B08,c,15,15,q
child,504310,504790,480,Brazil,B08,c,15,16,a
mother,505300,511970,6670,Brazil,B08,c,15,17,q
mother,401976,403086,1110,Brazil,B08,c,16,1,q
child,403176,404126,950,Brazil,B08,m,16,2,a
mother,405096,406276,1180,Brazil,B08,c,16,3,q
child,406576,407396,820,Brazil,B08,m,16,4,a
child,410565,414076,3511,Brazil,B08,m,16,5,a
mother,418129,420097,1968,Brazil,B08,c,16,6,a
father,429829,435796,5967,Brazil,B08,m,16,7,a
mother,433576,436096,2520,Brazil,B08,f,16,8,a
mother,438376,439376,1000,Brazil,B08,f,16,9,q
father,439676,440676,1000,Brazil,B08,m,16,10,q
mother,442676,443556,880,Brazil,B08,c,16,11,i
mother,444676,445696,1020,Brazil,B08,c,16,12,i
mother,447866,448686,820,Brazil,B08,c,16,13,i
mother,451876,453117,1241,Brazil,B08,c,16,14,a
mother,454576,456048,1472,Brazil,B08,c,16,15,q
child,455875,458332,2457,Brazil,B08,m,16,16,a
mother,457776,460006,2230,Brazil,B08,c,16,17,q
child,459986,462586,2600,Brazil,B08,m,16,18,a
father,462576,464276,1700,Brazil,B08,c,16,19,i
mother,466776,467816,1040,Brazil,B08,b,16,20,a
mother,468876,470486,1610,Brazil,B08,c,16,21,q
child,470510,475916,5406,Brazil,B08,b,16,22,a
father,472476,473876,1400,Brazil,B08,c,16,23,i
mother,473776,475906,2130,Brazil,B08,c,16,24,i
mother,476376,477376,1000,Brazil,B08,f,16,25,i
father,478166,479166,1000,Brazil,B08,c,16,26,i
mother,512601,514980,2379,Brazil,B08,b,16,27,a
father,489576,493776,4200,Brazil,B08,c,17,1,a
mother,493776,497016,3240,Brazil,B08,c,17,2,i
father,502676,506676,4000,Brazil,B08,c,17,3,i
father,511032,512971,1939,Brazil,B08,c,17,4,i
child,512983,513445,462,Brazil,B08,f,17,5,q
father,513676,514676,1000,Brazil,B08,c,17,6,i
mother,514686,515576,890,Brazil,B08,c,17,7,i
father,518576,519666,1090,Brazil,B08,c,17,8,a
father,527776,531776,4000,Brazil,B08,c,17,9,i
father,533680,539600,5920,Brazil,B08,c,17,10,a
father,549413,555710,6297,Brazil,B08,c,17,11,a
father,560753,562377,1624,Brazil,B08,c,17,12,a
child,564130,564720,590,Brazil,B08,b,17,13,a
child,567080,567510,430,Brazil,B08,b,17,14,a
mother,567720,568941,1221,Brazil,B08,c,17,15,q
father,569655,572303,2648,Brazil,B08,b,17,16,a
mother,579757,585120,5363,Brazil,B08,c,17,17,i
mother_gesture,1116,1776,660,Brazil,B08,NA,NA,NA,NA
mother_gesture,3036,3663,627,Brazil,B08,NA,NA,NA,NA
silence,3466,6876,3410,Brazil,B08,NA,NA,NA,NA
silence,4680,4701,21,Brazil,B08,NA,NA,NA,NA
silence,5828,12030,6202,Brazil,B08,NA,NA,NA,NA
father_gesture,12157,19626,7469,Brazil,B08,NA,NA,NA,NA
silence,13486,13776,290,Brazil,B08,NA,NA,NA,NA
silence,15978,20951,4973,Brazil,B08,NA,NA,NA,NA
silence,16766,16876,110,Brazil,B08,NA,NA,NA,NA
silence,22020,23860,1840,Brazil,B08,NA,NA,NA,NA
silence,22076,22666,590,Brazil,B08,NA,NA,NA,NA
silence,24326,24821,495,Brazil,B08,NA,NA,NA,NA
silence,24826,24876,50,Brazil,B08,NA,NA,NA,NA
silence,25866,26333,467,Brazil,B08,NA,NA,NA,NA
silence,26146,26150,4,Brazil,B08,NA,NA,NA,NA
child_gesture,26256,29660,3404,Brazil,B08,NA,NA,NA,NA
silence,27660,34151,6491,Brazil,B08,NA,NA,NA,NA
silence,30476,30876,400,Brazil,B08,NA,NA,NA,NA
silence,32326,35346,3020,Brazil,B08,NA,NA,NA,NA
silence,35886,38476,2590,Brazil,B08,NA,NA,NA,NA
silence,39220,44560,5340,Brazil,B08,NA,NA,NA,NA
mother_gesture,39362,39791,429,Brazil,B08,NA,NA,NA,NA
silence,40196,44776,4580,Brazil,B08,NA,NA,NA,NA
silence,45382,46150,768,Brazil,B08,NA,NA,NA,NA
silence,45786,50076,4290,Brazil,B08,NA,NA,NA,NA
silence,46660,47740,1080,Brazil,B08,NA,NA,NA,NA
silence,48145,49601,1456,Brazil,B08,NA,NA,NA,NA
silence,52670,54850,2180,Brazil,B08,NA,NA,NA,NA
silence,53476,54176,700,Brazil,B08,NA,NA,NA,NA
silence,55366,55456,90,Brazil,B08,NA,NA,NA,NA
silence,55420,55450,30,Brazil,B08,NA,NA,NA,NA
silence,55883,56090,207,Brazil,B08,NA,NA,NA,NA
mother_gesture,56025,57213,1188,Brazil,B08,NA,NA,NA,NA
silence,56780,57115,335,Brazil,B08,NA,NA,NA,NA
silence,57166,57576,410,Brazil,B08,NA,NA,NA,NA
silence,57489,58697,1208,Brazil,B08,NA,NA,NA,NA
silence,59140,59774,634,Brazil,B08,NA,NA,NA,NA
silence,59976,61066,1090,Brazil,B08,NA,NA,NA,NA
silence,62312,70991,8679,Brazil,B08,NA,NA,NA,NA
silence,69596,69606,10,Brazil,B08,NA,NA,NA,NA
child_gesture,70162,73323,3161,Brazil,B08,NA,NA,NA,NA
silence,70266,70476,210,Brazil,B08,NA,NA,NA,NA
mother_gesture,70633,72250,1617,Brazil,B08,NA,NA,NA,NA
silence,71730,72140,410,Brazil,B08,NA,NA,NA,NA
silence,72566,75865,3299,Brazil,B08,NA,NA,NA,NA
silence,72890,76420,3530,Brazil,B08,NA,NA,NA,NA
silence,76393,78076,1683,Brazil,B08,NA,NA,NA,NA
silence,77000,77590,590,Brazil,B08,NA,NA,NA,NA
silence,78050,78269,219,Brazil,B08,NA,NA,NA,NA
silence,78980,79640,660,Brazil,B08,NA,NA,NA,NA
silence,80450,82674,2224,Brazil,B08,NA,NA,NA,NA
child_gesture,80512,87460,6948,Brazil,B08,NA,NA,NA,NA
silence,83676,83856,180,Brazil,B08,NA,NA,NA,NA
silence,84446,85176,730,Brazil,B08,NA,NA,NA,NA
silence,84674,84715,41,Brazil,B08,NA,NA,NA,NA
silence,85750,86683,933,Brazil,B08,NA,NA,NA,NA
silence,86855,87376,521,Brazil,B08,NA,NA,NA,NA
mother_gesture,90569,91193,624,Brazil,B08,NA,NA,NA,NA
silence,93180,93393,213,Brazil,B08,NA,NA,NA,NA
silence,95266,95284,18,Brazil,B08,NA,NA,NA,NA
silence,96043,96776,733,Brazil,B08,NA,NA,NA,NA
silence,100376,105476,5100,Brazil,B08,NA,NA,NA,NA
mother_gesture,101151,101777,626,Brazil,B08,NA,NA,NA,NA
silence,101400,119500,18100,Brazil,B08,NA,NA,NA,NA
silence,106606,107076,470,Brazil,B08,NA,NA,NA,NA
child_gesture,107228,107723,495,Brazil,B08,NA,NA,NA,NA
silence,107676,107776,100,Brazil,B08,NA,NA,NA,NA
silence,109176,109511,335,Brazil,B08,NA,NA,NA,NA
silence,111576,112976,1400,Brazil,B08,NA,NA,NA,NA
silence,114076,114776,700,Brazil,B08,NA,NA,NA,NA
child_gesture,115275,115671,396,Brazil,B08,NA,NA,NA,NA
child_gesture,117960,120946,2986,Brazil,B08,NA,NA,NA,NA
silence,118176,120076,1900,Brazil,B08,NA,NA,NA,NA
silence,120660,123970,3310,Brazil,B08,NA,NA,NA,NA
silence,121516,121675,159,Brazil,B08,NA,NA,NA,NA
child_gesture,122456,124700,2244,Brazil,B08,NA,NA,NA,NA
mother_gesture,122841,126993,4152,Brazil,B08,NA,NA,NA,NA
silence,124246,124318,72,Brazil,B08,NA,NA,NA,NA
silence,125180,132740,7560,Brazil,B08,NA,NA,NA,NA
child_gesture,128894,131303,2409,Brazil,B08,NA,NA,NA,NA
silence,129179,132676,3497,Brazil,B08,NA,NA,NA,NA
silence,133230,133451,221,Brazil,B08,NA,NA,NA,NA
silence,134646,135076,430,Brazil,B08,NA,NA,NA,NA
silence,135726,136276,550,Brazil,B08,NA,NA,NA,NA
silence,135960,138355,2395,Brazil,B08,NA,NA,NA,NA
silence,137876,138516,640,Brazil,B08,NA,NA,NA,NA
silence,139091,140676,1585,Brazil,B08,NA,NA,NA,NA
silence,139391,139420,29,Brazil,B08,NA,NA,NA,NA
silence,140530,140670,140,Brazil,B08,NA,NA,NA,NA
silence,144420,145070,650,Brazil,B08,NA,NA,NA,NA
silence,145860,146870,1010,Brazil,B08,NA,NA,NA,NA
silence,146856,150876,4020,Brazil,B08,NA,NA,NA,NA
silence,148040,148130,90,Brazil,B08,NA,NA,NA,NA
silence,151796,152776,980,Brazil,B08,NA,NA,NA,NA
silence,153130,153520,390,Brazil,B08,NA,NA,NA,NA
silence,154180,154880,700,Brazil,B08,NA,NA,NA,NA
silence,154676,155276,600,Brazil,B08,NA,NA,NA,NA
silence,155460,157410,1950,Brazil,B08,NA,NA,NA,NA
silence,157085,157826,741,Brazil,B08,NA,NA,NA,NA
silence,158120,160865,2745,Brazil,B08,NA,NA,NA,NA
child_gesture,158212,160283,2071,Brazil,B08,NA,NA,NA,NA
silence,158426,158676,250,Brazil,B08,NA,NA,NA,NA
silence,161176,163511,2335,Brazil,B08,NA,NA,NA,NA
silence,164816,166666,1850,Brazil,B08,NA,NA,NA,NA
silence,167586,177076,9490,Brazil,B08,NA,NA,NA,NA
silence,169290,173960,4670,Brazil,B08,NA,NA,NA,NA
silence,175220,176780,1560,Brazil,B08,NA,NA,NA,NA
silence,177510,178240,730,Brazil,B08,NA,NA,NA,NA
silence,177686,182096,4410,Brazil,B08,NA,NA,NA,NA
silence,178740,179850,1110,Brazil,B08,NA,NA,NA,NA
silence,180600,181710,1110,Brazil,B08,NA,NA,NA,NA
silence,182590,183740,1150,Brazil,B08,NA,NA,NA,NA
silence,184186,185266,1080,Brazil,B08,NA,NA,NA,NA
silence,184880,185780,900,Brazil,B08,NA,NA,NA,NA
silence,185456,186476,1020,Brazil,B08,NA,NA,NA,NA
silence,186460,188930,2470,Brazil,B08,NA,NA,NA,NA
silence,190886,191276,390,Brazil,B08,NA,NA,NA,NA
silence,191976,192676,700,Brazil,B08,NA,NA,NA,NA
silence,195050,195080,30,Brazil,B08,NA,NA,NA,NA
silence,196190,198740,2550,Brazil,B08,NA,NA,NA,NA
silence,197466,200976,3510,Brazil,B08,NA,NA,NA,NA
silence,199660,199970,310,Brazil,B08,NA,NA,NA,NA
silence,200550,200740,190,Brazil,B08,NA,NA,NA,NA
silence,202210,202375,165,Brazil,B08,NA,NA,NA,NA
silence,202876,208176,5300,Brazil,B08,NA,NA,NA,NA
silence,204579,205400,821,Brazil,B08,NA,NA,NA,NA
silence,206040,206914,874,Brazil,B08,NA,NA,NA,NA
silence,207706,207980,274,Brazil,B08,NA,NA,NA,NA
silence,208337,208470,133,Brazil,B08,NA,NA,NA,NA
silence,210276,213476,3200,Brazil,B08,NA,NA,NA,NA
silence,212270,214111,1841,Brazil,B08,NA,NA,NA,NA
silence,214336,216476,2140,Brazil,B08,NA,NA,NA,NA
silence,217870,219814,1944,Brazil,B08,NA,NA,NA,NA
silence,222906,224676,1770,Brazil,B08,NA,NA,NA,NA
silence,223170,224536,1366,Brazil,B08,NA,NA,NA,NA
silence,225538,225666,128,Brazil,B08,NA,NA,NA,NA
silence,227156,227586,430,Brazil,B08,NA,NA,NA,NA
silence,228530,232601,4071,Brazil,B08,NA,NA,NA,NA
silence,228966,231376,2410,Brazil,B08,NA,NA,NA,NA
silence,232006,232076,70,Brazil,B08,NA,NA,NA,NA
silence,232660,232726,66,Brazil,B08,NA,NA,NA,NA
silence,233446,233574,128,Brazil,B08,NA,NA,NA,NA
silence,234128,234276,148,Brazil,B08,NA,NA,NA,NA
silence,234165,236260,2095,Brazil,B08,NA,NA,NA,NA
silence,235346,235717,371,Brazil,B08,NA,NA,NA,NA
silence,237150,237683,533,Brazil,B08,NA,NA,NA,NA
silence,237476,237676,200,Brazil,B08,NA,NA,NA,NA
silence,238241,238270,29,Brazil,B08,NA,NA,NA,NA
silence,238677,241430,2753,Brazil,B08,NA,NA,NA,NA
silence,238976,240776,1800,Brazil,B08,NA,NA,NA,NA
silence,242476,249276,6800,Brazil,B08,NA,NA,NA,NA
silence,251276,251873,597,Brazil,B08,NA,NA,NA,NA
silence,252575,252617,42,Brazil,B08,NA,NA,NA,NA
father_gesture,255260,256400,1140,Brazil,B08,NA,NA,NA,NA
silence,255366,255497,131,Brazil,B08,NA,NA,NA,NA
silence,258544,261086,2542,Brazil,B08,NA,NA,NA,NA
silence,259350,260286,936,Brazil,B08,NA,NA,NA,NA
father_gesture,260488,260884,396,Brazil,B08,NA,NA,NA,NA
silence,262576,262666,90,Brazil,B08,NA,NA,NA,NA
silence,263320,264390,1070,Brazil,B08,NA,NA,NA,NA
silence,263536,263840,304,Brazil,B08,NA,NA,NA,NA
silence,265063,265376,313,Brazil,B08,NA,NA,NA,NA
silence,265689,266810,1121,Brazil,B08,NA,NA,NA,NA
silence,268549,268850,301,Brazil,B08,NA,NA,NA,NA
silence,268563,274476,5913,Brazil,B08,NA,NA,NA,NA
silence,273920,274150,230,Brazil,B08,NA,NA,NA,NA
silence,276256,276284,28,Brazil,B08,NA,NA,NA,NA
silence,276400,277710,1310,Brazil,B08,NA,NA,NA,NA
silence,277197,277266,69,Brazil,B08,NA,NA,NA,NA
silence,278570,278970,400,Brazil,B08,NA,NA,NA,NA
silence,279116,280501,1385,Brazil,B08,NA,NA,NA,NA
silence,280482,283240,2758,Brazil,B08,NA,NA,NA,NA
silence,283760,287820,4060,Brazil,B08,NA,NA,NA,NA
silence,289040,290537,1497,Brazil,B08,NA,NA,NA,NA
silence,292237,300670,8433,Brazil,B08,NA,NA,NA,NA
silence,292776,292876,100,Brazil,B08,NA,NA,NA,NA
silence,294692,294776,84,Brazil,B08,NA,NA,NA,NA
silence,299076,299466,390,Brazil,B08,NA,NA,NA,NA
silence,301006,304776,3770,Brazil,B08,NA,NA,NA,NA
silence,302370,305580,3210,Brazil,B08,NA,NA,NA,NA
silence,306220,308360,2140,Brazil,B08,NA,NA,NA,NA
silence,306472,306976,504,Brazil,B08,NA,NA,NA,NA
silence,307776,307796,20,Brazil,B08,NA,NA,NA,NA
silence,309025,309176,151,Brazil,B08,NA,NA,NA,NA
silence,309816,310147,331,Brazil,B08,NA,NA,NA,NA
silence,311587,311876,289,Brazil,B08,NA,NA,NA,NA
silence,313046,313876,830,Brazil,B08,NA,NA,NA,NA
silence,314970,324919,9949,Brazil,B08,NA,NA,NA,NA
silence,314976,315186,210,Brazil,B08,NA,NA,NA,NA
silence,316531,317776,1245,Brazil,B08,NA,NA,NA,NA
silence,319076,319086,10,Brazil,B08,NA,NA,NA,NA
silence,320136,322776,2640,Brazil,B08,NA,NA,NA,NA
silence,323776,324276,500,Brazil,B08,NA,NA,NA,NA
silence,324896,325276,380,Brazil,B08,NA,NA,NA,NA
silence,326236,326476,240,Brazil,B08,NA,NA,NA,NA
silence,327176,327186,10,Brazil,B08,NA,NA,NA,NA
silence,328116,328666,550,Brazil,B08,NA,NA,NA,NA
silence,328330,330320,1990,Brazil,B08,NA,NA,NA,NA
silence,329966,329976,10,Brazil,B08,NA,NA,NA,NA
silence,330416,336576,6160,Brazil,B08,NA,NA,NA,NA
silence,331250,334050,2800,Brazil,B08,NA,NA,NA,NA
silence,335447,336540,1093,Brazil,B08,NA,NA,NA,NA
silence,337040,363710,26670,Brazil,B08,NA,NA,NA,NA
silence,337876,338676,800,Brazil,B08,NA,NA,NA,NA
silence,339576,340876,1300,Brazil,B08,NA,NA,NA,NA
silence,342276,343176,900,Brazil,B08,NA,NA,NA,NA
silence,345716,348776,3060,Brazil,B08,NA,NA,NA,NA
silence,349676,350376,700,Brazil,B08,NA,NA,NA,NA
silence,351166,351676,510,Brazil,B08,NA,NA,NA,NA
silence,352426,352439,13,Brazil,B08,NA,NA,NA,NA
silence,352966,353376,410,Brazil,B08,NA,NA,NA,NA
silence,358476,358676,200,Brazil,B08,NA,NA,NA,NA
silence,359776,361776,2000,Brazil,B08,NA,NA,NA,NA
silence,362606,366876,4270,Brazil,B08,NA,NA,NA,NA
silence,366420,368723,2303,Brazil,B08,NA,NA,NA,NA
silence,367836,370676,2840,Brazil,B08,NA,NA,NA,NA
silence,369957,383150,13193,Brazil,B08,NA,NA,NA,NA
silence,371776,372076,300,Brazil,B08,NA,NA,NA,NA
silence,372916,373276,360,Brazil,B08,NA,NA,NA,NA
silence,374676,375676,1000,Brazil,B08,NA,NA,NA,NA
silence,376876,386376,9500,Brazil,B08,NA,NA,NA,NA
silence,384676,384885,209,Brazil,B08,NA,NA,NA,NA
silence,385236,385609,373,Brazil,B08,NA,NA,NA,NA
silence,386432,388190,1758,Brazil,B08,NA,NA,NA,NA
silence,387686,387876,190,Brazil,B08,NA,NA,NA,NA
silence,388376,388476,100,Brazil,B08,NA,NA,NA,NA
silence,389809,390076,267,Brazil,B08,NA,NA,NA,NA
silence,390209,390210,1,Brazil,B08,NA,NA,NA,NA
silence,390586,390676,90,Brazil,B08,NA,NA,NA,NA
father_gesture,391118,392042,924,Brazil,B08,NA,NA,NA,NA
silence,392306,393176,870,Brazil,B08,NA,NA,NA,NA
silence,393250,397460,4210,Brazil,B08,NA,NA,NA,NA
silence,395676,401976,6300,Brazil,B08,NA,NA,NA,NA
father_gesture,399392,400450,1058,Brazil,B08,NA,NA,NA,NA
silence,401100,409190,8090,Brazil,B08,NA,NA,NA,NA
silence,403086,403176,90,Brazil,B08,NA,NA,NA,NA
silence,404126,405096,970,Brazil,B08,NA,NA,NA,NA
silence,406276,406576,300,Brazil,B08,NA,NA,NA,NA
silence,407396,410565,3169,Brazil,B08,NA,NA,NA,NA
silence,410910,423970,13060,Brazil,B08,NA,NA,NA,NA
silence,414076,418129,4053,Brazil,B08,NA,NA,NA,NA
silence,420097,429829,9732,Brazil,B08,NA,NA,NA,NA
silence,425800,426358,558,Brazil,B08,NA,NA,NA,NA
silence,426927,429330,2403,Brazil,B08,NA,NA,NA,NA
silence,430490,433930,3440,Brazil,B08,NA,NA,NA,NA
father_gesture,432365,433355,990,Brazil,B08,NA,NA,NA,NA
silence,435040,435290,250,Brazil,B08,NA,NA,NA,NA
silence,436025,436190,165,Brazil,B08,NA,NA,NA,NA
silence,436096,438376,2280,Brazil,B08,NA,NA,NA,NA
silence,436590,437230,640,Brazil,B08,NA,NA,NA,NA
silence,437970,438100,130,Brazil,B08,NA,NA,NA,NA
silence,438450,438659,209,Brazil,B08,NA,NA,NA,NA
silence,439376,439676,300,Brazil,B08,NA,NA,NA,NA
silence,440676,442676,2000,Brazil,B08,NA,NA,NA,NA
silence,441900,444120,2220,Brazil,B08,NA,NA,NA,NA
silence,443556,444676,1120,Brazil,B08,NA,NA,NA,NA
silence,445050,450750,5700,Brazil,B08,NA,NA,NA,NA
silence,445696,447866,2170,Brazil,B08,NA,NA,NA,NA
silence,448686,451876,3190,Brazil,B08,NA,NA,NA,NA
father_gesture,450965,452582,1617,Brazil,B08,NA,NA,NA,NA
silence,451340,462241,10901,Brazil,B08,NA,NA,NA,NA
silence,453117,454576,1459,Brazil,B08,NA,NA,NA,NA
silence,464120,464130,10,Brazil,B08,NA,NA,NA,NA
silence,464276,466776,2500,Brazil,B08,NA,NA,NA,NA
silence,467760,470920,3160,Brazil,B08,NA,NA,NA,NA
silence,467816,468876,1060,Brazil,B08,NA,NA,NA,NA
silence,470486,470510,24,Brazil,B08,NA,NA,NA,NA
silence,471939,472175,236,Brazil,B08,NA,NA,NA,NA
silence,473067,473499,432,Brazil,B08,NA,NA,NA,NA
silence,475916,476376,460,Brazil,B08,NA,NA,NA,NA
silence,477376,478166,790,Brazil,B08,NA,NA,NA,NA
silence,477700,478890,1190,Brazil,B08,NA,NA,NA,NA
silence,479166,489576,10410,Brazil,B08,NA,NA,NA,NA
silence,481050,481410,360,Brazil,B08,NA,NA,NA,NA
silence,482560,482838,278,Brazil,B08,NA,NA,NA,NA
silence,483604,486540,2936,Brazil,B08,NA,NA,NA,NA
silence,488090,493220,5130,Brazil,B08,NA,NA,NA,NA
silence,497016,502676,5660,Brazil,B08,NA,NA,NA,NA
silence,499900,501110,1210,Brazil,B08,NA,NA,NA,NA
silence,502590,502650,60,Brazil,B08,NA,NA,NA,NA
silence,503030,503580,550,Brazil,B08,NA,NA,NA,NA
silence,503980,504310,330,Brazil,B08,NA,NA,NA,NA
silence,504790,505300,510,Brazil,B08,NA,NA,NA,NA
silence,506676,511032,4356,Brazil,B08,NA,NA,NA,NA
father_gesture,511231,512847,1616,Brazil,B08,NA,NA,NA,NA
silence,511970,512601,631,Brazil,B08,NA,NA,NA,NA
silence,512971,512983,12,Brazil,B08,NA,NA,NA,NA
silence,513445,513676,231,Brazil,B08,NA,NA,NA,NA
father_gesture,513592,514251,659,Brazil,B08,NA,NA,NA,NA
silence,514676,514686,10,Brazil,B08,NA,NA,NA,NA
silence,514980,533680,18700,Brazil,B08,NA,NA,NA,NA
silence,515576,518576,3000,Brazil,B08,NA,NA,NA,NA
silence,519666,527776,8110,Brazil,B08,NA,NA,NA,NA
father_gesture,536554,538567,2013,Brazil,B08,NA,NA,NA,NA
silence,539600,549413,9813,Brazil,B08,NA,NA,NA,NA
father_gesture,549459,556356,6897,Brazil,B08,NA,NA,NA,NA
silence,555710,560753,5043,Brazil,B08,NA,NA,NA,NA
silence,562377,564130,1753,Brazil,B08,NA,NA,NA,NA
silence,564720,567080,2360,Brazil,B08,NA,NA,NA,NA
silence,567510,567720,210,Brazil,B08,NA,NA,NA,NA
silence,568941,569655,714,Brazil,B08,NA,NA,NA,NA
silence,572303,579757,7454,Brazil,B08,NA,NA,NA,NA
child,1440,3470,2030,Brazil,B09,b,1,1,a
child,5520,6601,1081,Brazil,B09,b,1,2,a
child,7641,10081,2440,Brazil,B09,b,1,3,a
child,13233,14010,777,Brazil,B09,b,1,4,a
child,22380,22870,490,Brazil,B09,b,1,5,a
mother,3310,5527,2217,Brazil,B09,f,2,1,a
mother,6391,6837,446,Brazil,B09,f,2,2,q
father,7185,7516,331,Brazil,B09,m,2,3,a
father,11850,12910,1060,Brazil,B09,m,2,4,a
child,40428,40790,362,Brazil,B09,m,3,1,q
mother,55650,55940,290,Brazil,B09,o,4,1,a
mother,87889,88122,233,Brazil,B09,b,5,1,a
mother,110420,111400,980,Brazil,B09,c,6,1,a
mother,114970,118030,3060,Brazil,B09,o,7,1,a
mother,173232,173559,327,Brazil,B09,c,8,1,a
child,228990,232680,3690,Brazil,B09,m,9,1,a
child,254910,255740,830,Brazil,B09,b,10,1,a
child,261912,263012,1100,Brazil,B09,b,10,2,a
child,270510,271690,1180,Brazil,B09,b,11,1,a
child,278766,279780,1014,Brazil,B09,b,11,2,a
father,280550,280835,285,Brazil,B09,c,12,1,a
father,283452,285010,1558,Brazil,B09,c,12,2,a
child,285529,286791,1262,Brazil,B09,f,12,3,a
child,289656,289992,336,Brazil,B09,b,13,1,a
child,295200,295497,297,Brazil,B09,m,14,1,a
mother,300090,300650,560,Brazil,B09,c,14,2,a
mother,335190,335650,460,Brazil,B09,c,15,1,i
mother,341500,343900,2400,Brazil,B09,f,16,1,a
father,344070,344630,560,Brazil,B09,m,16,2,a
child,355651,360450,4799,Brazil,B09,m,17,1,a
mother,387319,387609,290,Brazil,B09,c,18,1,a
child,416790,417240,450,Brazil,B09,m,19,1,a
child,438943,439261,318,Brazil,B09,f,20,1,q
father,441390,441700,310,Brazil,B09,c,20,2,a
child,441929,442276,347,Brazil,B09,f,20,3,a
child,459320,459850,530,Brazil,B09,b,21,1,a
mother,459920,460430,510,Brazil,B09,c,21,2,a
child,461023,461494,471,Brazil,B09,m,21,3,q
mother,461943,462500,557,Brazil,B09,c,21,4,a
child,463310,463752,442,Brazil,B09,m,21,5,q
child,470211,475820,5609,Brazil,B09,f,22,1,a
mother,476370,476920,550,Brazil,B09,b,22,2,a
child,476970,477600,630,Brazil,B09,f,22,3,a
child,480446,482380,1934,Brazil,B09,f,22,4,a
father,483960,484560,600,Brazil,B09,c,22,5,i
father,487210,487720,510,Brazil,B09,c,22,6,a
child,522616,524410,1794,Brazil,B09,f,23,1,a
father,526630,528130,1500,Brazil,B09,c,23,2,a
child,537919,538830,911,Brazil,B09,o,24,1,a
child,541540,543930,2390,Brazil,B09,o,24,2,a
child,549290,549770,480,Brazil,B09,f,24,3,a
mother,551480,553043,1563,Brazil,B09,f,24,4,a
father,552906,553319,413,Brazil,B09,m,24,5,a
child,570350,570760,410,Brazil,B09,f,25,1,a
child,583490,584080,590,Brazil,B09,b,26,1,a
silence,6837,7185,348,Brazil,B09,NA,NA,NA,NA
silence,7516,7641,125,Brazil,B09,NA,NA,NA,NA
silence,10081,11850,1769,Brazil,B09,NA,NA,NA,NA
silence,12910,13233,323,Brazil,B09,NA,NA,NA,NA
silence,14010,22380,8370,Brazil,B09,NA,NA,NA,NA
silence,22870,40428,17558,Brazil,B09,NA,NA,NA,NA
silence,40790,55650,14860,Brazil,B09,NA,NA,NA,NA
silence,55940,87889,31949,Brazil,B09,NA,NA,NA,NA
silence,88122,110420,22298,Brazil,B09,NA,NA,NA,NA
silence,111400,114970,3570,Brazil,B09,NA,NA,NA,NA
silence,118030,173232,55202,Brazil,B09,NA,NA,NA,NA
silence,173559,228990,55431,Brazil,B09,NA,NA,NA,NA
silence,232680,254910,22230,Brazil,B09,NA,NA,NA,NA
silence,255740,261912,6172,Brazil,B09,NA,NA,NA,NA
silence,263012,270510,7498,Brazil,B09,NA,NA,NA,NA
silence,271690,278766,7076,Brazil,B09,NA,NA,NA,NA
silence,279780,280550,770,Brazil,B09,NA,NA,NA,NA
silence,280835,283452,2617,Brazil,B09,NA,NA,NA,NA
silence,285010,285529,519,Brazil,B09,NA,NA,NA,NA
silence,286791,289656,2865,Brazil,B09,NA,NA,NA,NA
silence,289992,295200,5208,Brazil,B09,NA,NA,NA,NA
silence,295497,300090,4593,Brazil,B09,NA,NA,NA,NA
silence,300650,335190,34540,Brazil,B09,NA,NA,NA,NA
silence,335650,341500,5850,Brazil,B09,NA,NA,NA,NA
silence,343900,344070,170,Brazil,B09,NA,NA,NA,NA
silence,344630,355651,11021,Brazil,B09,NA,NA,NA,NA
silence,360450,387319,26869,Brazil,B09,NA,NA,NA,NA
silence,387609,416790,29181,Brazil,B09,NA,NA,NA,NA
silence,417240,438943,21703,Brazil,B09,NA,NA,NA,NA
silence,439261,441390,2129,Brazil,B09,NA,NA,NA,NA
silence,441700,441929,229,Brazil,B09,NA,NA,NA,NA
silence,442276,459320,17044,Brazil,B09,NA,NA,NA,NA
silence,459850,459920,70,Brazil,B09,NA,NA,NA,NA
silence,460430,461023,593,Brazil,B09,NA,NA,NA,NA
silence,461494,461943,449,Brazil,B09,NA,NA,NA,NA
silence,462500,463310,810,Brazil,B09,NA,NA,NA,NA
silence,463752,470211,6459,Brazil,B09,NA,NA,NA,NA
silence,475820,476370,550,Brazil,B09,NA,NA,NA,NA
silence,476920,476970,50,Brazil,B09,NA,NA,NA,NA
silence,477600,480446,2846,Brazil,B09,NA,NA,NA,NA
silence,482380,483960,1580,Brazil,B09,NA,NA,NA,NA
silence,484560,487210,2650,Brazil,B09,NA,NA,NA,NA
silence,487720,522616,34896,Brazil,B09,NA,NA,NA,NA
silence,524410,526630,2220,Brazil,B09,NA,NA,NA,NA
silence,528130,537919,9789,Brazil,B09,NA,NA,NA,NA
silence,538830,541540,2710,Brazil,B09,NA,NA,NA,NA
silence,543930,549290,5360,Brazil,B09,NA,NA,NA,NA
silence,549770,551480,1710,Brazil,B09,NA,NA,NA,NA
silence,553319,570350,17031,Brazil,B09,NA,NA,NA,NA
silence,570760,583490,12730,Brazil,B09,NA,NA,NA,NA
mother,379,849,470,Brazil,B10,c,1,1,a
child,959,2759,1800,Brazil,B10,m,1,2,q
mother,2909,3609,700,Brazil,B10,c,1,3,q
child,4300,5070,770,Brazil,B10,m,1,4,q
mother,4860,5370,510,Brazil,B10,c,1,5,a
child,5570,6260,690,Brazil,B10,m,1,6,a
mother,6190,10110,3920,Brazil,B10,c,1,7,a
child,10610,11610,1000,Brazil,B10,m,1,8,a
child,13000,15510,2510,Brazil,B10,m,1,9,a
child,3909,4499,590,Brazil,B10,f,2,1,a
father,4599,5109,510,Brazil,B10,c,2,2,q
child,4799,5659,860,Brazil,B10,f,2,3,q
father,5719,8179,2460,Brazil,B10,c,2,4,q
child,32910,34580,1670,Brazil,B10,m,2,5,q
mother,34610,36710,2100,Brazil,B10,c,2,6,a
child,36310,41520,5210,Brazil,B10,m,2,7,q
mother,41520,45150,3630,Brazil,B10,c,2,8,a
child,45810,46610,800,Brazil,B10,m,2,9,q
mother,46610,47610,1000,Brazil,B10,c,2,10,a
child,48270,49020,750,Brazil,B10,m,2,11,q
mother,49107,49642,535,Brazil,B10,c,2,12,a
child,49810,51830,2020,Brazil,B10,m,2,13,q
mother,52210,53070,860,Brazil,B10,c,2,14,a
child,53300,54320,1020,Brazil,B10,m,2,15,q
child,55110,56220,1110,Brazil,B10,m,2,16,a
mother,56720,57610,890,Brazil,B10,c,2,17,i
child,58210,58910,700,Brazil,B10,m,2,18,a
mother,58900,60910,2010,Brazil,B10,c,2,19,i
child,62810,63480,670,Brazil,B10,m,2,20,a
mother,63946,64731,785,Brazil,B10,c,2,21,a
child,64710,65750,1040,Brazil,B10,m,2,22,a
mother,67610,68190,580,Brazil,B10,c,2,23,i
mother,69080,70420,1340,Brazil,B10,c,2,24,a
child,69610,71010,1400,Brazil,B10,m,2,25,a
mother,70745,72100,1355,Brazil,B10,c,2,26,i
child,72879,73934,1055,Brazil,B10,m,2,27,a
mother,72900,74200,1300,Brazil,B10,c,2,28,a
child,78730,79360,630,Brazil,B10,m,2,29,a
mother,80510,82260,1750,Brazil,B10,c,2,30,i
mother,88220,89840,1620,Brazil,B10,c,2,31,a
child,90340,92020,1680,Brazil,B10,m,2,32,a
mother,92010,93230,1220,Brazil,B10,c,2,33,a
child,93500,100610,7110,Brazil,B10,m,2,34,q
mother,100010,101810,1800,Brazil,B10,c,2,35,a
mother,104900,106010,1110,Brazil,B10,c,2,36,a
child,105620,106580,960,Brazil,B10,m,2,37,i
father,106600,107610,1010,Brazil,B10,c,2,38,i
child,107620,108210,590,Brazil,B10,f,2,39,a
father,108610,110720,2110,Brazil,B10,c,2,40,a
child,110610,111940,1330,Brazil,B10,f,2,41,q
father,112720,113890,1170,Brazil,B10,c,2,42,a
mother,114400,115620,1220,Brazil,B10,f,2,43,a
mother,11159,11959,800,Brazil,B10,c,3,1,q
child,12959,15049,2090,Brazil,B10,m,3,2,a
mother,14559,18449,3890,Brazil,B10,c,3,3,a
child,20359,21159,800,Brazil,B10,m,3,4,a
child,117710,120920,3210,Brazil,B10,f,3,5,i
father,120910,122098,1188,Brazil,B10,c,3,6,a
child,122840,123500,660,Brazil,B10,f,3,7,i
child,37059,38459,1400,Brazil,B10,b,4,1,a
mother,39059,39889,830,Brazil,B10,c,4,2,a
child,40159,42299,2140,Brazil,B10,f,4,3,a
child,43259,44879,1620,Brazil,B10,m,4,4,a
mother,44959,45559,600,Brazil,B10,c,4,5,a
child,45259,53359,8100,Brazil,B10,m,4,6,a
mother,53459,56159,2700,Brazil,B10,c,4,7,i
child,56449,57149,700,Brazil,B10,m,4,8,a
mother,57289,61289,4000,Brazil,B10,c,4,9,i
child,63249,68749,5500,Brazil,B10,m,4,10,q
mother,69059,69769,710,Brazil,B10,c,4,11,a
child,70849,72559,1710,Brazil,B10,m,4,12,q
mother,72859,73679,820,Brazil,B10,c,4,13,a
child,79449,80389,940,Brazil,B10,m,4,14,q
mother,86759,88159,1400,Brazil,B10,c,4,15,i
child,89069,90999,1930,Brazil,B10,m,4,16,a
mother,91909,93229,1320,Brazil,B10,c,4,17,a
child,94709,95819,1110,Brazil,B10,c,4,18,q
mother,96259,96959,700,Brazil,B10,c,4,19,a
child,98389,99679,1290,Brazil,B10,m,4,20,i
mother,99959,100939,980,Brazil,B10,c,4,21,a
child,101299,101959,660,Brazil,B10,m,4,22,a
mother,102159,103059,900,Brazil,B10,c,4,23,a
mother,103759,105409,1650,Brazil,B10,c,4,24,i
child,106729,107589,860,Brazil,B10,m,4,25,q
mother,108059,108759,700,Brazil,B10,c,4,26,a
child,109089,110929,1840,Brazil,B10,m,4,27,q
child,112059,112798,739,Brazil,B10,c,4,28,a
mother,112909,113709,800,Brazil,B10,c,4,29,q
child,113748,114359,611,Brazil,B10,m,4,30,a
mother,115108,115898,790,Brazil,B10,c,4,31,a
child,116664,117269,605,Brazil,B10,m,4,32,q
mother,117259,118031,772,Brazil,B10,c,4,33,a
child,118819,119459,640,Brazil,B10,m,4,34,a
mother,125610,126930,1320,Brazil,B10,c,4,35,a
child,127130,127790,660,Brazil,B10,m,4,36,q
child,131420,132160,740,Brazil,B10,m,4,37,q
mother,134149,135749,1600,Brazil,B10,c,5,1,a
father,134500,135770,1270,Brazil,B10,c,5,2,i
mother,135780,136800,1020,Brazil,B10,c,5,3,i
child,136719,137899,1180,Brazil,B10,c,5,4,a
father,143189,143879,690,Brazil,B10,c,5,5,i
child,144725,145589,864,Brazil,B10,f,5,6,a
father,146309,147409,1100,Brazil,B10,c,5,7,i
child,147769,154649,6880,Brazil,B10,m,5,8,q
mother,154551,155178,627,Brazil,B10,c,5,9,a
child,155239,155749,510,Brazil,B10,m,5,10,a
mother,155928,156259,331,Brazil,B10,c,5,11,i
child,158189,159069,880,Brazil,B10,m,5,12,q
mother,158959,160059,1100,Brazil,B10,c,5,13,a
child,159819,160739,920,Brazil,B10,m,5,14,i
mother,161259,162259,1000,Brazil,B10,c,5,15,i
child,161895,162769,874,Brazil,B10,m,5,16,a
mother,162759,163509,750,Brazil,B10,c,5,17,i
child,163709,164409,700,Brazil,B10,m,5,18,a
mother,164659,167249,2590,Brazil,B10,c,5,19,i
child,165559,169469,3910,Brazil,B10,m,5,20,a
mother,171459,172359,900,Brazil,B10,c,5,21,a
child,172829,173759,930,Brazil,B10,m,5,22,q
mother,174059,175459,1400,Brazil,B10,c,5,23,a
child,176129,177139,1010,Brazil,B10,m,5,24,a
child,182349,185439,3090,Brazil,B10,m,5,25,a
child,187959,196469,8510,Brazil,B10,m,5,26,a
mother,196459,197859,1400,Brazil,B10,c,5,27,i
child,197959,199459,1500,Brazil,B10,m,5,28,a
mother,199459,201239,1780,Brazil,B10,c,5,29,a
child,202799,203459,660,Brazil,B10,m,5,30,q
mother,203559,204859,1300,Brazil,B10,c,5,31,a
child,205389,206179,790,Brazil,B10,m,5,32,q
mother,206209,207959,1750,Brazil,B10,c,5,33,a
child,208899,210849,1950,Brazil,B10,NA,5,34,q
mother,210959,211599,640,Brazil,B10,c,5,35,a
child,212039,213439,1400,Brazil,B10,m,5,36,q
mother,213759,219659,5900,Brazil,B10,c,5,37,a
child,217099,218139,1040,Brazil,B10,m,5,38,q
child,219739,220799,1060,Brazil,B10,m,5,39,a
mother,221059,222159,1100,Brazil,B10,c,5,40,a
father,137720,138860,1140,Brazil,B10,c,6,1,i
child,139510,140080,570,Brazil,B10,f,6,2,q
mother,140070,141420,1350,Brazil,B10,c,6,3,a
father,140500,141290,790,Brazil,B10,c,6,4,i
child,142010,142640,630,Brazil,B10,f,6,5,q
mother,142710,143780,1070,Brazil,B10,c,6,6,a
child,145100,145910,810,Brazil,B10,m,6,7,a
mother,146360,147850,1490,Brazil,B10,c,6,8,i
child,147560,148160,600,Brazil,B10,m,6,9,a
mother,148300,149250,950,Brazil,B10,c,6,10,a
child,149260,150000,740,Brazil,B10,m,6,11,a
mother,150420,151330,910,Brazil,B10,c,6,12,a
child,151210,151990,780,Brazil,B10,m,6,13,a
mother,153360,154940,1580,Brazil,B10,c,6,14,i
child,154860,155650,790,Brazil,B10,m,6,15,a
mother,156500,157250,750,Brazil,B10,c,6,16,a
child,228359,232589,4230,Brazil,B10,b,6,17,a
father,232149,232849,700,Brazil,B10,c,6,18,i
mother,232559,233329,770,Brazil,B10,c,6,19,a
child,161910,163020,1110,Brazil,B10,m,7,1,i
child,166610,167370,760,Brazil,B10,m,7,2,a
father,171910,172690,780,Brazil,B10,c,8,1,i
child,172700,173510,810,Brazil,B10,f,8,2,a
child,177370,178020,650,Brazil,B10,b,8,3,a
mother,177790,180180,2390,Brazil,B10,c,8,4,a
child,180816,181583,767,Brazil,B10,m,8,5,a
mother,181730,182480,750,Brazil,B10,c,8,6,a
child,183053,183765,712,Brazil,B10,m,8,7,a
mother,184760,186130,1370,Brazil,B10,c,8,8,q
child,186210,186780,570,Brazil,B10,m,8,9,a
mother,193443,199310,5867,Brazil,B10,c,8,10,a
child,200600,201390,790,Brazil,B10,m,8,11,a
mother,201800,203668,1868,Brazil,B10,c,8,12,a
child,205800,206440,640,Brazil,B10,m,8,13,a
child,207000,207710,710,Brazil,B10,m,8,14,a
mother,207700,211810,4110,Brazil,B10,c,8,15,a
child,211870,214160,2290,Brazil,B10,m,8,16,a
mother,213910,215990,2080,Brazil,B10,c,8,17,a
child,216010,217600,1590,Brazil,B10,c,8,18,a
father,217020,218230,1210,Brazil,B10,c,9,1,a
child,218610,220390,1780,Brazil,B10,f,9,2,q
mother,222630,225152,2522,Brazil,B10,c,9,3,a
child,225160,226510,1350,Brazil,B10,m,9,4,a
mother,226610,228510,1900,Brazil,B10,c,9,5,a
child,227710,229220,1510,Brazil,B10,m,9,6,a
mother,229380,233340,3960,Brazil,B10,c,9,7,a
child,229910,230470,560,Brazil,B10,m,9,8,q
mother,234990,235630,640,Brazil,B10,c,9,9,q
child,237200,238530,1330,Brazil,B10,m,10,1,a
mother,238320,240690,2370,Brazil,B10,c,10,2,i
mother,242110,243840,1730,Brazil,B10,f,10,3,i
child,244210,247130,2920,Brazil,B10,f,10,4,i
child,248100,249080,980,Brazil,B10,b,10,5,a
mother,249420,251100,1680,Brazil,B10,c,11,1,a
child,251010,252500,1490,Brazil,B10,m,11,2,a
mother,253220,254570,1350,Brazil,B10,c,11,3,a
mother,257520,259080,1560,Brazil,B10,c,11,4,a
child,260120,261610,1490,Brazil,B10,m,11,5,a
mother,262080,263820,1740,Brazil,B10,c,11,6,a
mother,269810,272280,2470,Brazil,B10,c,11,7,a
child,272810,273800,990,Brazil,B10,m,11,8,a
mother,273690,280620,6930,Brazil,B10,c,11,9,a
mother,282720,284900,2180,Brazil,B10,c,11,10,a
child,288310,294410,6100,Brazil,B10,m,12,1,a
mother,294500,295180,680,Brazil,B10,c,12,2,a
child,294743,295337,594,Brazil,B10,m,12,3,a
mother,304560,313560,9000,Brazil,B10,c,13,1,i
mother,316170,317150,980,Brazil,B10,c,13,2,q
child,317410,320000,2590,Brazil,B10,m,13,3,a
mother,320580,323980,3400,Brazil,B10,c,13,4,q
child,323990,324810,820,Brazil,B10,m,13,5,a
mother,325320,330620,5300,Brazil,B10,c,13,6,a
mother,332725,338450,5725,Brazil,B10,c,13,7,a
child,338610,339610,1000,Brazil,B10,m,13,8,a
mother,340410,341860,1450,Brazil,B10,c,13,9,a
child,341200,342350,1150,Brazil,B10,m,13,10,a
mother,342700,343490,790,Brazil,B10,c,13,11,q
child,343310,343990,680,Brazil,B10,m,13,12,a
mother,345460,346630,1170,Brazil,B10,c,13,13,a
child,346620,347130,510,Brazil,B10,m,13,14,a
mother,346820,349580,2760,Brazil,B10,c,13,15,a
child,349200,350150,950,Brazil,B10,m,13,16,a
mother,350790,358210,7420,Brazil,B10,c,13,17,a
child,360300,361000,700,Brazil,B10,m,13,18,a
mother,360920,362660,1740,Brazil,B10,c,13,19,a
mother,363750,365030,1280,Brazil,B10,c,13,20,a
silence,849,959,110,Brazil,B10,NA,NA,NA,NA
silence,1890,4300,2410,Brazil,B10,NA,NA,NA,NA
silence,2759,2909,150,Brazil,B10,NA,NA,NA,NA
silence,3609,3909,300,Brazil,B10,NA,NA,NA,NA
silence,4499,4599,100,Brazil,B10,NA,NA,NA,NA
silence,5370,5570,200,Brazil,B10,NA,NA,NA,NA
silence,5659,5719,60,Brazil,B10,NA,NA,NA,NA
silence,8179,11159,2980,Brazil,B10,NA,NA,NA,NA
silence,10110,10610,500,Brazil,B10,NA,NA,NA,NA
silence,11610,13000,1390,Brazil,B10,NA,NA,NA,NA
silence,11959,12959,1000,Brazil,B10,NA,NA,NA,NA
silence,15510,32910,17400,Brazil,B10,NA,NA,NA,NA
silence,18449,20359,1910,Brazil,B10,NA,NA,NA,NA
silence,21159,37059,15900,Brazil,B10,NA,NA,NA,NA
silence,34580,34610,30,Brazil,B10,NA,NA,NA,NA
silence,38459,39059,600,Brazil,B10,NA,NA,NA,NA
silence,39889,40159,270,Brazil,B10,NA,NA,NA,NA
silence,42299,43259,960,Brazil,B10,NA,NA,NA,NA
silence,44879,44959,80,Brazil,B10,NA,NA,NA,NA
silence,45150,45810,660,Brazil,B10,NA,NA,NA,NA
silence,47610,48270,660,Brazil,B10,NA,NA,NA,NA
silence,49020,49107,87,Brazil,B10,NA,NA,NA,NA
silence,49642,49810,168,Brazil,B10,NA,NA,NA,NA
silence,51830,52210,380,Brazil,B10,NA,NA,NA,NA
child_gesture,51949,53500,1551,Brazil,B10,NA,NA,NA,NA
silence,53070,53300,230,Brazil,B10,NA,NA,NA,NA
silence,53359,53459,100,Brazil,B10,NA,NA,NA,NA
silence,54320,55110,790,Brazil,B10,NA,NA,NA,NA
silence,56159,56449,290,Brazil,B10,NA,NA,NA,NA
silence,56220,56720,500,Brazil,B10,NA,NA,NA,NA
silence,57149,57289,140,Brazil,B10,NA,NA,NA,NA
silence,57610,58210,600,Brazil,B10,NA,NA,NA,NA
silence,60910,62810,1900,Brazil,B10,NA,NA,NA,NA
silence,61289,63249,1960,Brazil,B10,NA,NA,NA,NA
silence,63480,63946,466,Brazil,B10,NA,NA,NA,NA
silence,65750,67610,1860,Brazil,B10,NA,NA,NA,NA
silence,68190,69080,890,Brazil,B10,NA,NA,NA,NA
silence,68749,69059,310,Brazil,B10,NA,NA,NA,NA
silence,69769,70849,1080,Brazil,B10,NA,NA,NA,NA
silence,72100,72879,779,Brazil,B10,NA,NA,NA,NA
silence,72559,72859,300,Brazil,B10,NA,NA,NA,NA
silence,73679,79449,5770,Brazil,B10,NA,NA,NA,NA
silence,74200,78730,4530,Brazil,B10,NA,NA,NA,NA
silence,79360,80510,1150,Brazil,B10,NA,NA,NA,NA
silence,80389,86759,6370,Brazil,B10,NA,NA,NA,NA
silence,82260,88220,5960,Brazil,B10,NA,NA,NA,NA
silence,88159,89069,910,Brazil,B10,NA,NA,NA,NA
silence,89840,90340,500,Brazil,B10,NA,NA,NA,NA
silence,90999,91909,910,Brazil,B10,NA,NA,NA,NA
silence,93229,94709,1480,Brazil,B10,NA,NA,NA,NA
silence,93230,93500,270,Brazil,B10,NA,NA,NA,NA
silence,95819,96259,440,Brazil,B10,NA,NA,NA,NA
silence,96959,98389,1430,Brazil,B10,NA,NA,NA,NA
child_gesture,99149,100535,1386,Brazil,B10,NA,NA,NA,NA
silence,99679,99959,280,Brazil,B10,NA,NA,NA,NA
silence,100939,101299,360,Brazil,B10,NA,NA,NA,NA
silence,101810,104900,3090,Brazil,B10,NA,NA,NA,NA
silence,101959,102159,200,Brazil,B10,NA,NA,NA,NA
silence,103059,103759,700,Brazil,B10,NA,NA,NA,NA
silence,105409,106729,1320,Brazil,B10,NA,NA,NA,NA
silence,106580,106600,20,Brazil,B10,NA,NA,NA,NA
silence,107589,108059,470,Brazil,B10,NA,NA,NA,NA
silence,107610,107620,10,Brazil,B10,NA,NA,NA,NA
silence,108210,108610,400,Brazil,B10,NA,NA,NA,NA
silence,108759,109089,330,Brazil,B10,NA,NA,NA,NA
silence,110929,112059,1130,Brazil,B10,NA,NA,NA,NA
silence,111940,112720,780,Brazil,B10,NA,NA,NA,NA
silence,112798,112909,111,Brazil,B10,NA,NA,NA,NA
silence,113709,113748,39,Brazil,B10,NA,NA,NA,NA
silence,113890,114400,510,Brazil,B10,NA,NA,NA,NA
silence,114359,115108,749,Brazil,B10,NA,NA,NA,NA
mother_gesture,115199,116123,924,Brazil,B10,NA,NA,NA,NA
silence,115620,117710,2090,Brazil,B10,NA,NA,NA,NA
silence,115898,116664,766,Brazil,B10,NA,NA,NA,NA
silence,118031,118819,788,Brazil,B10,NA,NA,NA,NA
silence,119459,134149,14690,Brazil,B10,NA,NA,NA,NA
silence,122098,122840,742,Brazil,B10,NA,NA,NA,NA
silence,123500,125610,2110,Brazil,B10,NA,NA,NA,NA
silence,126930,127130,200,Brazil,B10,NA,NA,NA,NA
silence,127790,131420,3630,Brazil,B10,NA,NA,NA,NA
silence,132160,134500,2340,Brazil,B10,NA,NA,NA,NA
silence,135749,136719,970,Brazil,B10,NA,NA,NA,NA
silence,135770,135780,10,Brazil,B10,NA,NA,NA,NA
silence,136800,137720,920,Brazil,B10,NA,NA,NA,NA
silence,137899,143189,5290,Brazil,B10,NA,NA,NA,NA
silence,138860,139510,650,Brazil,B10,NA,NA,NA,NA
silence,141420,142010,590,Brazil,B10,NA,NA,NA,NA
silence,142640,142710,70,Brazil,B10,NA,NA,NA,NA
silence,143780,145100,1320,Brazil,B10,NA,NA,NA,NA
silence,143879,144725,846,Brazil,B10,NA,NA,NA,NA
silence,145589,146309,720,Brazil,B10,NA,NA,NA,NA
silence,145910,146360,450,Brazil,B10,NA,NA,NA,NA
silence,147409,147769,360,Brazil,B10,NA,NA,NA,NA
silence,148160,148300,140,Brazil,B10,NA,NA,NA,NA
silence,149250,149260,10,Brazil,B10,NA,NA,NA,NA
silence,150000,150420,420,Brazil,B10,NA,NA,NA,NA
silence,151990,153360,1370,Brazil,B10,NA,NA,NA,NA
silence,155178,155239,61,Brazil,B10,NA,NA,NA,NA
silence,155650,156500,850,Brazil,B10,NA,NA,NA,NA
silence,155749,155928,179,Brazil,B10,NA,NA,NA,NA
silence,156259,158189,1930,Brazil,B10,NA,NA,NA,NA
silence,157250,161910,4660,Brazil,B10,NA,NA,NA,NA
silence,160739,161259,520,Brazil,B10,NA,NA,NA,NA
silence,163020,166610,3590,Brazil,B10,NA,NA,NA,NA
silence,163509,163709,200,Brazil,B10,NA,NA,NA,NA
silence,164409,164659,250,Brazil,B10,NA,NA,NA,NA
silence,167370,171910,4540,Brazil,B10,NA,NA,NA,NA
silence,169469,171459,1990,Brazil,B10,NA,NA,NA,NA
silence,172359,172829,470,Brazil,B10,NA,NA,NA,NA
silence,172690,172700,10,Brazil,B10,NA,NA,NA,NA
silence,173510,177370,3860,Brazil,B10,NA,NA,NA,NA
silence,173759,174059,300,Brazil,B10,NA,NA,NA,NA
silence,175459,176129,670,Brazil,B10,NA,NA,NA,NA
silence,177139,182349,5210,Brazil,B10,NA,NA,NA,NA
silence,180180,180816,636,Brazil,B10,NA,NA,NA,NA
silence,181583,181730,147,Brazil,B10,NA,NA,NA,NA
silence,182480,183053,573,Brazil,B10,NA,NA,NA,NA
silence,183765,184760,995,Brazil,B10,NA,NA,NA,NA
silence,185439,187959,2520,Brazil,B10,NA,NA,NA,NA
silence,186130,186210,80,Brazil,B10,NA,NA,NA,NA
silence,186780,193443,6663,Brazil,B10,NA,NA,NA,NA
silence,197859,197959,100,Brazil,B10,NA,NA,NA,NA
silence,199310,200600,1290,Brazil,B10,NA,NA,NA,NA
silence,201239,202799,1560,Brazil,B10,NA,NA,NA,NA
silence,201390,201800,410,Brazil,B10,NA,NA,NA,NA
silence,203459,203559,100,Brazil,B10,NA,NA,NA,NA
silence,203668,205800,2132,Brazil,B10,NA,NA,NA,NA
silence,204859,205389,530,Brazil,B10,NA,NA,NA,NA
silence,206179,206209,30,Brazil,B10,NA,NA,NA,NA
silence,206440,207000,560,Brazil,B10,NA,NA,NA,NA
silence,207959,208899,940,Brazil,B10,NA,NA,NA,NA
silence,210849,210959,110,Brazil,B10,NA,NA,NA,NA
silence,211599,212039,440,Brazil,B10,NA,NA,NA,NA
silence,211810,211870,60,Brazil,B10,NA,NA,NA,NA
silence,213439,213759,320,Brazil,B10,NA,NA,NA,NA
silence,215990,216010,20,Brazil,B10,NA,NA,NA,NA
silence,218230,218610,380,Brazil,B10,NA,NA,NA,NA
silence,219659,219739,80,Brazil,B10,NA,NA,NA,NA
silence,220390,222630,2240,Brazil,B10,NA,NA,NA,NA
silence,220799,221059,260,Brazil,B10,NA,NA,NA,NA
silence,222159,228359,6200,Brazil,B10,NA,NA,NA,NA
silence,225152,225160,8,Brazil,B10,NA,NA,NA,NA
silence,226510,226610,100,Brazil,B10,NA,NA,NA,NA
silence,229220,229380,160,Brazil,B10,NA,NA,NA,NA
silence,233329,233459,130,Brazil,B10,NA,NA,NA,NA
silence,233340,234990,1650,Brazil,B10,NA,NA,NA,NA
silence,235630,237200,1570,Brazil,B10,NA,NA,NA,NA
silence,240690,242110,1420,Brazil,B10,NA,NA,NA,NA
silence,243840,244210,370,Brazil,B10,NA,NA,NA,NA
silence,247130,248100,970,Brazil,B10,NA,NA,NA,NA
silence,249080,249420,340,Brazil,B10,NA,NA,NA,NA
silence,252500,253220,720,Brazil,B10,NA,NA,NA,NA
silence,254570,257520,2950,Brazil,B10,NA,NA,NA,NA
silence,259080,260120,1040,Brazil,B10,NA,NA,NA,NA
silence,261610,262080,470,Brazil,B10,NA,NA,NA,NA
silence,263820,269810,5990,Brazil,B10,NA,NA,NA,NA
silence,272280,272810,530,Brazil,B10,NA,NA,NA,NA
silence,280620,282720,2100,Brazil,B10,NA,NA,NA,NA
silence,284900,288310,3410,Brazil,B10,NA,NA,NA,NA
silence,294410,294500,90,Brazil,B10,NA,NA,NA,NA
silence,295337,304560,9223,Brazil,B10,NA,NA,NA,NA
silence,313560,316170,2610,Brazil,B10,NA,NA,NA,NA
silence,317150,317410,260,Brazil,B10,NA,NA,NA,NA
silence,320000,320580,580,Brazil,B10,NA,NA,NA,NA
silence,323980,323990,10,Brazil,B10,NA,NA,NA,NA
silence,324810,325320,510,Brazil,B10,NA,NA,NA,NA
silence,330620,332725,2105,Brazil,B10,NA,NA,NA,NA
silence,338450,338610,160,Brazil,B10,NA,NA,NA,NA
silence,339610,340410,800,Brazil,B10,NA,NA,NA,NA
silence,342350,342700,350,Brazil,B10,NA,NA,NA,NA
silence,343990,345460,1470,Brazil,B10,NA,NA,NA,NA
silence,350150,350790,640,Brazil,B10,NA,NA,NA,NA
silence,358210,360300,2090,Brazil,B10,NA,NA,NA,NA
silence,362660,363750,1090,Brazil,B10,NA,NA,NA,NA
father,956,1910,954,Brazil,B11,c,1,1,i
child,2223,2799,576,Brazil,B11,b,1,2,a
child,18614,19253,639,Brazil,B11,f,2,1,a
father,19428,20144,716,Brazil,B11,c,2,2,a
child,20954,21714,760,Brazil,B11,f,2,3,q
child,24384,25812,1428,Brazil,B11,m,2,4,a
mother,26200,27105,905,Brazil,B11,c,2,5,q
child,27428,28132,704,Brazil,B11,m,2,6,a
mother,28277,29323,1046,Brazil,B11,c,2,7,a
child,32927,34594,1667,Brazil,B11,f,2,8,a
father,51907,52427,520,Brazil,B11,c,3,1,i
mother,59574,61604,2030,Brazil,B11,c,3,2,i
child,62224,63334,1110,Brazil,B11,m,3,3,a
father,63914,65132,1218,Brazil,B11,c,3,4,i
father,68934,69932,998,Brazil,B11,c,3,5,a
mother,70894,74044,3150,Brazil,B11,c,3,6,a
mother,80854,81624,770,Brazil,B11,c,3,7,i
child,88902,90077,1175,Brazil,B11,f,3,8,q
father,90874,91474,600,Brazil,B11,c,3,9,a
father,98944,99464,520,Brazil,B11,c,3,10,q
child,101754,102718,964,Brazil,B11,f,3,11,a
father,103169,104629,1460,Brazil,B11,c,3,12,a
father,114004,115114,1110,Brazil,B11,c,3,13,a
child,115794,116321,527,Brazil,B11,f,3,14,q
father,116624,117154,530,Brazil,B11,c,3,15,a
child,117674,118364,690,Brazil,B11,c,3,16,a
father,118814,119354,540,Brazil,B11,c,3,17,a
child,119694,120364,670,Brazil,B11,c,3,18,q
father,120644,121054,410,Brazil,B11,c,3,19,a
mother,128653,129254,601,Brazil,B11,c,3,20,q
child,130504,131027,523,Brazil,B11,m,3,21,a
father,135325,136102,777,Brazil,B11,c,3,22,q
mother,149720,150620,900,Brazil,B11,f,4,1,a
child,153004,155264,2260,Brazil,B11,m,4,2,a
child,158184,159204,1020,Brazil,B11,m,4,3,a
mother,171176,173207,2031,Brazil,B11,f,5,1,a
father,175364,176074,710,Brazil,B11,c,6,1,i
child,176624,181104,4480,Brazil,B11,f,6,2,a
mother,181324,186514,5190,Brazil,B11,c,6,3,a
child,186996,187725,729,Brazil,B11,m,6,4,a
mother,193154,193704,550,Brazil,B11,c,6,5,a
child,201504,202368,864,Brazil,B11,b,6,6,a
father,202639,202971,332,Brazil,B11,c,6,7,q
child,203030,204284,1254,Brazil,B11,m,6,8,i
father,204453,205544,1091,Brazil,B11,c,6,9,q
child,205504,206774,1270,Brazil,B11,m,6,10,a
child,228474,230864,2390,Brazil,B11,f,7,1,a
child,234132,235090,958,Brazil,B11,f,7,2,a
father,240014,240705,691,Brazil,B11,c,7,3,a
child,241354,242064,710,Brazil,B11,f,7,4,a
father,243234,243792,558,Brazil,B11,c,7,5,i
child,243880,244367,487,Brazil,B11,f,7,6,a
father,273964,274994,1030,Brazil,B11,c,8,1,a
child,275234,275909,675,Brazil,B11,f,8,2,a
father,276058,277026,968,Brazil,B11,c,8,3,q
child,278244,279884,1640,Brazil,B11,f,8,4,a
father,279573,281144,1571,Brazil,B11,c,8,5,a
child,298044,300744,2700,Brazil,B11,f,9,1,a
father,300314,301052,738,Brazil,B11,c,9,2,q
mother,305104,306325,1221,Brazil,B11,c,9,3,i
child,306984,307378,394,Brazil,B11,m,9,4,a
mother,308834,309989,1155,Brazil,B11,c,9,5,a
mother,312414,315253,2839,Brazil,B11,c,9,6,a
child,322984,323564,580,Brazil,B11,m,9,7,a
mother,324994,325651,657,Brazil,B11,c,9,8,i
child,395504,395974,470,Brazil,B11,f,10,1,a
mother,433764,435945,2181,Brazil,B11,c,10,2,a
child,442024,442464,440,Brazil,B11,f,10,3,i
father,471024,471534,510,Brazil,B11,c,11,1,i
father,477141,477720,579,Brazil,B11,c,11,2,i
father,480744,481054,310,Brazil,B11,c,11,3,a
child,485359,486327,968,Brazil,B11,m,11,4,a
child,494354,494984,630,Brazil,B11,f,11,5,a
child,509264,510314,1050,Brazil,B11,f,12,1,i
father,510304,511341,1037,Brazil,B11,c,12,2,a
child,513174,513774,600,Brazil,B11,b,12,3,a
silence,1910,2223,313,Brazil,B11,NA,NA,NA,NA
silence,2799,18614,15815,Brazil,B11,NA,NA,NA,NA
silence,19253,19428,175,Brazil,B11,NA,NA,NA,NA
silence,20144,20954,810,Brazil,B11,NA,NA,NA,NA
silence,21714,24384,2670,Brazil,B11,NA,NA,NA,NA
silence,25812,26200,388,Brazil,B11,NA,NA,NA,NA
silence,27105,27428,323,Brazil,B11,NA,NA,NA,NA
silence,28132,28277,145,Brazil,B11,NA,NA,NA,NA
silence,29323,32927,3604,Brazil,B11,NA,NA,NA,NA
silence,34594,51907,17313,Brazil,B11,NA,NA,NA,NA
silence,52427,59574,7147,Brazil,B11,NA,NA,NA,NA
silence,61604,62224,620,Brazil,B11,NA,NA,NA,NA
silence,63334,63914,580,Brazil,B11,NA,NA,NA,NA
silence,65132,68934,3802,Brazil,B11,NA,NA,NA,NA
father_gesture,68944,69860,916,Brazil,B11,NA,NA,NA,NA
silence,69932,70894,962,Brazil,B11,NA,NA,NA,NA
silence,74044,80854,6810,Brazil,B11,NA,NA,NA,NA
silence,81624,88902,7278,Brazil,B11,NA,NA,NA,NA
silence,90077,90874,797,Brazil,B11,NA,NA,NA,NA
silence,91474,98944,7470,Brazil,B11,NA,NA,NA,NA
silence,99464,101754,2290,Brazil,B11,NA,NA,NA,NA
silence,102718,103169,451,Brazil,B11,NA,NA,NA,NA
silence,104629,114004,9375,Brazil,B11,NA,NA,NA,NA
silence,115114,115794,680,Brazil,B11,NA,NA,NA,NA
silence,116321,116624,303,Brazil,B11,NA,NA,NA,NA
silence,117154,117674,520,Brazil,B11,NA,NA,NA,NA
silence,118364,118814,450,Brazil,B11,NA,NA,NA,NA
silence,119354,119694,340,Brazil,B11,NA,NA,NA,NA
silence,120364,120644,280,Brazil,B11,NA,NA,NA,NA
silence,121054,128653,7599,Brazil,B11,NA,NA,NA,NA
silence,129254,130504,1250,Brazil,B11,NA,NA,NA,NA
silence,131027,135325,4298,Brazil,B11,NA,NA,NA,NA
silence,136102,149720,13618,Brazil,B11,NA,NA,NA,NA
silence,150620,153004,2384,Brazil,B11,NA,NA,NA,NA
silence,155264,158184,2920,Brazil,B11,NA,NA,NA,NA
silence,159204,171176,11972,Brazil,B11,NA,NA,NA,NA
silence,173207,175364,2157,Brazil,B11,NA,NA,NA,NA
silence,176074,176624,550,Brazil,B11,NA,NA,NA,NA
silence,181104,181324,220,Brazil,B11,NA,NA,NA,NA
silence,186514,186996,482,Brazil,B11,NA,NA,NA,NA
silence,187725,193154,5429,Brazil,B11,NA,NA,NA,NA
silence,193704,201504,7800,Brazil,B11,NA,NA,NA,NA
silence,202368,202639,271,Brazil,B11,NA,NA,NA,NA
silence,202971,203030,59,Brazil,B11,NA,NA,NA,NA
silence,204284,204453,169,Brazil,B11,NA,NA,NA,NA
silence,206774,228474,21700,Brazil,B11,NA,NA,NA,NA
silence,230864,234132,3268,Brazil,B11,NA,NA,NA,NA
silence,235090,240014,4924,Brazil,B11,NA,NA,NA,NA
silence,240705,241354,649,Brazil,B11,NA,NA,NA,NA
silence,242064,243234,1170,Brazil,B11,NA,NA,NA,NA
silence,243792,243880,88,Brazil,B11,NA,NA,NA,NA
silence,244367,273964,29597,Brazil,B11,NA,NA,NA,NA
silence,274994,275234,240,Brazil,B11,NA,NA,NA,NA
silence,275909,276058,149,Brazil,B11,NA,NA,NA,NA
silence,277026,278244,1218,Brazil,B11,NA,NA,NA,NA
silence,281144,298044,16900,Brazil,B11,NA,NA,NA,NA
silence,301052,305104,4052,Brazil,B11,NA,NA,NA,NA
silence,306325,306984,659,Brazil,B11,NA,NA,NA,NA
silence,307378,308834,1456,Brazil,B11,NA,NA,NA,NA
silence,309989,312414,2425,Brazil,B11,NA,NA,NA,NA
silence,315253,322984,7731,Brazil,B11,NA,NA,NA,NA
silence,323564,324994,1430,Brazil,B11,NA,NA,NA,NA
silence,325651,395504,69853,Brazil,B11,NA,NA,NA,NA
silence,395974,433764,37790,Brazil,B11,NA,NA,NA,NA
silence,435945,442024,6079,Brazil,B11,NA,NA,NA,NA
silence,442464,471024,28560,Brazil,B11,NA,NA,NA,NA
silence,471534,477141,5607,Brazil,B11,NA,NA,NA,NA
silence,477720,480744,3024,Brazil,B11,NA,NA,NA,NA
child_gesture,479762,481148,1386,Brazil,B11,NA,NA,NA,NA
silence,481054,485359,4305,Brazil,B11,NA,NA,NA,NA
silence,486327,494354,8027,Brazil,B11,NA,NA,NA,NA
silence,494984,509264,14280,Brazil,B11,NA,NA,NA,NA
child_gesture,509410,510136,726,Brazil,B11,NA,NA,NA,NA
silence,511341,513174,1833,Brazil,B11,NA,NA,NA,NA
child,1466,2666,1200,Brazil,B12,m,1,1,a
child,4716,6986,2270,Brazil,B12,m,1,2,a
mother,5476,6466,990,Brazil,B12,c,1,3,a
child,9656,11066,1410,Brazil,B12,m,1,4,a
father,11366,12166,800,Brazil,B12,m,2,1,a
mother,13266,14566,1300,Brazil,B12,f,2,2,a
father,18266,18836,570,Brazil,B12,m,2,3,a
father,20866,22766,1900,Brazil,B12,m,2,4,a
mother,24166,30076,5910,Brazil,B12,f,2,5,a
father,30096,35266,5170,Brazil,B12,m,2,6,a
mother,33466,34166,700,Brazil,B12,f,2,7,a
mother,35866,37466,1600,Brazil,B12,f,2,8,a
father,41066,42956,1890,Brazil,B12,c,3,1,a
child,43126,43606,480,Brazil,B12,f,3,2,a
mother,44766,47626,2860,Brazil,B12,c,3,3,a
mother,49666,50566,900,Brazil,B12,c,3,4,a
father,62006,62576,570,Brazil,B12,c,4,1,i
child,63066,67276,4210,Brazil,B12,f,4,2,q
father,67973,69622,1649,Brazil,B12,c,4,3,a
child,70173,70676,503,Brazil,B12,f,4,4,a
mother,83746,86966,3220,Brazil,B12,f,5,1,a
mother,89506,91126,1620,Brazil,B12,f,5,2,a
mother,93466,96016,2550,Brazil,B12,f,5,3,a
child,89056,90256,1200,Brazil,B12,m,7,1,a
child,93766,94656,890,Brazil,B12,m,7,2,a
child,96866,97506,640,Brazil,B12,m,7,3,q
mother,116766,119198,2432,Brazil,B12,f,7,4,a
child,119786,124546,4760,Brazil,B12,m,8,1,q
mother,125116,125666,550,Brazil,B12,c,8,2,q
child,125926,126376,450,Brazil,B12,m,8,3,a
mother,126306,126726,420,Brazil,B12,c,8,4,i
child,127466,128876,1410,Brazil,B12,m,8,5,q
mother,129456,131396,1940,Brazil,B12,c,8,6,a
father,134766,136966,2200,Brazil,B12,m,8,7,a
father,139556,141086,1530,Brazil,B12,m,8,8,a
mother,145556,146266,710,Brazil,B12,f,8,9,a
child,147166,156966,9800,Brazil,B12,m,8,10,q
mother,157036,158326,1290,Brazil,B12,c,8,11,a
child,158666,160976,2310,Brazil,B12,m,8,12,a
child,163356,168626,5270,Brazil,B12,m,8,13,q
mother,169106,180256,11150,Brazil,B12,c,8,14,a
child,180866,181866,1000,Brazil,B12,m,8,15,q
mother,181916,184536,2620,Brazil,B12,c,8,16,a
child,184476,184956,480,Brazil,B12,m,8,17,a
father,184736,185206,470,Brazil,B12,b,8,18,a
child,185566,186326,760,Brazil,B12,m,8,19,a
child,187476,188426,950,Brazil,B12,f,8,20,i
mother,189126,190196,1070,Brazil,B12,c,8,21,a
child,193296,197446,4150,Brazil,B12,f,8,22,a
father,199216,201086,1870,Brazil,B12,c,8,23,a
child,201106,202192,1086,Brazil,B12,f,8,24,a
mother,203106,205821,2715,Brazil,B12,f,8,25,a
child,213456,214846,1390,Brazil,B12,f,8,26,q
child,226156,226966,810,Brazil,B12,m,9,1,a
child,232156,234716,2560,Brazil,B12,m,9,2,a
child,235546,238436,2890,Brazil,B12,m,9,3,a
mother,239666,240586,920,Brazil,B12,c,9,4,i
child,242116,244316,2200,Brazil,B12,m,9,5,a
father,245456,247286,1830,Brazil,B12,c,9,6,a
mother,230666,232664,1998,Brazil,B12,f,10,1,a
mother,234426,237286,2860,Brazil,B12,f,10,2,a
child,261266,265316,4050,Brazil,B12,b,11,1,a
mother,266736,268756,2020,Brazil,B12,c,11,2,a
child,269556,275706,6150,Brazil,B12,m,11,3,a
mother,275256,276636,1380,Brazil,B12,c,11,4,a
child,277686,279786,2100,Brazil,B12,m,11,5,a
mother,279796,281046,1250,Brazil,B12,c,11,6,a
father,265166,270766,5600,Brazil,B12,m,12,1,a
child,293746,295956,2210,Brazil,B12,m,12,2,a
child,320666,326586,5920,Brazil,B12,f,12,3,a
mother,328176,328776,600,Brazil,B12,c,12,4,i
child,315806,317936,2130,Brazil,B12,m,13,1,a
mother,336676,343266,6590,Brazil,B12,f,13,2,a
mother,345556,348166,2610,Brazil,B12,f,13,3,a
father,353116,354596,1480,Brazil,B12,m,13,4,a
mother,363666,364956,1290,Brazil,B12,f,13,5,i
child,371646,372976,1330,Brazil,B12,b,13,6,a
child,380266,382476,2210,Brazil,B12,m,13,7,a
child,384376,385136,760,Brazil,B12,m,13,8,a
mother,385686,386916,1230,Brazil,B12,c,13,9,a
child,387176,387906,730,Brazil,B12,m,13,10,a
child,395456,397056,1600,Brazil,B12,m,13,11,a
child,357836,360696,2860,Brazil,B12,b,14,1,a
mother,410346,415446,5100,Brazil,B12,f,15,1,a
child,418526,420366,1840,Brazil,B12,b,16,1,a
father,420266,422536,2270,Brazil,B12,m,16,2,a
mother,422886,423596,710,Brazil,B12,f,16,3,q
father,424296,426226,1930,Brazil,B12,m,16,4,a
mother,427236,428096,860,Brazil,B12,f,16,5,a
father,428466,429486,1020,Brazil,B12,m,16,6,a
mother,430726,431406,680,Brazil,B12,c,16,7,i
child,433296,436686,3390,Brazil,B12,m,16,8,q
child,444396,450936,6540,Brazil,B12,b,16,9,a
mother,457146,458416,1270,Brazil,B12,c,16,10,a
child,458566,459216,650,Brazil,B12,m,16,11,q
father,459586,460166,580,Brazil,B12,c,16,12,a
father,470746,475346,4600,Brazil,B12,c,16,13,i
child,475936,476906,970,Brazil,B12,f,16,14,a
father,477616,478516,900,Brazil,B12,c,16,15,a
child,478526,479506,980,Brazil,B12,m,16,16,q
father,479516,481436,1920,Brazil,B12,c,16,17,a
child,481576,482756,1180,Brazil,B12,m,16,18,a
mother,482936,484946,2010,Brazil,B12,c,16,19,i
father,528776,529766,990,Brazil,B12,m,17,1,a
mother,530536,532316,1780,Brazil,B12,f,17,2,q
mother,535166,535966,800,Brazil,B12,f,17,3,NA
child,535366,537856,2490,Brazil,B12,b,17,4,q
mother,538826,539956,1130,Brazil,B12,c,17,5,i
mother,79266,80576,1310,Brazil,B12,f,56,1,a
silence,2666,4716,2050,Brazil,B12,NA,NA,NA,NA
silence,6986,9656,2670,Brazil,B12,NA,NA,NA,NA
silence,11066,11366,300,Brazil,B12,NA,NA,NA,NA
silence,12166,13266,1100,Brazil,B12,NA,NA,NA,NA
silence,14566,18266,3700,Brazil,B12,NA,NA,NA,NA
silence,18836,20866,2030,Brazil,B12,NA,NA,NA,NA
silence,22766,24166,1400,Brazil,B12,NA,NA,NA,NA
silence,30076,30096,20,Brazil,B12,NA,NA,NA,NA
silence,35266,35866,600,Brazil,B12,NA,NA,NA,NA
silence,37466,41066,3600,Brazil,B12,NA,NA,NA,NA
silence,42956,43126,170,Brazil,B12,NA,NA,NA,NA
silence,43606,44766,1160,Brazil,B12,NA,NA,NA,NA
silence,47626,49666,2040,Brazil,B12,NA,NA,NA,NA
silence,50566,62006,11440,Brazil,B12,NA,NA,NA,NA
silence,62576,63066,490,Brazil,B12,NA,NA,NA,NA
silence,67276,67973,697,Brazil,B12,NA,NA,NA,NA
silence,69622,70173,551,Brazil,B12,NA,NA,NA,NA
silence,70676,79266,8590,Brazil,B12,NA,NA,NA,NA
silence,80576,83746,3170,Brazil,B12,NA,NA,NA,NA
silence,86966,89056,2090,Brazil,B12,NA,NA,NA,NA
silence,91126,93466,2340,Brazil,B12,NA,NA,NA,NA
silence,96016,96866,850,Brazil,B12,NA,NA,NA,NA
silence,97506,116766,19260,Brazil,B12,NA,NA,NA,NA
mother_gesture,117066,118465,1399,Brazil,B12,NA,NA,NA,NA
silence,119198,119786,588,Brazil,B12,NA,NA,NA,NA
child_gesture,121754,123906,2152,Brazil,B12,NA,NA,NA,NA
silence,124546,125116,570,Brazil,B12,NA,NA,NA,NA
silence,125666,125926,260,Brazil,B12,NA,NA,NA,NA
silence,126726,127466,740,Brazil,B12,NA,NA,NA,NA
silence,128876,129456,580,Brazil,B12,NA,NA,NA,NA
silence,131396,134766,3370,Brazil,B12,NA,NA,NA,NA
silence,136966,139556,2590,Brazil,B12,NA,NA,NA,NA
silence,141086,145556,4470,Brazil,B12,NA,NA,NA,NA
silence,146266,147166,900,Brazil,B12,NA,NA,NA,NA
silence,156966,157036,70,Brazil,B12,NA,NA,NA,NA
silence,158326,158666,340,Brazil,B12,NA,NA,NA,NA
silence,160976,163356,2380,Brazil,B12,NA,NA,NA,NA
silence,168626,169106,480,Brazil,B12,NA,NA,NA,NA
silence,180256,180866,610,Brazil,B12,NA,NA,NA,NA
silence,181866,181916,50,Brazil,B12,NA,NA,NA,NA
silence,185206,185566,360,Brazil,B12,NA,NA,NA,NA
silence,186326,187476,1150,Brazil,B12,NA,NA,NA,NA
silence,188426,189126,700,Brazil,B12,NA,NA,NA,NA
silence,190196,193296,3100,Brazil,B12,NA,NA,NA,NA
silence,197446,199216,1770,Brazil,B12,NA,NA,NA,NA
silence,201086,201106,20,Brazil,B12,NA,NA,NA,NA
silence,202192,203106,914,Brazil,B12,NA,NA,NA,NA
silence,205821,213456,7635,Brazil,B12,NA,NA,NA,NA
child_gesture,213181,213872,691,Brazil,B12,NA,NA,NA,NA
silence,214846,226156,11310,Brazil,B12,NA,NA,NA,NA
silence,226966,230666,3700,Brazil,B12,NA,NA,NA,NA
silence,238436,239666,1230,Brazil,B12,NA,NA,NA,NA
silence,240586,242116,1530,Brazil,B12,NA,NA,NA,NA
silence,244316,245456,1140,Brazil,B12,NA,NA,NA,NA
silence,247286,261266,13980,Brazil,B12,NA,NA,NA,NA
silence,276636,277686,1050,Brazil,B12,NA,NA,NA,NA
silence,279786,279796,10,Brazil,B12,NA,NA,NA,NA
silence,281046,293746,12700,Brazil,B12,NA,NA,NA,NA
silence,295956,315806,19850,Brazil,B12,NA,NA,NA,NA
silence,317936,320666,2730,Brazil,B12,NA,NA,NA,NA
silence,326586,328176,1590,Brazil,B12,NA,NA,NA,NA
silence,328776,336676,7900,Brazil,B12,NA,NA,NA,NA
silence,343266,345556,2290,Brazil,B12,NA,NA,NA,NA
silence,348166,353116,4950,Brazil,B12,NA,NA,NA,NA
silence,354596,357836,3240,Brazil,B12,NA,NA,NA,NA
silence,360696,363666,2970,Brazil,B12,NA,NA,NA,NA
silence,364956,371646,6690,Brazil,B12,NA,NA,NA,NA
silence,372976,380266,7290,Brazil,B12,NA,NA,NA,NA
silence,382476,384376,1900,Brazil,B12,NA,NA,NA,NA
silence,385136,385686,550,Brazil,B12,NA,NA,NA,NA
silence,386916,387176,260,Brazil,B12,NA,NA,NA,NA
silence,387906,395456,7550,Brazil,B12,NA,NA,NA,NA
silence,397056,410346,13290,Brazil,B12,NA,NA,NA,NA
silence,415446,418526,3080,Brazil,B12,NA,NA,NA,NA
silence,422536,422886,350,Brazil,B12,NA,NA,NA,NA
silence,423596,424296,700,Brazil,B12,NA,NA,NA,NA
silence,426226,427236,1010,Brazil,B12,NA,NA,NA,NA
silence,428096,428466,370,Brazil,B12,NA,NA,NA,NA
silence,429486,430726,1240,Brazil,B12,NA,NA,NA,NA
silence,431406,433296,1890,Brazil,B12,NA,NA,NA,NA
silence,436686,444396,7710,Brazil,B12,NA,NA,NA,NA
silence,450936,457146,6210,Brazil,B12,NA,NA,NA,NA
silence,458416,458566,150,Brazil,B12,NA,NA,NA,NA
silence,459216,459586,370,Brazil,B12,NA,NA,NA,NA
silence,460166,470746,10580,Brazil,B12,NA,NA,NA,NA
silence,475346,475936,590,Brazil,B12,NA,NA,NA,NA
silence,476906,477616,710,Brazil,B12,NA,NA,NA,NA
silence,478516,478526,10,Brazil,B12,NA,NA,NA,NA
silence,479506,479516,10,Brazil,B12,NA,NA,NA,NA
silence,481436,481576,140,Brazil,B12,NA,NA,NA,NA
silence,482756,482936,180,Brazil,B12,NA,NA,NA,NA
silence,484946,528776,43830,Brazil,B12,NA,NA,NA,NA
silence,529766,530536,770,Brazil,B12,NA,NA,NA,NA
mother_gesture,530970,531661,691,Brazil,B12,NA,NA,NA,NA
silence,532316,535166,2850,Brazil,B12,NA,NA,NA,NA
silence,537856,538826,970,Brazil,B12,NA,NA,NA,NA
child,185,580,395,Brazil,B13,m,1,1,a
father,958,2457,1499,Brazil,B13,b,1,2,a
mother,3650,4686,1036,Brazil,B13,c,1,3,a
child,7510,7950,440,Brazil,B13,m,1,4,a
mother,8380,11880,3500,Brazil,B13,c,1,5,a
mother,15700,19064,3364,Brazil,B13,c,1,6,a
mother,21660,22980,1320,Brazil,B13,f,1,7,a
mother,25260,26340,1080,Brazil,B13,f,1,8,a
father,26830,31350,4520,Brazil,B13,m,1,9,q
mother,31930,33720,1790,Brazil,B13,c,1,10,i
mother,35830,37040,1210,Brazil,B13,c,1,11,a
child,37446,40290,2844,Brazil,B13,m,1,12,a
mother,39747,40855,1108,Brazil,B13,c,1,13,i
child,41023,41477,454,Brazil,B13,m,1,14,q
mother,41533,45240,3707,Brazil,B13,c,1,15,i
father,43710,49230,5520,Brazil,B13,c,1,16,a
child,48790,49292,502,Brazil,B13,f,1,17,a
child,55560,59690,4130,Brazil,B13,b,1,18,a
mother,57920,60610,2690,Brazil,B13,c,1,19,a
father,58500,59340,840,Brazil,B13,c,1,20,a
mother,63880,65100,1220,Brazil,B13,f,1,21,q
father,67340,68430,1090,Brazil,B13,m,1,22,a
mother,69674,71044,1370,Brazil,B13,c,1,23,i
child,70670,74910,4240,Brazil,B13,m,1,24,a
father,74560,76806,2246,Brazil,B13,m,1,25,a
mother,76690,77420,730,Brazil,B13,c,1,26,i
child,78220,78980,760,Brazil,B13,m,1,27,q
father,78836,79720,884,Brazil,B13,c,1,28,a
mother,79240,79640,400,Brazil,B13,c,1,29,a
child,79911,80307,396,Brazil,B13,m,1,30,q
father,80050,81426,1376,Brazil,B13,c,1,31,a
child,80616,81888,1272,Brazil,B13,m,1,32,a
mother,81843,82457,614,Brazil,B13,c,1,33,q
father,82270,83608,1338,Brazil,B13,c,1,34,i
child,83910,84630,720,Brazil,B13,m,1,35,a
mother,85450,86427,977,Brazil,B13,c,1,36,a
child,87560,88055,495,Brazil,B13,m,1,37,a
father,93980,94530,550,Brazil,B13,c,1,38,i
child,115320,119270,3950,Brazil,B13,f,2,1,a
child,121430,126970,5540,Brazil,B13,f,2,2,a
father,129870,131278,1408,Brazil,B13,c,2,3,a
child,131410,131708,298,Brazil,B13,f,2,4,a
father,132055,134730,2675,Brazil,B13,c,2,5,a
child,161540,162130,590,Brazil,B13,f,2,6,a
mother,134629,135540,911,Brazil,B13,c,3,1,q
child,136100,136850,750,Brazil,B13,m,3,2,a
mother,136830,137370,540,Brazil,B13,c,3,3,q
child,138150,138924,774,Brazil,B13,m,3,4,a
mother,139330,139630,300,Brazil,B13,m,3,5,q
child,139820,140260,440,Brazil,B13,m,3,6,a
mother,141850,142756,906,Brazil,B13,c,3,7,i
child,143240,143780,540,Brazil,B13,m,3,8,a
mother,152680,153480,800,Brazil,B13,c,3,9,q
child,153770,154300,530,Brazil,B13,m,3,10,a
child,156140,158400,2260,Brazil,B13,f,3,11,a
father,157863,164430,6567,Brazil,B13,c,3,12,a
child,166430,167110,680,Brazil,B13,f,3,13,a
father,167710,168353,643,Brazil,B13,c,3,14,a
mother,168393,168872,479,Brazil,B13,f,3,15,a
child,168775,169410,635,Brazil,B13,f,3,16,q
mother,169336,170280,944,Brazil,B13,f,3,17,a
father,170212,170910,698,Brazil,B13,c,3,18,a
child,171620,173530,1910,Brazil,B13,f,3,19,a
father,173073,176210,3137,Brazil,B13,c,3,20,a
mother,175510,176324,814,Brazil,B13,c,3,21,i
child,177153,179180,2027,Brazil,B13,f,3,22,a
father,178870,181546,2676,Brazil,B13,c,3,23,i
father,186835,189070,2235,Brazil,B13,c,3,24,a
father,193300,196140,2840,Brazil,B13,c,3,25,a
father,200040,200870,830,Brazil,B13,c,3,26,a
child,200270,201292,1022,Brazil,B13,f,3,27,a
father,201456,202424,968,Brazil,B13,c,3,28,a
child,204930,206738,1808,Brazil,B13,f,3,29,a
mother,206212,207377,1165,Brazil,B13,c,3,30,a
mother,209730,211940,2210,Brazil,B13,c,3,31,a
child,212411,212966,555,Brazil,B13,m,3,32,q
mother,213129,213870,741,Brazil,B13,c,3,33,q
child,219360,220250,890,Brazil,B13,m,3,34,a
mother,221450,227120,5670,Brazil,B13,c,3,35,a
child,226910,228870,1960,Brazil,B13,f,3,36,a
father,229490,230325,835,Brazil,B13,c,3,37,a
mother,231607,232513,906,Brazil,B13,c,3,38,i
father,231680,233106,1426,Brazil,B13,c,3,39,a
child,234260,234710,450,Brazil,B13,f,3,40,NA
father,235370,236348,978,Brazil,B13,c,3,41,a
child,236340,236740,400,Brazil,B13,f,3,42,a
mother,238150,239900,1750,Brazil,B13,c,3,43,i
father,241455,243510,2055,Brazil,B13,m,3,44,a
child,243530,244022,492,Brazil,B13,b,3,45,a
mother,244660,245250,590,Brazil,B13,f,3,46,a
mother,248780,250930,2150,Brazil,B13,c,3,47,q
child,252140,254969,2829,Brazil,B13,b,3,48,a
mother,254160,255070,910,Brazil,B13,c,3,49,a
child,256040,256940,900,Brazil,B13,m,3,50,a
mother,257170,258430,1260,Brazil,B13,c,3,51,a
mother,263010,270960,7950,Brazil,B13,c,3,52,a
father,274226,275686,1460,Brazil,B13,c,3,53,a
child,290467,291740,1273,Brazil,B13,f,4,1,a
father,291698,292810,1112,Brazil,B13,c,4,2,a
child,293290,293642,352,Brazil,B13,f,4,3,a
father,294160,295600,1440,Brazil,B13,c,4,4,a
child,295590,295940,350,Brazil,B13,f,4,5,q
mother,300990,302230,1240,Brazil,B13,f,4,6,a
child,302250,302680,430,Brazil,B13,b,4,7,a
father,303064,306410,3346,Brazil,B13,m,4,8,q
father,315730,316950,1220,Brazil,B13,c,4,9,a
child,317940,318797,857,Brazil,B13,f,4,10,a
father,319370,320630,1260,Brazil,B13,c,4,11,a
father,323422,326724,3302,Brazil,B13,c,4,12,a
child,325210,326010,800,Brazil,B13,f,4,13,a
father,331850,332850,1000,Brazil,B13,c,4,14,a
mother,332842,333602,760,Brazil,B13,c,4,15,a
father,335370,336154,784,Brazil,B13,c,4,16,a
mother,337818,338480,662,Brazil,B13,c,4,17,a
father,338060,340110,2050,Brazil,B13,c,4,18,a
child,338109,338636,527,Brazil,B13,b,4,19,a
mother,340110,343230,3120,Brazil,B13,c,4,20,i
father,344317,346000,1683,Brazil,B13,m,4,21,q
mother,347520,348520,1000,Brazil,B13,f,4,22,a
mother,350870,352120,1250,Brazil,B13,f,4,23,a
father,356710,357850,1140,Brazil,B13,c,4,24,a
mother,358370,359110,740,Brazil,B13,c,4,25,a
father,359060,360230,1170,Brazil,B13,c,4,26,a
mother,360674,361133,459,Brazil,B13,c,4,27,a
father,361646,363553,1907,Brazil,B13,c,4,28,a
child,364000,364990,990,Brazil,B13,f,4,29,a
father,365606,366682,1076,Brazil,B13,c,4,30,i
child,366755,367334,579,Brazil,B13,f,4,31,a
father,373420,373940,520,Brazil,B13,c,4,32,a
mother,374631,374923,292,Brazil,B13,b,4,33,a
mother,383110,386170,3060,Brazil,B13,c,4,34,a
mother,391060,391750,690,Brazil,B13,c,4,35,a
child,391759,392649,890,Brazil,B13,m,4,36,a
child,404420,405243,823,Brazil,B13,b,4,37,q
mother,399550,403260,3710,Brazil,B13,f,5,1,a
child,416200,416580,380,Brazil,B13,b,6,1,q
father,433380,434970,1590,Brazil,B13,m,7,1,a
mother,439410,440914,1504,Brazil,B13,f,7,2,q
child,440820,447210,6390,Brazil,B13,b,7,3,a
father,443610,446320,2710,Brazil,B13,m,7,4,q
mother,447484,457710,10226,Brazil,B13,f,7,5,a
father,461297,461714,417,Brazil,B13,c,7,6,a
child,462960,463435,475,Brazil,B13,f,7,7,a
father,463543,466020,2477,Brazil,B13,c,7,8,a
child,466150,466720,570,Brazil,B13,f,7,9,a
child,470565,471973,1408,Brazil,B13,f,7,10,a
father,471754,473284,1530,Brazil,B13,c,7,11,a
child,472882,473600,718,Brazil,B13,f,7,12,a
father,474062,475161,1099,Brazil,B13,c,7,13,a
mother,479450,480420,970,Brazil,B13,f,7,14,i
father,480265,481870,1605,Brazil,B13,m,7,15,a
mother,481472,482998,1526,Brazil,B13,NA,7,16,NA
child,483160,492100,8940,Brazil,B13,o,7,17,a
father,491421,492760,1339,Brazil,B13,c,7,18,a
child,493491,501710,8219,Brazil,B13,o,7,19,a
father,499410,503390,3980,Brazil,B13,c,7,20,a
child,503130,503520,390,Brazil,B13,f,7,21,a
father,504310,505073,763,Brazil,B13,c,7,22,a
child,505104,507560,2456,Brazil,B13,f,7,23,a
father,506830,507600,770,Brazil,B13,c,7,24,a
child,508930,511510,2580,Brazil,B13,f,7,25,a
father,512367,513419,1052,Brazil,B13,c,7,26,a
child,515950,516606,656,Brazil,B13,f,7,27,a
father,516260,517800,1540,Brazil,B13,c,7,28,a
mother,522280,525140,2860,Brazil,B13,c,7,29,a
child,525550,527270,1720,Brazil,B13,m,7,30,a
mother,525796,532100,6304,Brazil,B13,f,8,1,a
father,532160,532520,360,Brazil,B13,m,8,2,a
father,535420,535960,540,Brazil,B13,m,8,3,q
mother,537512,542990,5478,Brazil,B13,f,8,4,a
child,545257,549110,3853,Brazil,B13,b,8,5,a
mother,549770,551081,1311,Brazil,B13,c,8,6,a
child,551200,551540,340,Brazil,B13,c,8,7,q
mother,551574,554770,3196,Brazil,B13,c,8,8,i
child,555185,556920,1735,Brazil,B13,f,8,9,a
father,556834,557800,966,Brazil,B13,c,8,10,a
child,558438,558775,337,Brazil,B13,f,8,11,a
mother,559095,560369,1274,Brazil,B13,c,8,12,i
child,560580,561168,588,Brazil,B13,m,8,13,q
mother,561210,562430,1220,Brazil,B13,c,8,14,i
child,562440,562920,480,Brazil,B13,m,8,15,q
mother,563036,565003,1967,Brazil,B13,c,8,16,i
child,564989,565558,569,Brazil,B13,m,8,17,q
mother,565594,569300,3706,Brazil,B13,c,8,18,a
father,569950,571131,1181,Brazil,B13,c,8,19,a
mother,570699,574050,3351,Brazil,B13,f,8,20,a
child,575860,576250,390,Brazil,B13,m,8,21,q
mother,576472,577551,1079,Brazil,B13,c,8,22,a
mother,581130,582111,981,Brazil,B13,c,8,23,q
child,582156,582594,438,Brazil,B13,m,8,24,q
mother,582648,585240,2592,Brazil,B13,c,8,25,q
child,585386,587510,2124,Brazil,B13,f,8,26,a
mother,586862,589400,2538,Brazil,B13,c,8,27,a
mother,593530,594010,480,Brazil,B13,c,8,28,q
child,542765,543241,476,Brazil,B13,b,9,1,a
silence,580,958,378,Brazil,B13,NA,NA,NA,NA
silence,2457,3650,1193,Brazil,B13,NA,NA,NA,NA
mother_gesture,3778,4075,297,Brazil,B13,NA,NA,NA,NA
silence,4686,7510,2824,Brazil,B13,NA,NA,NA,NA
silence,7950,8380,430,Brazil,B13,NA,NA,NA,NA
silence,11880,15700,3820,Brazil,B13,NA,NA,NA,NA
silence,19064,21660,2596,Brazil,B13,NA,NA,NA,NA
silence,22980,25260,2280,Brazil,B13,NA,NA,NA,NA
silence,26340,26830,490,Brazil,B13,NA,NA,NA,NA
silence,31350,31930,580,Brazil,B13,NA,NA,NA,NA
silence,33720,35830,2110,Brazil,B13,NA,NA,NA,NA
silence,37040,37446,406,Brazil,B13,NA,NA,NA,NA
silence,40855,41023,168,Brazil,B13,NA,NA,NA,NA
silence,41477,41533,56,Brazil,B13,NA,NA,NA,NA
silence,49292,55560,6268,Brazil,B13,NA,NA,NA,NA
mother_gesture,58408,59473,1065,Brazil,B13,NA,NA,NA,NA
silence,60610,63880,3270,Brazil,B13,NA,NA,NA,NA
silence,65100,67340,2240,Brazil,B13,NA,NA,NA,NA
silence,68430,69674,1244,Brazil,B13,NA,NA,NA,NA
silence,77420,78220,800,Brazil,B13,NA,NA,NA,NA
silence,79720,79911,191,Brazil,B13,NA,NA,NA,NA
child_gesture,80960,81950,990,Brazil,B13,NA,NA,NA,NA
silence,83608,83910,302,Brazil,B13,NA,NA,NA,NA
silence,84630,85450,820,Brazil,B13,NA,NA,NA,NA
silence,86427,87560,1133,Brazil,B13,NA,NA,NA,NA
silence,88055,93980,5925,Brazil,B13,NA,NA,NA,NA
silence,94530,115320,20790,Brazil,B13,NA,NA,NA,NA
silence,119270,121430,2160,Brazil,B13,NA,NA,NA,NA
silence,126970,129870,2900,Brazil,B13,NA,NA,NA,NA
silence,131278,131410,132,Brazil,B13,NA,NA,NA,NA
silence,131708,132055,347,Brazil,B13,NA,NA,NA,NA
silence,135540,136100,560,Brazil,B13,NA,NA,NA,NA
silence,137370,138150,780,Brazil,B13,NA,NA,NA,NA
child_gesture,138088,138933,845,Brazil,B13,NA,NA,NA,NA
silence,138924,139330,406,Brazil,B13,NA,NA,NA,NA
silence,139630,139820,190,Brazil,B13,NA,NA,NA,NA
silence,140260,141850,1590,Brazil,B13,NA,NA,NA,NA
mother_gesture,142469,143150,681,Brazil,B13,NA,NA,NA,NA
silence,142756,143240,484,Brazil,B13,NA,NA,NA,NA
silence,143780,152680,8900,Brazil,B13,NA,NA,NA,NA
silence,153480,153770,290,Brazil,B13,NA,NA,NA,NA
silence,154300,156140,1840,Brazil,B13,NA,NA,NA,NA
silence,164430,166430,2000,Brazil,B13,NA,NA,NA,NA
silence,167110,167710,600,Brazil,B13,NA,NA,NA,NA
silence,168353,168393,40,Brazil,B13,NA,NA,NA,NA
silence,170910,171620,710,Brazil,B13,NA,NA,NA,NA
silence,176324,177153,829,Brazil,B13,NA,NA,NA,NA
silence,181546,186835,5289,Brazil,B13,NA,NA,NA,NA
silence,189070,193300,4230,Brazil,B13,NA,NA,NA,NA
silence,196140,200040,3900,Brazil,B13,NA,NA,NA,NA
silence,201292,201456,164,Brazil,B13,NA,NA,NA,NA
silence,202424,204930,2506,Brazil,B13,NA,NA,NA,NA
silence,207377,209730,2353,Brazil,B13,NA,NA,NA,NA
silence,211940,212411,471,Brazil,B13,NA,NA,NA,NA
silence,212966,213129,163,Brazil,B13,NA,NA,NA,NA
silence,213870,219360,5490,Brazil,B13,NA,NA,NA,NA
silence,220250,221450,1200,Brazil,B13,NA,NA,NA,NA
silence,228870,229490,620,Brazil,B13,NA,NA,NA,NA
silence,230325,231607,1282,Brazil,B13,NA,NA,NA,NA
silence,233106,234260,1154,Brazil,B13,NA,NA,NA,NA
silence,234710,235370,660,Brazil,B13,NA,NA,NA,NA
silence,236740,238150,1410,Brazil,B13,NA,NA,NA,NA
silence,239900,241455,1555,Brazil,B13,NA,NA,NA,NA
silence,243510,243530,20,Brazil,B13,NA,NA,NA,NA
silence,244022,244660,638,Brazil,B13,NA,NA,NA,NA
silence,245250,248780,3530,Brazil,B13,NA,NA,NA,NA
silence,250930,252140,1210,Brazil,B13,NA,NA,NA,NA
silence,255070,256040,970,Brazil,B13,NA,NA,NA,NA
silence,256940,257170,230,Brazil,B13,NA,NA,NA,NA
silence,258430,263010,4580,Brazil,B13,NA,NA,NA,NA
silence,270960,274226,3266,Brazil,B13,NA,NA,NA,NA
silence,275686,290467,14781,Brazil,B13,NA,NA,NA,NA
child_gesture,290395,291875,1480,Brazil,B13,NA,NA,NA,NA
silence,292810,293290,480,Brazil,B13,NA,NA,NA,NA
silence,293642,294160,518,Brazil,B13,NA,NA,NA,NA
silence,295940,300990,5050,Brazil,B13,NA,NA,NA,NA
silence,302230,302250,20,Brazil,B13,NA,NA,NA,NA
silence,302680,303064,384,Brazil,B13,NA,NA,NA,NA
silence,306410,315730,9320,Brazil,B13,NA,NA,NA,NA
silence,316950,317940,990,Brazil,B13,NA,NA,NA,NA
silence,318797,319370,573,Brazil,B13,NA,NA,NA,NA
silence,320630,323422,2792,Brazil,B13,NA,NA,NA,NA
silence,326724,331850,5126,Brazil,B13,NA,NA,NA,NA
silence,333602,335370,1768,Brazil,B13,NA,NA,NA,NA
silence,336154,337818,1664,Brazil,B13,NA,NA,NA,NA
silence,343230,344317,1087,Brazil,B13,NA,NA,NA,NA
silence,346000,347520,1520,Brazil,B13,NA,NA,NA,NA
silence,348520,350870,2350,Brazil,B13,NA,NA,NA,NA
silence,352120,356710,4590,Brazil,B13,NA,NA,NA,NA
silence,357850,358370,520,Brazil,B13,NA,NA,NA,NA
silence,360230,360674,444,Brazil,B13,NA,NA,NA,NA
silence,361133,361646,513,Brazil,B13,NA,NA,NA,NA
silence,363553,364000,447,Brazil,B13,NA,NA,NA,NA
silence,364990,365606,616,Brazil,B13,NA,NA,NA,NA
silence,366682,366755,73,Brazil,B13,NA,NA,NA,NA
silence,367334,373420,6086,Brazil,B13,NA,NA,NA,NA
silence,373940,374631,691,Brazil,B13,NA,NA,NA,NA
silence,374923,383110,8187,Brazil,B13,NA,NA,NA,NA
silence,386170,391060,4890,Brazil,B13,NA,NA,NA,NA
silence,391750,391759,9,Brazil,B13,NA,NA,NA,NA
silence,392649,399550,6901,Brazil,B13,NA,NA,NA,NA
silence,403260,404420,1160,Brazil,B13,NA,NA,NA,NA
silence,405243,416200,10957,Brazil,B13,NA,NA,NA,NA
silence,416580,433380,16800,Brazil,B13,NA,NA,NA,NA
silence,434970,439410,4440,Brazil,B13,NA,NA,NA,NA
silence,447210,447484,274,Brazil,B13,NA,NA,NA,NA
silence,457710,461297,3587,Brazil,B13,NA,NA,NA,NA
silence,461714,462960,1246,Brazil,B13,NA,NA,NA,NA
silence,463435,463543,108,Brazil,B13,NA,NA,NA,NA
silence,466020,466150,130,Brazil,B13,NA,NA,NA,NA
silence,466720,470565,3845,Brazil,B13,NA,NA,NA,NA
silence,473600,474062,462,Brazil,B13,NA,NA,NA,NA
silence,475161,479450,4289,Brazil,B13,NA,NA,NA,NA
silence,482998,483160,162,Brazil,B13,NA,NA,NA,NA
silence,492760,493491,731,Brazil,B13,NA,NA,NA,NA
silence,503520,504310,790,Brazil,B13,NA,NA,NA,NA
silence,505073,505104,31,Brazil,B13,NA,NA,NA,NA
silence,507600,508930,1330,Brazil,B13,NA,NA,NA,NA
silence,511510,512367,857,Brazil,B13,NA,NA,NA,NA
silence,513419,515950,2531,Brazil,B13,NA,NA,NA,NA
silence,517800,522280,4480,Brazil,B13,NA,NA,NA,NA
silence,525140,525550,410,Brazil,B13,NA,NA,NA,NA
silence,532100,532160,60,Brazil,B13,NA,NA,NA,NA
silence,532520,535420,2900,Brazil,B13,NA,NA,NA,NA
silence,535960,537512,1552,Brazil,B13,NA,NA,NA,NA
silence,543241,545257,2016,Brazil,B13,NA,NA,NA,NA
silence,549110,549770,660,Brazil,B13,NA,NA,NA,NA
silence,551081,551200,119,Brazil,B13,NA,NA,NA,NA
silence,551540,551574,34,Brazil,B13,NA,NA,NA,NA
silence,554770,555185,415,Brazil,B13,NA,NA,NA,NA
silence,557800,558438,638,Brazil,B13,NA,NA,NA,NA
silence,558775,559095,320,Brazil,B13,NA,NA,NA,NA
silence,560369,560580,211,Brazil,B13,NA,NA,NA,NA
silence,561168,561210,42,Brazil,B13,NA,NA,NA,NA
silence,562430,562440,10,Brazil,B13,NA,NA,NA,NA
silence,562920,563036,116,Brazil,B13,NA,NA,NA,NA
silence,565558,565594,36,Brazil,B13,NA,NA,NA,NA
silence,569300,569950,650,Brazil,B13,NA,NA,NA,NA
silence,574050,575860,1810,Brazil,B13,NA,NA,NA,NA
silence,576250,576472,222,Brazil,B13,NA,NA,NA,NA
silence,577551,581130,3579,Brazil,B13,NA,NA,NA,NA
silence,582111,582156,45,Brazil,B13,NA,NA,NA,NA
silence,582594,582648,54,Brazil,B13,NA,NA,NA,NA
silence,585240,585386,146,Brazil,B13,NA,NA,NA,NA
child_gesture,585895,586918,1023,Brazil,B13,NA,NA,NA,NA
silence,589400,593530,4130,Brazil,B13,NA,NA,NA,NA
father,205,2055,1850,Brazil,B14,c,1,1,q
child,2260,2820,560,Brazil,B14,f,1,2,q
father,3280,5890,2610,Brazil,B14,c,1,3,a
child,5600,6073,473,Brazil,B14,f,1,4,q
mother,5796,6572,776,Brazil,B14,c,1,5,a
child,6950,7530,580,Brazil,B14,f,1,6,q
father,6960,7590,630,Brazil,B14,c,1,7,q
father,8720,9250,530,Brazil,B14,c,1,8,q
child,8860,11400,2540,Brazil,B14,f,1,9,a
father,11260,11970,710,Brazil,B14,c,1,10,a
child,14711,16285,1574,Brazil,B14,f,1,11,q
father,17280,18674,1394,Brazil,B14,c,1,12,a
child,21650,22550,900,Brazil,B14,f,1,13,a
father,22042,22871,829,Brazil,B14,c,1,14,a
child,24173,34240,10067,Brazil,B14,f,1,15,a
father,34200,34890,690,Brazil,B14,c,1,16,a
child,35020,35650,630,Brazil,B14,f,1,17,a
mother,35370,36130,760,Brazil,B14,c,1,18,a
child,35976,37880,1904,Brazil,B14,m,1,19,a
mother,37581,38152,571,Brazil,B14,c,1,20,i
child,40180,40850,670,Brazil,B14,m,1,21,a
child,45440,45946,506,Brazil,B14,f,1,22,a
mother,45864,46781,917,Brazil,B14,c,1,23,q
child,49230,49680,450,Brazil,B14,f,1,24,a
child,52985,55021,2036,Brazil,B14,f,1,25,a
father,54850,55550,700,Brazil,B14,c,1,26,q
child,55582,56174,592,Brazil,B14,f,1,27,a
father,56328,56903,575,Brazil,B14,c,1,28,q
father,67700,69440,1740,Brazil,B14,o,2,1,a
child,72970,73935,965,Brazil,B14,b,2,2,a
mother,74561,75284,723,Brazil,B14,c,2,3,a
child,75790,76720,930,Brazil,B14,m,2,4,a
mother,76644,77166,522,Brazil,B14,c,2,5,q
father,76705,77330,625,Brazil,B14,c,2,6,q
child,79301,79701,400,Brazil,B14,m,2,7,a
father,82190,85960,3770,Brazil,B14,b,3,1,a
mother,95630,96120,490,Brazil,B14,c,3,2,i
mother,99990,100800,810,Brazil,B14,c,3,3,a
mother,102340,103220,880,Brazil,B14,c,3,4,a
child,101396,101862,466,Brazil,B14,m,4,1,a
father,103773,104567,794,Brazil,B14,m,4,2,i
mother,104413,105262,849,Brazil,B14,f,4,3,q
father,105590,106000,410,Brazil,B14,m,4,4,q
father,108328,112810,4482,Brazil,B14,c,4,5,q
child,112616,114900,2284,Brazil,B14,f,4,6,a
mother,120686,121817,1131,Brazil,B14,c,4,7,a
child,122780,127430,4650,Brazil,B14,m,4,8,a
mother,123904,124696,792,Brazil,B14,c,4,9,a
mother,126751,128141,1390,Brazil,B14,c,4,10,a
child,128601,129257,656,Brazil,B14,m,4,11,q
mother,129365,130207,842,Brazil,B14,c,4,12,a
father,129520,130270,750,Brazil,B14,c,4,13,a
mother,130950,131470,520,Brazil,B14,c,4,14,a
father,131084,132420,1336,Brazil,B14,c,4,15,a
mother,132240,132710,470,Brazil,B14,c,4,16,a
father,133260,136212,2952,Brazil,B14,c,4,17,a
child,136220,136770,550,Brazil,B14,f,4,18,a
child,139030,139870,840,Brazil,B14,f,4,19,a
father,140080,142275,2195,Brazil,B14,c,4,20,a
child,143606,148050,4444,Brazil,B14,f,5,1,a
father,147607,148708,1101,Brazil,B14,c,5,2,a
child,148930,149300,370,Brazil,B14,f,5,3,q
father,149230,150170,940,Brazil,B14,c,5,4,a
child,150501,152420,1919,Brazil,B14,f,5,5,a
father,152610,153470,860,Brazil,B14,m,5,6,a
child,154821,161510,6689,Brazil,B14,m,5,7,a
father,160710,162308,1598,Brazil,B14,m,5,8,a
child,183080,185160,2080,Brazil,B14,f,6,1,q
mother,187561,190130,2569,Brazil,B14,c,6,2,i
child,189357,191370,2013,Brazil,B14,b,6,3,a
father,199400,201060,1660,Brazil,B14,o,7,1,a
child,211350,214937,3587,Brazil,B14,f,8,1,a
father,214755,215728,973,Brazil,B14,c,8,2,q
child,215506,215952,446,Brazil,B14,f,8,3,a
father,216910,217670,760,Brazil,B14,c,8,4,q
child,217567,220068,2501,Brazil,B14,f,8,5,a
father,220021,220537,516,Brazil,B14,c,8,6,q
child,220877,222500,1623,Brazil,B14,f,8,7,a
father,222425,222938,513,Brazil,B14,c,8,8,q
child,223163,225354,2191,Brazil,B14,f,8,9,q
father,224960,226200,1240,Brazil,B14,c,8,10,i
mother,225140,227137,1997,Brazil,B14,c,8,11,i
father,226920,228020,1100,Brazil,B14,c,8,12,i
child,228070,228570,500,Brazil,B14,f,8,13,a
father,228796,230159,1363,Brazil,B14,c,8,14,a
child,232380,233900,1520,Brazil,B14,f,8,15,a
father,243533,244365,832,Brazil,B14,c,8,16,q
father,247177,249010,1833,Brazil,B14,c,8,17,a
father,255980,256830,850,Brazil,B14,c,8,18,q
child,261320,262516,1196,Brazil,B14,f,8,19,a
father,263530,265000,1470,Brazil,B14,c,8,20,q
child,264680,265330,650,Brazil,B14,f,8,21,a
father,266450,268170,1720,Brazil,B14,c,8,22,a
child,270230,271100,870,Brazil,B14,f,8,23,a
father,270830,271620,790,Brazil,B14,c,8,24,a
child,272190,273494,1304,Brazil,B14,f,8,25,a
mother,273690,274102,412,Brazil,B14,c,8,26,a
child,274417,275579,1162,Brazil,B14,f,8,27,a
father,275510,276510,1000,Brazil,B14,c,8,28,a
mother,276222,278907,2685,Brazil,B14,c,8,29,a
child,276626,278930,2304,Brazil,B14,m,8,30,a
father,278780,279530,750,Brazil,B14,c,8,31,i
mother,279260,279770,510,Brazil,B14,c,8,32,a
father,280077,283600,3523,Brazil,B14,c,8,33,a
child,287980,288640,660,Brazil,B14,f,8,34,a
father,289200,291420,2220,Brazil,B14,c,8,35,i
father,294620,295680,1060,Brazil,B14,c,8,36,q
child,295960,296521,561,Brazil,B14,f,8,37,a
mother,296320,297070,750,Brazil,B14,f,8,38,a
father,296860,297450,590,Brazil,B14,c,8,39,a
child,297920,298610,690,Brazil,B14,f,8,40,a
father,298550,299280,730,Brazil,B14,c,8,41,a
father,309990,311360,1370,Brazil,B14,c,9,1,i
mother,310180,311520,1340,Brazil,B14,c,9,2,i
father,315702,316419,717,Brazil,B14,c,9,3,a
child,322920,326570,3650,Brazil,B14,f,9,4,a
father,326560,327290,730,Brazil,B14,c,9,5,a
child,328860,330070,1210,Brazil,B14,f,9,6,a
father,330170,331660,1490,Brazil,B14,c,9,7,a
mother,332590,333921,1331,Brazil,B14,c,9,8,a
child,332710,333600,890,Brazil,B14,f,9,9,a
father,334880,335877,997,Brazil,B14,c,9,10,a
father,337232,338534,1302,Brazil,B14,c,9,11,a
child,337416,339430,2014,Brazil,B14,m,9,12,a
mother,337880,340421,2541,Brazil,B14,c,9,13,a
father,339330,349720,10390,Brazil,B14,c,9,14,q
father,353990,355718,1728,Brazil,B14,m,10,1,a
mother,357340,357901,561,Brazil,B14,f,10,2,a
father,357390,357980,590,Brazil,B14,m,10,3,a
mother,359620,360390,770,Brazil,B14,f,10,4,q
father,360220,362440,2220,Brazil,B14,m,10,5,i
mother,363860,364568,708,Brazil,B14,f,10,6,a
father,364510,367500,2990,Brazil,B14,m,10,7,i
mother,367504,368652,1148,Brazil,B14,f,10,8,a
father,369460,370757,1297,Brazil,B14,m,10,9,a
mother,371280,371980,700,Brazil,B14,f,10,10,a
father,372573,373559,986,Brazil,B14,m,10,11,a
child,376330,377939,1609,Brazil,B14,f,11,1,q
father,378950,381260,2310,Brazil,B14,c,11,2,a
child,381582,382341,759,Brazil,B14,f,11,3,q
father,383890,386800,2910,Brazil,B14,c,11,4,i
child,386630,387310,680,Brazil,B14,f,11,5,a
father,388423,388937,514,Brazil,B14,c,12,1,i
child,389510,390080,570,Brazil,B14,f,12,2,a
mother,391180,392210,1030,Brazil,B14,c,12,3,a
child,392049,393050,1001,Brazil,B14,m,12,4,a
mother,393260,396120,2860,Brazil,B14,c,12,5,a
father,395860,399920,4060,Brazil,B14,c,12,6,a
mother,398461,399103,642,Brazil,B14,c,12,7,i
father,400988,401982,994,Brazil,B14,c,12,8,q
child,401486,403500,2014,Brazil,B14,f,12,9,a
father,403386,404281,895,Brazil,B14,c,12,10,q
mother,404250,404930,680,Brazil,B14,b,12,11,a
father,404880,408710,3830,Brazil,B14,c,12,12,a
child,408010,410550,2540,Brazil,B14,f,12,13,a
father,411429,413350,1921,Brazil,B14,c,12,14,a
mother,411990,413579,1589,Brazil,B14,c,12,15,a
child,413800,418000,4200,Brazil,B14,f,12,16,a
father,414640,419780,5140,Brazil,B14,c,12,17,q
child,419531,420212,681,Brazil,B14,f,12,18,a
father,421830,422540,710,Brazil,B14,c,12,19,q
child,422870,425139,2269,Brazil,B14,f,12,20,a
father,424508,425376,868,Brazil,B14,c,12,21,q
child,425397,427505,2108,Brazil,B14,f,12,22,a
father,427260,430280,3020,Brazil,B14,c,12,23,q
child,430759,437570,6811,Brazil,B14,f,12,24,a
father,431300,438290,6990,Brazil,B14,c,12,25,q
child,438413,439136,723,Brazil,B14,f,12,26,a
father,439210,441460,2250,Brazil,B14,c,12,27,a
child,442009,442626,617,Brazil,B14,f,12,28,q
father,442540,445810,3270,Brazil,B14,c,12,29,a
child,443620,444200,580,Brazil,B14,f,12,30,q
child,446328,446780,452,Brazil,B14,f,12,31,a
father,450330,451730,1400,Brazil,B14,c,12,32,q
child,451883,452529,646,Brazil,B14,f,12,33,a
father,452857,456370,3513,Brazil,B14,c,12,34,a
child,456610,457440,830,Brazil,B14,f,12,35,q
father,457683,461110,3427,Brazil,B14,c,12,36,a
child,461500,463540,2040,Brazil,B14,f,12,37,a
father,463694,464838,1144,Brazil,B14,c,12,38,q
child,464510,465060,550,Brazil,B14,f,12,39,a
father,465270,466730,1460,Brazil,B14,c,12,40,a
child,466974,467718,744,Brazil,B14,f,12,41,a
father,467580,468866,1286,Brazil,B14,c,12,42,a
child,468880,469445,565,Brazil,B14,f,12,43,q
father,469598,470478,880,Brazil,B14,c,12,44,a
child,470449,472990,2541,Brazil,B14,f,12,45,a
father,473050,473630,580,Brazil,B14,c,12,46,a
child,476967,477950,983,Brazil,B14,m,12,47,a
child,481486,482889,1403,Brazil,B14,m,12,48,a
mother,482250,482920,670,Brazil,B14,c,12,49,a
child,487620,490040,2420,Brazil,B14,m,12,50,a
father,489400,490230,830,Brazil,B14,c,12,51,q
child,495367,497323,1956,Brazil,B14,f,12,52,a
father,496818,497330,512,Brazil,B14,c,12,53,q
child,497630,498120,490,Brazil,B14,f,12,54,a
father,497837,501300,3463,Brazil,B14,c,12,55,a
child,501774,502241,467,Brazil,B14,f,12,56,a
father,502355,504097,1742,Brazil,B14,c,12,57,a
child,504450,505080,630,Brazil,B14,f,12,58,a
father,505480,506381,901,Brazil,B14,c,12,59,i
child,508000,508750,750,Brazil,B14,f,12,60,i
father,510870,511946,1076,Brazil,B14,c,12,61,q
child,511915,514380,2465,Brazil,B14,f,12,62,a
father,513280,514325,1045,Brazil,B14,c,12,63,q
child,514710,515720,1010,Brazil,B14,f,12,64,a
father,515650,516110,460,Brazil,B14,c,12,65,q
child,516670,517327,657,Brazil,B14,f,12,66,a
child,520570,523220,2650,Brazil,B14,f,12,67,a
father,523560,525159,1599,Brazil,B14,c,12,68,q
child,524638,527500,2862,Brazil,B14,f,12,69,a
father,527530,529314,1784,Brazil,B14,c,12,70,a
child,529331,531476,2145,Brazil,B14,f,12,71,a
father,531330,535340,4010,Brazil,B14,c,12,72,a
mother,536110,537301,1191,Brazil,B14,c,12,73,a
father,537034,538793,1759,Brazil,B14,c,12,74,a
child,538591,539955,1364,Brazil,B14,f,12,75,a
mother,538963,539838,875,Brazil,B14,c,12,76,a
father,539945,540342,397,Brazil,B14,c,12,77,q
mother,541080,543270,2190,Brazil,B14,c,12,78,a
father,542370,543847,1477,Brazil,B14,c,12,79,a
child,544077,544795,718,Brazil,B14,f,12,80,a
father,544702,545829,1127,Brazil,B14,c,12,81,a
child,546210,547640,1430,Brazil,B14,f,12,82,a
father,548261,552350,4089,Brazil,B14,c,12,83,a
child,551270,553190,1920,Brazil,B14,f,12,84,a
father,555410,556220,810,Brazil,B14,c,12,85,a
child,557130,557455,325,Brazil,B14,f,12,86,a
father,559708,561270,1562,Brazil,B14,c,12,87,a
father,563667,564219,552,Brazil,B14,c,12,88,a
child,564650,565170,520,Brazil,B14,f,12,89,a
father,565540,567040,1500,Brazil,B14,c,12,90,a
child,567410,572000,4590,Brazil,B14,f,12,91,a
child,573870,576097,2227,Brazil,B14,f,12,92,a
father,571789,573619,1830,Brazil,B14,c,13,1,a
father,576259,580310,4051,Brazil,B14,c,13,2,q
child,580594,582186,1592,Brazil,B14,c,13,3,a
father,581311,582488,1177,Brazil,B14,NA,13,4,q
child,583100,584080,980,Brazil,B14,c,13,5,a
father,583234,592310,9076,Brazil,B14,c,13,6,a
father,594540,596028,1488,Brazil,B14,c,13,7,q
child,596330,597050,720,Brazil,B14,f,13,8,a
father,597210,598110,900,Brazil,B14,c,13,9,q
child,597439,598790,1351,Brazil,B14,f,13,10,a
silence,2055,2260,205,Brazil,B14,NA,NA,NA,NA
child_gesture,2110,4360,2250,Brazil,B14,NA,NA,NA,NA
silence,2820,3280,460,Brazil,B14,NA,NA,NA,NA
child_gesture,5273,6156,883,Brazil,B14,NA,NA,NA,NA
silence,6572,6950,378,Brazil,B14,NA,NA,NA,NA
father_gesture,7348,8857,1509,Brazil,B14,NA,NA,NA,NA
child_gesture,7560,9480,1920,Brazil,B14,NA,NA,NA,NA
silence,7590,8720,1130,Brazil,B14,NA,NA,NA,NA
silence,11970,14711,2741,Brazil,B14,NA,NA,NA,NA
silence,16285,17280,995,Brazil,B14,NA,NA,NA,NA
silence,18674,21650,2976,Brazil,B14,NA,NA,NA,NA
silence,22871,24173,1302,Brazil,B14,NA,NA,NA,NA
child_gesture,32137,35850,3713,Brazil,B14,NA,NA,NA,NA
father_gesture,34392,34689,297,Brazil,B14,NA,NA,NA,NA
silence,34890,35020,130,Brazil,B14,NA,NA,NA,NA
silence,38152,40180,2028,Brazil,B14,NA,NA,NA,NA
silence,40850,45440,4590,Brazil,B14,NA,NA,NA,NA
child_gesture,45745,47110,1365,Brazil,B14,NA,NA,NA,NA
father,45948,48370,2422,Brazil,B14,c,NA,NA,q
father_gesture,47547,48009,462,Brazil,B14,NA,NA,NA,NA
silence,48370,49230,860,Brazil,B14,NA,NA,NA,NA
child_gesture,49650,50850,1200,Brazil,B14,NA,NA,NA,NA
silence,49680,52985,3305,Brazil,B14,NA,NA,NA,NA
child_gesture,53284,56742,3458,Brazil,B14,NA,NA,NA,NA
silence,55550,55582,32,Brazil,B14,NA,NA,NA,NA
silence,56174,56328,154,Brazil,B14,NA,NA,NA,NA
silence,56903,67700,10797,Brazil,B14,NA,NA,NA,NA
silence,69440,72970,3530,Brazil,B14,NA,NA,NA,NA
silence,73935,74561,626,Brazil,B14,NA,NA,NA,NA
silence,75284,75790,506,Brazil,B14,NA,NA,NA,NA
child_gesture,76069,76818,749,Brazil,B14,NA,NA,NA,NA
silence,77330,79301,1971,Brazil,B14,NA,NA,NA,NA
child_gesture,77784,79024,1240,Brazil,B14,NA,NA,NA,NA
silence,79701,82190,2489,Brazil,B14,NA,NA,NA,NA
silence,85960,95630,9670,Brazil,B14,NA,NA,NA,NA
silence,96120,99990,3870,Brazil,B14,NA,NA,NA,NA
silence,100800,101396,596,Brazil,B14,NA,NA,NA,NA
silence,101862,102340,478,Brazil,B14,NA,NA,NA,NA
silence,103220,103773,553,Brazil,B14,NA,NA,NA,NA
silence,105262,105590,328,Brazil,B14,NA,NA,NA,NA
silence,106000,108328,2328,Brazil,B14,NA,NA,NA,NA
child_gesture,111628,113215,1587,Brazil,B14,NA,NA,NA,NA
father_gesture,112650,113190,540,Brazil,B14,NA,NA,NA,NA
child_gesture,114482,114897,415,Brazil,B14,NA,NA,NA,NA
silence,114900,120686,5786,Brazil,B14,NA,NA,NA,NA
silence,121817,122780,963,Brazil,B14,NA,NA,NA,NA
child_gesture,123935,127540,3605,Brazil,B14,NA,NA,NA,NA
mother_gesture,126881,127840,959,Brazil,B14,NA,NA,NA,NA
silence,128141,128601,460,Brazil,B14,NA,NA,NA,NA
child_gesture,128503,137110,8607,Brazil,B14,NA,NA,NA,NA
silence,129257,129365,108,Brazil,B14,NA,NA,NA,NA
father_gesture,129621,129919,298,Brazil,B14,NA,NA,NA,NA
mother_gesture,129667,130130,463,Brazil,B14,NA,NA,NA,NA
silence,130270,130950,680,Brazil,B14,NA,NA,NA,NA
mother_gesture,131090,131495,405,Brazil,B14,NA,NA,NA,NA
silence,132710,133260,550,Brazil,B14,NA,NA,NA,NA
silence,136212,136220,8,Brazil,B14,NA,NA,NA,NA
silence,136770,139030,2260,Brazil,B14,NA,NA,NA,NA
child_gesture,139460,142832,3372,Brazil,B14,NA,NA,NA,NA
silence,139870,140080,210,Brazil,B14,NA,NA,NA,NA
silence,142275,143606,1331,Brazil,B14,NA,NA,NA,NA
silence,148708,148930,222,Brazil,B14,NA,NA,NA,NA
silence,150170,150501,331,Brazil,B14,NA,NA,NA,NA
silence,152420,152610,190,Brazil,B14,NA,NA,NA,NA
silence,153470,154821,1351,Brazil,B14,NA,NA,NA,NA
child_gesture,158865,160944,2079,Brazil,B14,NA,NA,NA,NA
silence,162308,183080,20772,Brazil,B14,NA,NA,NA,NA
silence,185160,187561,2401,Brazil,B14,NA,NA,NA,NA
silence,191370,199400,8030,Brazil,B14,NA,NA,NA,NA
silence,201060,211350,10290,Brazil,B14,NA,NA,NA,NA
silence,215952,216910,958,Brazil,B14,NA,NA,NA,NA
silence,220537,220877,340,Brazil,B14,NA,NA,NA,NA
silence,222938,223163,225,Brazil,B14,NA,NA,NA,NA
silence,228020,228070,50,Brazil,B14,NA,NA,NA,NA
silence,228570,228796,226,Brazil,B14,NA,NA,NA,NA
silence,230159,232380,2221,Brazil,B14,NA,NA,NA,NA
silence,233900,243533,9633,Brazil,B14,NA,NA,NA,NA
silence,244365,247177,2812,Brazil,B14,NA,NA,NA,NA
silence,249010,255980,6970,Brazil,B14,NA,NA,NA,NA
silence,256830,261320,4490,Brazil,B14,NA,NA,NA,NA
silence,262516,263530,1014,Brazil,B14,NA,NA,NA,NA
child_gesture,263100,264690,1590,Brazil,B14,NA,NA,NA,NA
silence,265330,266450,1120,Brazil,B14,NA,NA,NA,NA
silence,268170,270230,2060,Brazil,B14,NA,NA,NA,NA
father_gesture,270973,271336,363,Brazil,B14,NA,NA,NA,NA
silence,271620,272190,570,Brazil,B14,NA,NA,NA,NA
silence,273494,273690,196,Brazil,B14,NA,NA,NA,NA
silence,274102,274417,315,Brazil,B14,NA,NA,NA,NA
silence,279770,280077,307,Brazil,B14,NA,NA,NA,NA
silence,283600,287980,4380,Brazil,B14,NA,NA,NA,NA
silence,288640,289200,560,Brazil,B14,NA,NA,NA,NA
silence,291420,294620,3200,Brazil,B14,NA,NA,NA,NA
silence,295680,295960,280,Brazil,B14,NA,NA,NA,NA
silence,297450,297920,470,Brazil,B14,NA,NA,NA,NA
silence,299280,309990,10710,Brazil,B14,NA,NA,NA,NA
silence,311520,315702,4182,Brazil,B14,NA,NA,NA,NA
silence,316419,322920,6501,Brazil,B14,NA,NA,NA,NA
child_gesture,325471,328060,2589,Brazil,B14,NA,NA,NA,NA
silence,327290,328860,1570,Brazil,B14,NA,NA,NA,NA
silence,330070,330170,100,Brazil,B14,NA,NA,NA,NA
father_gesture,331022,331566,544,Brazil,B14,NA,NA,NA,NA
silence,331660,332590,930,Brazil,B14,NA,NA,NA,NA
silence,333921,334880,959,Brazil,B14,NA,NA,NA,NA
silence,335877,337232,1355,Brazil,B14,NA,NA,NA,NA
silence,349720,353990,4270,Brazil,B14,NA,NA,NA,NA
silence,355718,357340,1622,Brazil,B14,NA,NA,NA,NA
silence,357980,359620,1640,Brazil,B14,NA,NA,NA,NA
silence,362440,363860,1420,Brazil,B14,NA,NA,NA,NA
father_gesture,363380,363979,599,Brazil,B14,NA,NA,NA,NA
father_gesture,364542,365110,568,Brazil,B14,NA,NA,NA,NA
silence,367500,367504,4,Brazil,B14,NA,NA,NA,NA
silence,368652,369460,808,Brazil,B14,NA,NA,NA,NA
silence,370757,371280,523,Brazil,B14,NA,NA,NA,NA
silence,371980,372573,593,Brazil,B14,NA,NA,NA,NA
silence,373559,376330,2771,Brazil,B14,NA,NA,NA,NA
silence,377939,378950,1011,Brazil,B14,NA,NA,NA,NA
silence,381260,381582,322,Brazil,B14,NA,NA,NA,NA
silence,382341,383890,1549,Brazil,B14,NA,NA,NA,NA
silence,387310,388423,1113,Brazil,B14,NA,NA,NA,NA
silence,388937,389510,573,Brazil,B14,NA,NA,NA,NA
silence,390080,391180,1100,Brazil,B14,NA,NA,NA,NA
silence,393050,393260,210,Brazil,B14,NA,NA,NA,NA
mother_gesture,398419,398820,401,Brazil,B14,NA,NA,NA,NA
silence,399920,400988,1068,Brazil,B14,NA,NA,NA,NA
child_gesture,410215,410842,627,Brazil,B14,NA,NA,NA,NA
silence,410550,411429,879,Brazil,B14,NA,NA,NA,NA
mother_gesture,412229,414990,2761,Brazil,B14,NA,NA,NA,NA
silence,413579,413800,221,Brazil,B14,NA,NA,NA,NA
child_gesture,416147,417269,1122,Brazil,B14,NA,NA,NA,NA
silence,420212,421830,1618,Brazil,B14,NA,NA,NA,NA
silence,422540,422870,330,Brazil,B14,NA,NA,NA,NA
silence,425376,425397,21,Brazil,B14,NA,NA,NA,NA
child_gesture,426340,427493,1153,Brazil,B14,NA,NA,NA,NA
silence,430280,430759,479,Brazil,B14,NA,NA,NA,NA
silence,438290,438413,123,Brazil,B14,NA,NA,NA,NA
silence,439136,439210,74,Brazil,B14,NA,NA,NA,NA
silence,441460,442009,549,Brazil,B14,NA,NA,NA,NA
silence,445810,446328,518,Brazil,B14,NA,NA,NA,NA
silence,446780,450330,3550,Brazil,B14,NA,NA,NA,NA
silence,451730,451883,153,Brazil,B14,NA,NA,NA,NA
silence,452529,452857,328,Brazil,B14,NA,NA,NA,NA
silence,456370,456610,240,Brazil,B14,NA,NA,NA,NA
silence,457440,457683,243,Brazil,B14,NA,NA,NA,NA
silence,461110,461500,390,Brazil,B14,NA,NA,NA,NA
silence,463540,463694,154,Brazil,B14,NA,NA,NA,NA
silence,465060,465270,210,Brazil,B14,NA,NA,NA,NA
silence,466730,466974,244,Brazil,B14,NA,NA,NA,NA
silence,468866,468880,14,Brazil,B14,NA,NA,NA,NA
silence,469445,469598,153,Brazil,B14,NA,NA,NA,NA
silence,472990,473050,60,Brazil,B14,NA,NA,NA,NA
silence,473630,476967,3337,Brazil,B14,NA,NA,NA,NA
silence,477950,481486,3536,Brazil,B14,NA,NA,NA,NA
silence,482920,487620,4700,Brazil,B14,NA,NA,NA,NA
silence,490230,495367,5137,Brazil,B14,NA,NA,NA,NA
silence,497330,497630,300,Brazil,B14,NA,NA,NA,NA
silence,501300,501774,474,Brazil,B14,NA,NA,NA,NA
silence,502241,502355,114,Brazil,B14,NA,NA,NA,NA
silence,504097,504450,353,Brazil,B14,NA,NA,NA,NA
silence,505080,505480,400,Brazil,B14,NA,NA,NA,NA
silence,506381,508000,1619,Brazil,B14,NA,NA,NA,NA
silence,508750,510870,2120,Brazil,B14,NA,NA,NA,NA
silence,514380,514710,330,Brazil,B14,NA,NA,NA,NA
silence,516110,516670,560,Brazil,B14,NA,NA,NA,NA
silence,517327,520570,3243,Brazil,B14,NA,NA,NA,NA
silence,523220,523560,340,Brazil,B14,NA,NA,NA,NA
silence,527500,527530,30,Brazil,B14,NA,NA,NA,NA
silence,529314,529331,17,Brazil,B14,NA,NA,NA,NA
silence,535340,536110,770,Brazil,B14,NA,NA,NA,NA
silence,540342,541080,738,Brazil,B14,NA,NA,NA,NA
silence,543847,544077,230,Brazil,B14,NA,NA,NA,NA
silence,545829,546210,381,Brazil,B14,NA,NA,NA,NA
silence,547640,548261,621,Brazil,B14,NA,NA,NA,NA
silence,553190,555410,2220,Brazil,B14,NA,NA,NA,NA
silence,556220,557130,910,Brazil,B14,NA,NA,NA,NA
silence,557455,559708,2253,Brazil,B14,NA,NA,NA,NA
silence,561270,563667,2397,Brazil,B14,NA,NA,NA,NA
silence,564219,564650,431,Brazil,B14,NA,NA,NA,NA
silence,565170,565540,370,Brazil,B14,NA,NA,NA,NA
silence,567040,567410,370,Brazil,B14,NA,NA,NA,NA
child_gesture,570292,571865,1573,Brazil,B14,NA,NA,NA,NA
father_gesture,572000,572490,490,Brazil,B14,NA,NA,NA,NA
silence,573619,573870,251,Brazil,B14,NA,NA,NA,NA
child_gesture,574290,576070,1780,Brazil,B14,NA,NA,NA,NA
silence,576097,576259,162,Brazil,B14,NA,NA,NA,NA
silence,580310,580594,284,Brazil,B14,NA,NA,NA,NA
silence,582488,583100,612,Brazil,B14,NA,NA,NA,NA
father_gesture,589410,592960,3550,Brazil,B14,NA,NA,NA,NA
silence,592310,594540,2230,Brazil,B14,NA,NA,NA,NA
silence,596028,596330,302,Brazil,B14,NA,NA,NA,NA
silence,597050,597210,160,Brazil,B14,NA,NA,NA,NA
father,393,6170,5777,Brazil,B15,b,1,1,a
mother,19590,21080,1490,Brazil,B15,o,2,1,i
mother,30350,32510,2160,Brazil,B15,o,2,2,a
father,35446,49330,13884,Brazil,B15,m,3,1,a
father,52320,56294,3974,Brazil,B15,m,3,2,a
mother,57080,59687,2607,Brazil,B15,f,3,3,a
father,59750,61780,2030,Brazil,B15,m,3,4,q
father,67620,69940,2320,Brazil,B15,m,3,5,a
mother,69933,71160,1227,Brazil,B15,f,3,6,a
father,71800,73611,1811,Brazil,B15,m,3,7,a
mother,73900,74680,780,Brazil,B15,f,3,8,a
child,62167,65586,3419,Brazil,B15,f,4,1,a
father,65542,66351,809,Brazil,B15,c,4,2,i
child,74696,76443,1747,Brazil,B15,b,5,1,a
child,79670,81654,1984,Brazil,B15,b,5,2,a
father,82020,83334,1314,Brazil,B15,c,5,3,a
child,84060,84952,892,Brazil,B15,b,5,4,a
mother,84219,84932,713,Brazil,B15,c,5,5,a
child,85547,87110,1563,Brazil,B15,m,5,6,a
mother,88210,92220,4010,Brazil,B15,c,5,7,a
mother,99050,99980,930,Brazil,B15,c,5,8,i
father,108410,110614,2204,Brazil,B15,m,6,1,a
father,114650,115206,556,Brazil,B15,m,6,2,a
father,119150,120430,1280,Brazil,B15,m,6,3,q
mother,124966,126476,1510,Brazil,B15,f,6,4,a
mother,129510,130290,780,Brazil,B15,f,6,5,a
father,130940,137460,6520,Brazil,B15,m,6,6,a
mother,138361,140210,1849,Brazil,B15,f,6,7,a
father,140367,141560,1193,Brazil,B15,m,6,8,q
child,113770,114780,1010,Brazil,B15,b,7,1,a
child,121870,124670,2800,Brazil,B15,b,7,2,a
child,148130,150495,2365,Brazil,B15,m,8,1,a
mother,151290,155295,4005,Brazil,B15,c,8,2,a
child,156337,158400,2063,Brazil,B15,m,8,3,q
mother,158235,164680,6445,Brazil,B15,c,8,4,q
child,165550,166390,840,Brazil,B15,m,8,5,a
mother,165734,168098,2364,Brazil,B15,c,8,6,a
mother,172793,177110,4317,Brazil,B15,c,8,7,i
mother,179203,180490,1287,Brazil,B15,c,8,8,a
child,180710,184073,3363,Brazil,B15,m,8,9,a
mother,185100,185900,800,Brazil,B15,c,8,10,a
child,185120,186630,1510,Brazil,B15,m,8,11,a
mother,186638,190230,3592,Brazil,B15,c,8,12,a
mother,195670,200070,4400,Brazil,B15,c,8,13,a
mother,205840,206830,990,Brazil,B15,c,8,14,a
child,208530,209749,1219,Brazil,B15,m,8,15,a
mother,211259,212452,1193,Brazil,B15,c,8,16,q
child,214500,217298,2798,Brazil,B15,f,8,17,a
mother,217933,219822,1889,Brazil,B15,c,8,18,a
child,220376,222850,2474,Brazil,B15,f,8,19,a
father,224180,224690,510,Brazil,B15,c,8,20,a
mother,230040,235250,5210,Brazil,B15,o,8,21,a
mother,239898,243581,3683,Brazil,B15,o,8,22,a
father,246660,251070,4410,Brazil,B15,m,8,23,a
mother,251094,251798,704,Brazil,B15,f,8,24,a
mother,254660,256170,1510,Brazil,B15,o,8,25,a
mother,262980,263660,680,Brazil,B15,c,8,26,q
child,265378,266908,1530,Brazil,B15,m,8,27,a
mother,272088,273155,1067,Brazil,B15,c,8,28,a
mother,278720,284780,6060,Brazil,B15,c,8,29,a
mother,285720,288271,2551,Brazil,B15,f,8,30,a
father,190969,191542,573,Brazil,B15,o,9,1,a
father,287802,291920,4118,Brazil,B15,m,9,2,a
mother,294018,298130,4112,Brazil,B15,f,9,3,a
father,298770,299642,872,Brazil,B15,m,9,4,q
mother,300400,301941,1541,Brazil,B15,f,9,5,a
father,302033,306890,4857,Brazil,B15,m,9,6,a
mother,306052,306625,573,Brazil,B15,f,9,7,a
father,309670,321940,12270,Brazil,B15,m,9,8,a
father,327690,328770,1080,Brazil,B15,m,9,9,a
mother,331697,334248,2551,Brazil,B15,f,9,10,a
mother,343560,344160,600,Brazil,B15,f,9,11,q
father,352890,354920,2030,Brazil,B15,m,9,12,a
father,367780,370564,2784,Brazil,B15,m,9,13,a
mother,373000,374973,1973,Brazil,B15,f,9,14,a
mother,379297,384740,5443,Brazil,B15,f,9,15,a
father,394040,396210,2170,Brazil,B15,m,9,16,a
mother,396200,401320,5120,Brazil,B15,f,9,17,a
mother,363680,365058,1378,Brazil,B15,c,10,1,a
child,402450,405015,2565,Brazil,B15,f,11,1,a
mother,405020,406030,1010,Brazil,B15,c,11,2,a
child,410850,414063,3213,Brazil,B15,f,11,3,a
mother,414930,417975,3045,Brazil,B15,c,11,4,a
mother,420370,421089,719,Brazil,B15,c,11,5,i
father,428000,430260,2260,Brazil,B15,c,11,6,i
father,443892,444623,731,Brazil,B15,m,12,1,a
mother,447410,448264,854,Brazil,B15,f,12,2,a
mother,450573,452076,1503,Brazil,B15,f,12,3,a
mother,454010,454762,752,Brazil,B15,o,12,4,a
father,455199,456157,958,Brazil,B15,m,12,5,q
father,458760,463480,4720,Brazil,B15,o,12,6,i
father,468935,470890,1955,Brazil,B15,o,12,7,i
father,472200,473090,890,Brazil,B15,m,12,8,a
mother,481600,482120,520,Brazil,B15,c,12,9,i
father,501410,502450,1040,Brazil,B15,m,12,10,a
child,478697,479257,560,Brazil,B15,m,13,1,a
mother,484260,486210,1950,Brazil,B15,c,13,2,i
child,490030,491260,1230,Brazil,B15,m,13,3,q
mother,491360,492450,1090,Brazil,B15,c,13,4,a
child,493630,494350,720,Brazil,B15,m,13,5,q
child,496940,498817,1877,Brazil,B15,m,13,6,q
mother,502470,503280,810,Brazil,B15,f,13,7,a
mother,506237,510951,4714,Brazil,B15,f,13,8,a
mother,513107,515200,2093,Brazil,B15,f,13,9,a
child,517720,518760,1040,Brazil,B15,f,14,1,a
father,519720,520328,608,Brazil,B15,c,14,2,a
mother,523641,528460,4819,Brazil,B15,c,14,3,i
mother,533221,534224,1003,Brazil,B15,c,14,4,a
child,535240,535872,632,Brazil,B15,m,14,5,a
mother,536700,537695,995,Brazil,B15,c,14,6,a
father,548583,550318,1735,Brazil,B15,m,15,1,a
mother,551474,552041,567,Brazil,B15,f,15,2,a
father,552077,555290,3213,Brazil,B15,m,15,3,a
mother,555200,556520,1320,Brazil,B15,f,15,4,a
father,557010,565840,8830,Brazil,B15,m,15,5,a
father,569820,570710,890,Brazil,B15,m,15,6,a
mother,570383,571089,706,Brazil,B15,f,15,7,a
mother,573300,573940,640,Brazil,B15,f,15,8,a
father,577060,582590,5530,Brazil,B15,c,16,1,q
mother,587690,589750,2060,Brazil,B15,f,16,2,a
father,594360,596160,1800,Brazil,B15,m,16,3,a
mother,599388,599797,409,Brazil,B15,o,16,4,i
child,589740,591772,2032,Brazil,B15,m,17,1,a
mother,592590,593680,1090,Brazil,B15,c,17,2,q
father_gesture,4873,6778,1905,Brazil,B15,NA,NA,NA,NA
silence,6170,19590,13420,Brazil,B15,NA,NA,NA,NA
silence,21080,30350,9270,Brazil,B15,NA,NA,NA,NA
silence,32510,35446,2936,Brazil,B15,NA,NA,NA,NA
silence,49330,52320,2990,Brazil,B15,NA,NA,NA,NA
silence,56294,57080,786,Brazil,B15,NA,NA,NA,NA
silence,59687,59750,63,Brazil,B15,NA,NA,NA,NA
silence,61780,62167,387,Brazil,B15,NA,NA,NA,NA
silence,66351,67620,1269,Brazil,B15,NA,NA,NA,NA
silence,71160,71800,640,Brazil,B15,NA,NA,NA,NA
silence,73611,73900,289,Brazil,B15,NA,NA,NA,NA
silence,74680,74696,16,Brazil,B15,NA,NA,NA,NA
silence,76443,79670,3227,Brazil,B15,NA,NA,NA,NA
silence,81654,82020,366,Brazil,B15,NA,NA,NA,NA
silence,83334,84060,726,Brazil,B15,NA,NA,NA,NA
silence,84952,85547,595,Brazil,B15,NA,NA,NA,NA
silence,87110,88210,1100,Brazil,B15,NA,NA,NA,NA
silence,92220,99050,6830,Brazil,B15,NA,NA,NA,NA
silence,99980,108410,8430,Brazil,B15,NA,NA,NA,NA
silence,110614,113770,3156,Brazil,B15,NA,NA,NA,NA
silence,115206,119150,3944,Brazil,B15,NA,NA,NA,NA
silence,120430,121870,1440,Brazil,B15,NA,NA,NA,NA
silence,124670,124966,296,Brazil,B15,NA,NA,NA,NA
silence,126476,129510,3034,Brazil,B15,NA,NA,NA,NA
silence,130290,130940,650,Brazil,B15,NA,NA,NA,NA
silence,137460,138361,901,Brazil,B15,NA,NA,NA,NA
silence,140210,140367,157,Brazil,B15,NA,NA,NA,NA
silence,141560,148130,6570,Brazil,B15,NA,NA,NA,NA
silence,150495,151290,795,Brazil,B15,NA,NA,NA,NA
mother_gesture,151295,152286,991,Brazil,B15,NA,NA,NA,NA
silence,155295,156337,1042,Brazil,B15,NA,NA,NA,NA
mother_gesture,160352,160781,429,Brazil,B15,NA,NA,NA,NA
silence,164680,165550,870,Brazil,B15,NA,NA,NA,NA
silence,168098,172793,4695,Brazil,B15,NA,NA,NA,NA
silence,177110,179203,2093,Brazil,B15,NA,NA,NA,NA
silence,180490,180710,220,Brazil,B15,NA,NA,NA,NA
silence,184073,185100,1027,Brazil,B15,NA,NA,NA,NA
silence,186630,186638,8,Brazil,B15,NA,NA,NA,NA
silence,190230,190969,739,Brazil,B15,NA,NA,NA,NA
silence,191542,195670,4128,Brazil,B15,NA,NA,NA,NA
silence,200070,205840,5770,Brazil,B15,NA,NA,NA,NA
silence,206830,208530,1700,Brazil,B15,NA,NA,NA,NA
silence,209749,211259,1510,Brazil,B15,NA,NA,NA,NA
silence,212452,214500,2048,Brazil,B15,NA,NA,NA,NA
silence,217298,217933,635,Brazil,B15,NA,NA,NA,NA
silence,219822,220376,554,Brazil,B15,NA,NA,NA,NA
silence,222850,224180,1330,Brazil,B15,NA,NA,NA,NA
silence,224690,225270,580,Brazil,B15,NA,NA,NA,NA
mother,225270,227890,2620,Brazil,B15,f,NA,NA,a
silence,227890,230040,2150,Brazil,B15,NA,NA,NA,NA
silence,235250,239898,4648,Brazil,B15,NA,NA,NA,NA
silence,243581,246660,3079,Brazil,B15,NA,NA,NA,NA
silence,251070,251094,24,Brazil,B15,NA,NA,NA,NA
silence,251798,254660,2862,Brazil,B15,NA,NA,NA,NA
silence,256170,262980,6810,Brazil,B15,NA,NA,NA,NA
silence,263660,265378,1718,Brazil,B15,NA,NA,NA,NA
child_gesture,265399,269190,3791,Brazil,B15,NA,NA,NA,NA
silence,266908,272088,5180,Brazil,B15,NA,NA,NA,NA
silence,273155,278720,5565,Brazil,B15,NA,NA,NA,NA
silence,284780,285720,940,Brazil,B15,NA,NA,NA,NA
silence,291920,294018,2098,Brazil,B15,NA,NA,NA,NA
silence,298130,298770,640,Brazil,B15,NA,NA,NA,NA
silence,299642,300400,758,Brazil,B15,NA,NA,NA,NA
silence,301941,302033,92,Brazil,B15,NA,NA,NA,NA
silence,306890,309670,2780,Brazil,B15,NA,NA,NA,NA
silence,321940,327690,5750,Brazil,B15,NA,NA,NA,NA
silence,328770,331697,2927,Brazil,B15,NA,NA,NA,NA
silence,334248,343560,9312,Brazil,B15,NA,NA,NA,NA
silence,344160,352890,8730,Brazil,B15,NA,NA,NA,NA
silence,354920,363680,8760,Brazil,B15,NA,NA,NA,NA
silence,365058,367780,2722,Brazil,B15,NA,NA,NA,NA
silence,370564,373000,2436,Brazil,B15,NA,NA,NA,NA
silence,374973,379297,4324,Brazil,B15,NA,NA,NA,NA
silence,384740,394040,9300,Brazil,B15,NA,NA,NA,NA
silence,401320,402450,1130,Brazil,B15,NA,NA,NA,NA
silence,405015,405020,5,Brazil,B15,NA,NA,NA,NA
silence,406030,410850,4820,Brazil,B15,NA,NA,NA,NA
silence,414063,414930,867,Brazil,B15,NA,NA,NA,NA
silence,417975,420370,2395,Brazil,B15,NA,NA,NA,NA
silence,421089,428000,6911,Brazil,B15,NA,NA,NA,NA
silence,430260,443892,13632,Brazil,B15,NA,NA,NA,NA
silence,444623,447410,2787,Brazil,B15,NA,NA,NA,NA
silence,448264,450573,2309,Brazil,B15,NA,NA,NA,NA
silence,452076,454010,1934,Brazil,B15,NA,NA,NA,NA
silence,454762,455199,437,Brazil,B15,NA,NA,NA,NA
silence,456157,458760,2603,Brazil,B15,NA,NA,NA,NA
silence,463480,468935,5455,Brazil,B15,NA,NA,NA,NA
silence,470890,472200,1310,Brazil,B15,NA,NA,NA,NA
silence,473090,478697,5607,Brazil,B15,NA,NA,NA,NA
silence,479257,481600,2343,Brazil,B15,NA,NA,NA,NA
silence,482120,484260,2140,Brazil,B15,NA,NA,NA,NA
silence,486210,490030,3820,Brazil,B15,NA,NA,NA,NA
silence,491260,491360,100,Brazil,B15,NA,NA,NA,NA
silence,492450,493630,1180,Brazil,B15,NA,NA,NA,NA
silence,494350,496940,2590,Brazil,B15,NA,NA,NA,NA
silence,498817,501410,2593,Brazil,B15,NA,NA,NA,NA
silence,502450,502470,20,Brazil,B15,NA,NA,NA,NA
silence,503280,506237,2957,Brazil,B15,NA,NA,NA,NA
silence,510951,513107,2156,Brazil,B15,NA,NA,NA,NA
silence,515200,517720,2520,Brazil,B15,NA,NA,NA,NA
silence,518760,519720,960,Brazil,B15,NA,NA,NA,NA
silence,520328,523641,3313,Brazil,B15,NA,NA,NA,NA
silence,528460,533221,4761,Brazil,B15,NA,NA,NA,NA
silence,534224,535240,1016,Brazil,B15,NA,NA,NA,NA
silence,535872,536700,828,Brazil,B15,NA,NA,NA,NA
silence,537695,548583,10888,Brazil,B15,NA,NA,NA,NA
silence,550318,551474,1156,Brazil,B15,NA,NA,NA,NA
silence,552041,552077,36,Brazil,B15,NA,NA,NA,NA
silence,556520,557010,490,Brazil,B15,NA,NA,NA,NA
father_gesture,557519,563880,6361,Brazil,B15,NA,NA,NA,NA
silence,565840,569820,3980,Brazil,B15,NA,NA,NA,NA
silence,571089,573300,2211,Brazil,B15,NA,NA,NA,NA
silence,573940,577060,3120,Brazil,B15,NA,NA,NA,NA
silence,582590,587690,5100,Brazil,B15,NA,NA,NA,NA
silence,591772,592590,818,Brazil,B15,NA,NA,NA,NA
silence,593680,594360,680,Brazil,B15,NA,NA,NA,NA
silence,596160,599388,3228,Brazil,B15,NA,NA,NA,NA
child,7530,8625,1095,Brazil,B16,b,1,1,a
mother,8844,13730,4886,Brazil,B16,c,1,2,i
child,11411,12110,699,Brazil,B16,m,1,3,a
mother,18320,19291,971,Brazil,B16,f,1,4,a
father,19317,22920,3603,Brazil,B16,m,1,5,q
father,24950,29520,4570,Brazil,B16,m,1,6,a
mother,29140,31013,1873,Brazil,B16,f,1,7,a
father,33760,36810,3050,Brazil,B16,m,1,8,a
father,40890,43250,2360,Brazil,B16,m,1,9,a
father,58670,65540,6870,Brazil,B16,m,1,10,q
mother,65530,66170,640,Brazil,B16,f,1,11,a
father,66850,67631,781,Brazil,B16,m,1,12,a
mother,67802,71970,4168,Brazil,B16,f,1,13,i
mother,74390,76600,2210,Brazil,B16,f,1,14,a
father,86940,88700,1760,Brazil,B16,m,1,15,a
child,43250,46120,2870,Brazil,B16,b,2,1,a
child,51630,52290,660,Brazil,B16,b,2,2,a
child,78050,80660,2610,Brazil,B16,m,3,1,i
child,95166,96783,1617,Brazil,B16,m,3,2,a
mother,96641,97167,526,Brazil,B16,c,3,3,i
father,106400,109080,2680,Brazil,B16,m,4,1,a
mother,108700,109590,890,Brazil,B16,f,4,2,a
father,116830,119600,2770,Brazil,B16,m,4,3,a
mother,124273,126492,2219,Brazil,B16,f,4,4,q
father,130050,131119,1069,Brazil,B16,m,4,5,q
father,135400,136610,1210,Brazil,B16,m,4,6,a
mother,136962,137296,334,Brazil,B16,f,4,7,a
father,138960,139894,934,Brazil,B16,m,4,8,q
mother,140270,141050,780,Brazil,B16,f,4,9,a
father,141430,143010,1580,Brazil,B16,m,4,10,q
mother,144085,147368,3283,Brazil,B16,f,4,11,a
father,148140,148710,570,Brazil,B16,c,4,12,i
child,152730,154310,1580,Brazil,B16,f,4,13,a
father,154570,155160,590,Brazil,B16,c,4,14,a
father,157870,158280,410,Brazil,B16,o,4,15,i
mother,158147,160118,1971,Brazil,B16,f,4,16,a
mother,164083,164880,797,Brazil,B16,o,4,17,a
mother,128518,129191,673,Brazil,B16,o,5,1,i
mother,175434,177050,1616,Brazil,B16,b,6,1,i
father,180540,183001,2461,Brazil,B16,m,6,2,a
child,181720,192250,10530,Brazil,B16,m,7,1,a
child,198110,201330,3220,Brazil,B16,b,7,2,a
child,206810,220280,13470,Brazil,B16,f,7,3,q
father,221480,221981,501,Brazil,B16,c,7,4,a
child,222958,223400,442,Brazil,B16,f,7,5,q
mother,225310,226303,993,Brazil,B16,c,7,6,a
father,228160,229204,1044,Brazil,B16,m,7,7,a
mother,230322,230870,548,Brazil,B16,f,7,8,q
mother,251990,252600,610,Brazil,B16,o,7,9,a
father,259780,260300,520,Brazil,B16,o,7,10,a
child,240840,245130,4290,Brazil,B16,b,8,1,a
father,285110,286498,1388,Brazil,B16,m,8,2,q
father,299580,301040,1460,Brazil,B16,m,8,3,i
mother,302570,303670,1100,Brazil,B16,o,8,4,a
father,304010,305890,1880,Brazil,B16,m,8,5,a
child,308256,311030,2774,Brazil,B16,m,8,6,i
mother,316336,316871,535,Brazil,B16,c,8,7,a
child,288520,289620,1100,Brazil,B16,b,9,1,a
mother,334310,335621,1311,Brazil,B16,b,9,2,a
mother,341980,344587,2607,Brazil,B16,f,9,3,a
child,360610,361383,773,Brazil,B16,m,10,1,a
father,362215,363092,877,Brazil,B16,m,10,2,a
child,363200,369250,6050,Brazil,B16,m,10,3,a
child,376860,377605,745,Brazil,B16,b,10,4,a
father,389170,394260,5090,Brazil,B16,c,11,1,a
child,394488,397689,3201,Brazil,B16,f,11,2,a
mother,397680,398050,370,Brazil,B16,c,11,3,i
father,399334,402690,3356,Brazil,B16,m,11,4,q
child,412292,417310,5018,Brazil,B16,m,11,5,q
father,417150,418330,1180,Brazil,B16,c,11,6,q
mother,420760,424030,3270,Brazil,B16,o,11,7,i
father,424890,425349,459,Brazil,B16,c,11,8,q
child,425860,426300,440,Brazil,B16,f,11,9,a
father,426615,428380,1765,Brazil,B16,c,11,10,q
child,440640,441661,1021,Brazil,B16,o,12,1,a
child,446987,455730,8743,Brazil,B16,o,12,2,i
child,457800,459930,2130,Brazil,B16,m,12,3,a
mother,460400,461591,1191,Brazil,B16,c,12,4,q
child,461527,465420,3893,Brazil,B16,m,12,5,a
child,469920,471807,1887,Brazil,B16,b,12,6,a
father,470952,472176,1224,Brazil,B16,m,12,7,i
mother,472380,472904,524,Brazil,B16,f,12,8,q
father,472857,473880,1023,Brazil,B16,m,12,9,i
child,477984,482050,4066,Brazil,B16,m,12,10,a
child,491420,492698,1278,Brazil,B16,m,12,11,a
child,501020,502040,1020,Brazil,B16,m,12,12,q
father,505819,506396,577,Brazil,B16,b,12,13,a
mother,514760,517360,2600,Brazil,B16,f,12,14,q
father,520326,521836,1510,Brazil,B16,m,12,15,a
child,511100,515200,4100,Brazil,B16,o,13,1,a
child,518450,520430,1980,Brazil,B16,o,13,2,a
child,528210,529940,1730,Brazil,B16,o,13,3,a
mother,540630,543813,3183,Brazil,B16,f,14,1,a
father,547188,548560,1372,Brazil,B16,m,14,2,a
mother,548950,563330,14380,Brazil,B16,f,14,3,a
child,547112,549666,2554,Brazil,B16,o,15,1,a
father,579696,580475,779,Brazil,B16,c,16,1,i
child,581280,582460,1180,Brazil,B16,f,16,2,a
mother,584520,585813,1293,Brazil,B16,f,16,3,q
father,585854,587686,1832,Brazil,B16,m,16,4,a
child,585859,588974,3115,Brazil,B16,b,16,5,a
child,590150,596550,6400,Brazil,B16,b,16,6,a
mother,595680,597200,1520,Brazil,B16,c,16,7,a
silence,8625,8844,219,Brazil,B16,NA,NA,NA,NA
mother_gesture,12429,13254,825,Brazil,B16,NA,NA,NA,NA
silence,13730,18320,4590,Brazil,B16,NA,NA,NA,NA
silence,19291,19317,26,Brazil,B16,NA,NA,NA,NA
silence,22920,24950,2030,Brazil,B16,NA,NA,NA,NA
silence,31013,33760,2747,Brazil,B16,NA,NA,NA,NA
silence,36810,40890,4080,Brazil,B16,NA,NA,NA,NA
silence,46120,51630,5510,Brazil,B16,NA,NA,NA,NA
silence,52290,58670,6380,Brazil,B16,NA,NA,NA,NA
father_gesture,59216,59876,660,Brazil,B16,NA,NA,NA,NA
father_gesture,64345,64906,561,Brazil,B16,NA,NA,NA,NA
mother_gesture,65503,66196,693,Brazil,B16,NA,NA,NA,NA
silence,66170,66850,680,Brazil,B16,NA,NA,NA,NA
silence,67631,67802,171,Brazil,B16,NA,NA,NA,NA
mother_gesture,69699,70491,792,Brazil,B16,NA,NA,NA,NA
silence,71970,74390,2420,Brazil,B16,NA,NA,NA,NA
silence,76600,78050,1450,Brazil,B16,NA,NA,NA,NA
silence,80660,86940,6280,Brazil,B16,NA,NA,NA,NA
silence,88700,95166,6466,Brazil,B16,NA,NA,NA,NA
silence,97167,106400,9233,Brazil,B16,NA,NA,NA,NA
silence,109590,116830,7240,Brazil,B16,NA,NA,NA,NA
silence,119600,124273,4673,Brazil,B16,NA,NA,NA,NA
silence,126492,128518,2026,Brazil,B16,NA,NA,NA,NA
silence,129191,130050,859,Brazil,B16,NA,NA,NA,NA
silence,131119,135400,4281,Brazil,B16,NA,NA,NA,NA
silence,136610,136962,352,Brazil,B16,NA,NA,NA,NA
silence,137296,138960,1664,Brazil,B16,NA,NA,NA,NA
silence,139894,140270,376,Brazil,B16,NA,NA,NA,NA
silence,141050,141430,380,Brazil,B16,NA,NA,NA,NA
silence,143010,144085,1075,Brazil,B16,NA,NA,NA,NA
mother_gesture,144121,145871,1750,Brazil,B16,NA,NA,NA,NA
silence,147368,148140,772,Brazil,B16,NA,NA,NA,NA
silence,148710,152730,4020,Brazil,B16,NA,NA,NA,NA
silence,154310,154570,260,Brazil,B16,NA,NA,NA,NA
silence,155160,157870,2710,Brazil,B16,NA,NA,NA,NA
silence,160118,164083,3965,Brazil,B16,NA,NA,NA,NA
silence,164880,175434,10554,Brazil,B16,NA,NA,NA,NA
silence,177050,180540,3490,Brazil,B16,NA,NA,NA,NA
silence,192250,198110,5860,Brazil,B16,NA,NA,NA,NA
silence,201330,206810,5480,Brazil,B16,NA,NA,NA,NA
silence,220280,221480,1200,Brazil,B16,NA,NA,NA,NA
silence,221981,222958,977,Brazil,B16,NA,NA,NA,NA
silence,223400,225310,1910,Brazil,B16,NA,NA,NA,NA
silence,226303,228160,1857,Brazil,B16,NA,NA,NA,NA
silence,229204,230322,1118,Brazil,B16,NA,NA,NA,NA
silence,230870,240840,9970,Brazil,B16,NA,NA,NA,NA
silence,245130,251990,6860,Brazil,B16,NA,NA,NA,NA
silence,252600,259780,7180,Brazil,B16,NA,NA,NA,NA
silence,260300,285110,24810,Brazil,B16,NA,NA,NA,NA
silence,286498,288520,2022,Brazil,B16,NA,NA,NA,NA
silence,289620,299580,9960,Brazil,B16,NA,NA,NA,NA
father_gesture,300407,300836,429,Brazil,B16,NA,NA,NA,NA
silence,301040,302570,1530,Brazil,B16,NA,NA,NA,NA
silence,303670,304010,340,Brazil,B16,NA,NA,NA,NA
silence,305890,308256,2366,Brazil,B16,NA,NA,NA,NA
silence,311030,316336,5306,Brazil,B16,NA,NA,NA,NA
silence,316871,334310,17439,Brazil,B16,NA,NA,NA,NA
silence,335621,341980,6359,Brazil,B16,NA,NA,NA,NA
silence,344587,360610,16023,Brazil,B16,NA,NA,NA,NA
silence,361383,362215,832,Brazil,B16,NA,NA,NA,NA
silence,363092,363200,108,Brazil,B16,NA,NA,NA,NA
child_gesture,364301,368906,4605,Brazil,B16,NA,NA,NA,NA
silence,369250,376860,7610,Brazil,B16,NA,NA,NA,NA
silence,377605,389170,11565,Brazil,B16,NA,NA,NA,NA
silence,394260,394488,228,Brazil,B16,NA,NA,NA,NA
silence,398050,399334,1284,Brazil,B16,NA,NA,NA,NA
father_gesture,399586,400073,487,Brazil,B16,NA,NA,NA,NA
silence,402690,412292,9602,Brazil,B16,NA,NA,NA,NA
silence,418330,420760,2430,Brazil,B16,NA,NA,NA,NA
silence,424030,424890,860,Brazil,B16,NA,NA,NA,NA
silence,425349,425860,511,Brazil,B16,NA,NA,NA,NA
silence,426300,426615,315,Brazil,B16,NA,NA,NA,NA
silence,428380,440640,12260,Brazil,B16,NA,NA,NA,NA
silence,441661,446987,5326,Brazil,B16,NA,NA,NA,NA
silence,455730,457800,2070,Brazil,B16,NA,NA,NA,NA
silence,459930,460400,470,Brazil,B16,NA,NA,NA,NA
silence,465420,469920,4500,Brazil,B16,NA,NA,NA,NA
silence,472176,472380,204,Brazil,B16,NA,NA,NA,NA
silence,473880,477984,4104,Brazil,B16,NA,NA,NA,NA
child_gesture,478268,481529,3261,Brazil,B16,NA,NA,NA,NA
silence,482050,491420,9370,Brazil,B16,NA,NA,NA,NA
silence,492698,501020,8322,Brazil,B16,NA,NA,NA,NA
silence,502040,505819,3779,Brazil,B16,NA,NA,NA,NA
silence,506396,511100,4704,Brazil,B16,NA,NA,NA,NA
silence,517360,518450,1090,Brazil,B16,NA,NA,NA,NA
silence,521836,528210,6374,Brazil,B16,NA,NA,NA,NA
silence,529940,540630,10690,Brazil,B16,NA,NA,NA,NA
silence,543813,547112,3299,Brazil,B16,NA,NA,NA,NA
silence,563360,579696,16336,Brazil,B16,NA,NA,NA,NA
silence,580475,581280,805,Brazil,B16,NA,NA,NA,NA
silence,582460,584520,2060,Brazil,B16,NA,NA,NA,NA
silence,585813,585854,41,Brazil,B16,NA,NA,NA,NA
silence,588974,590150,1176,Brazil,B16,NA,NA,NA,NA
mother,712,1682,970,Brazil,B17,f,1,1,a
child,1422,8186,6764,Brazil,B17,b,2,1,a
child,11021,12055,1034,Brazil,B17,m,2,2,a
mother,12032,13152,1120,Brazil,B17,c,2,3,q
child,13017,13384,367,Brazil,B17,m,2,4,a
father,14917,18752,3835,Brazil,B17,c,2,5,i
mother,18762,19532,770,Brazil,B17,c,2,6,i
mother,21742,30722,8980,Brazil,B17,c,2,7,a
father,21877,22645,768,Brazil,B17,c,2,8,i
father,25272,25988,716,Brazil,B17,c,2,9,i
father,28460,29254,794,Brazil,B17,c,2,10,i
mother,33432,34092,660,Brazil,B17,c,2,11,q
child,35031,41132,6101,Brazil,B17,m,2,12,a
mother,40492,44472,3980,Brazil,B17,c,2,13,a
mother,47082,48512,1430,Brazil,B17,c,2,14,q
child,48992,50352,1360,Brazil,B17,m,2,15,a
mother,49892,51392,1500,Brazil,B17,c,2,16,a
father,51712,52212,500,Brazil,B17,c,2,17,a
child,51912,52472,560,Brazil,B17,f,2,18,q
mother,52792,54212,1420,Brazil,B17,c,2,19,a
father,52832,53324,492,Brazil,B17,c,2,20,a
mother,56392,59292,2900,Brazil,B17,c,2,21,a
child,61467,63613,2146,Brazil,B17,m,2,22,a
mother,63582,64302,720,Brazil,B17,c,2,23,q
mother,75592,83392,7800,Brazil,B17,f,3,1,a
father,81462,82232,770,Brazil,B17,m,3,2,a
mother,86872,102392,15520,Brazil,B17,f,3,3,a
father,104823,107302,2479,Brazil,B17,m,3,4,a
mother,107592,108312,720,Brazil,B17,f,3,5,q
father,114142,116874,2732,Brazil,B17,m,3,6,a
father,119075,120309,1234,Brazil,B17,m,3,7,a
mother,124482,125832,1350,Brazil,B17,f,3,8,a
mother,130692,133542,2850,Brazil,B17,f,3,9,a
mother,137992,140212,2220,Brazil,B17,f,3,10,a
father,141342,141802,460,Brazil,B17,m,3,11,a
mother,150432,168402,17970,Brazil,B17,f,3,12,a
father,176702,179212,2510,Brazil,B17,m,3,13,a
mother,179782,180492,710,Brazil,B17,f,3,14,a
father,181652,183649,1997,Brazil,B17,m,3,15,a
mother,188192,189802,1610,Brazil,B17,f,3,16,a
father,198884,200395,1511,Brazil,B17,m,3,17,a
father,208658,210284,1626,Brazil,B17,m,3,18,a
mother,211992,213282,1290,Brazil,B17,f,3,19,q
father,215233,216216,983,Brazil,B17,m,3,20,a
mother,217892,221812,3920,Brazil,B17,f,3,21,a
father,223565,225085,1520,Brazil,B17,m,3,22,a
mother,225692,228292,2600,Brazil,B17,f,3,23,a
father,226922,228739,1817,Brazil,B17,m,3,24,a
mother,228875,229990,1115,Brazil,B17,f,3,25,a
father,229802,230712,910,Brazil,B17,f,3,26,a
child,234753,235988,1235,Brazil,B17,m,3,27,a
mother,238582,239522,940,Brazil,B17,c,3,28,q
father,241229,241859,630,Brazil,B17,c,3,29,q
father,249435,252318,2883,Brazil,B17,m,3,30,a
mother,251792,259892,8100,Brazil,B17,f,3,31,a
father,258579,262092,3513,Brazil,B17,m,3,32,a
mother,261982,268352,6370,Brazil,B17,f,3,33,a
mother,268792,283032,14240,Brazil,B17,f,3,34,a
mother,288402,289662,1260,Brazil,B17,f,3,35,a
father,289682,292342,2660,Brazil,B17,m,3,36,a
mother,290492,291122,630,Brazil,B17,f,3,37,a
mother,291792,313942,22150,Brazil,B17,f,3,38,a
mother,318192,319892,1700,Brazil,B17,f,3,39,a
mother,322092,336452,14360,Brazil,B17,f,3,40,a
child,85372,85802,430,Brazil,B17,b,4,1,a
mother,245172,246042,870,Brazil,B17,c,4,2,i
child,248397,249623,1226,Brazil,B17,b,4,3,a
child,267492,272405,4913,Brazil,B17,m,5,1,a
child,278106,282112,4006,Brazil,B17,m,5,2,a
child,336250,337178,928,Brazil,B17,m,6,1,a
mother,337872,338462,590,Brazil,B17,c,6,2,a
child,339072,339752,680,Brazil,B17,m,6,3,a
father,341895,347515,5620,Brazil,B17,c,6,4,i
child,344622,345972,1350,Brazil,B17,f,6,5,a
child,349135,350735,1600,Brazil,B17,f,6,6,a
father,351652,352258,606,Brazil,B17,c,6,7,q
mother,353692,354782,1090,Brazil,B17,c,6,8,a
child,355016,355603,587,Brazil,B17,m,6,9,a
child,358270,358770,500,Brazil,B17,b,6,10,a
father,370499,372666,2167,Brazil,B17,c,6,11,a
father,377102,379085,1983,Brazil,B17,c,6,12,a
mother,355382,361182,5800,Brazil,B17,f,7,1,a
child,394558,395734,1176,Brazil,B17,m,8,1,a
child,403462,404516,1054,Brazil,B17,m,8,2,a
mother,404092,405562,1470,Brazil,B17,c,8,3,i
child,408242,409679,1437,Brazil,B17,m,8,4,a
father,412212,412822,610,Brazil,B17,c,8,5,q
mother,414602,441792,27190,Brazil,B17,f,9,1,a
mother,442812,444882,2070,Brazil,B17,c,10,1,q
child,445328,447442,2114,Brazil,B17,m,10,2,a
mother,445812,448072,2260,Brazil,B17,m,10,3,a
mother,449592,473782,24190,Brazil,B17,f,11,1,a
father,479985,480966,981,Brazil,B17,m,11,2,q
mother,482482,485922,3440,Brazil,B17,f,11,3,a
mother,488322,491602,3280,Brazil,B17,c,11,4,a
mother,497512,535532,38020,Brazil,B17,f,11,5,a
father,535392,536282,890,Brazil,B17,m,11,6,q
mother,536522,539972,3450,Brazil,B17,f,11,7,a
mother,542412,583912,41500,Brazil,B17,f,11,8,a
mother,587882,589482,1600,Brazil,B17,f,11,9,a
mother,593032,598552,5520,Brazil,B17,f,11,10,a
child,471393,472358,965,Brazil,B17,m,12,1,a
child,476402,488227,11825,Brazil,B17,m,12,2,a
child,491001,492278,1277,Brazil,B17,m,12,3,a
mother,492282,496512,4230,Brazil,B17,c,12,4,a
child,564502,565322,820,Brazil,B17,b,12,5,a
child,573050,574066,1016,Brazil,B17,b,12,6,a
child,596372,600072,3700,Brazil,B17,m,13,1,a
silence,8186,11021,2835,Brazil,B17,NA,NA,NA,NA
silence,13384,14917,1533,Brazil,B17,NA,NA,NA,NA
silence,18752,18762,10,Brazil,B17,NA,NA,NA,NA
silence,19532,21742,2210,Brazil,B17,NA,NA,NA,NA
silence,30722,33432,2710,Brazil,B17,NA,NA,NA,NA
silence,34092,35031,939,Brazil,B17,NA,NA,NA,NA
silence,44472,47082,2610,Brazil,B17,NA,NA,NA,NA
silence,48512,48992,480,Brazil,B17,NA,NA,NA,NA
silence,51392,51712,320,Brazil,B17,NA,NA,NA,NA
silence,52472,52792,320,Brazil,B17,NA,NA,NA,NA
silence,54212,56392,2180,Brazil,B17,NA,NA,NA,NA
mother_gesture,56762,57362,600,Brazil,B17,NA,NA,NA,NA
silence,59292,61467,2175,Brazil,B17,NA,NA,NA,NA
silence,64302,75592,11290,Brazil,B17,NA,NA,NA,NA
silence,83392,85372,1980,Brazil,B17,NA,NA,NA,NA
silence,85802,86872,1070,Brazil,B17,NA,NA,NA,NA
silence,102392,104823,2431,Brazil,B17,NA,NA,NA,NA
silence,107302,107592,290,Brazil,B17,NA,NA,NA,NA
silence,108312,114142,5830,Brazil,B17,NA,NA,NA,NA
silence,116874,119075,2201,Brazil,B17,NA,NA,NA,NA
silence,120309,124482,4173,Brazil,B17,NA,NA,NA,NA
silence,125832,130692,4860,Brazil,B17,NA,NA,NA,NA
silence,133542,137992,4450,Brazil,B17,NA,NA,NA,NA
silence,140212,141342,1130,Brazil,B17,NA,NA,NA,NA
silence,141802,150432,8630,Brazil,B17,NA,NA,NA,NA
silence,168402,176702,8300,Brazil,B17,NA,NA,NA,NA
silence,179212,179782,570,Brazil,B17,NA,NA,NA,NA
silence,180492,181652,1160,Brazil,B17,NA,NA,NA,NA
silence,183649,188192,4543,Brazil,B17,NA,NA,NA,NA
silence,189802,198884,9082,Brazil,B17,NA,NA,NA,NA
silence,200395,208658,8263,Brazil,B17,NA,NA,NA,NA
silence,210284,211992,1708,Brazil,B17,NA,NA,NA,NA
silence,213282,215233,1951,Brazil,B17,NA,NA,NA,NA
silence,216216,217892,1676,Brazil,B17,NA,NA,NA,NA
silence,221812,223565,1753,Brazil,B17,NA,NA,NA,NA
silence,225085,225692,607,Brazil,B17,NA,NA,NA,NA
silence,228739,228875,136,Brazil,B17,NA,NA,NA,NA
silence,230712,238582,7870,Brazil,B17,NA,NA,NA,NA
silence,239522,241229,1707,Brazil,B17,NA,NA,NA,NA
silence,241859,245172,3313,Brazil,B17,NA,NA,NA,NA
mother_gesture,245273,245834,561,Brazil,B17,NA,NA,NA,NA
silence,246042,248397,2355,Brazil,B17,NA,NA,NA,NA
mother_gesture,258619,258979,360,Brazil,B17,NA,NA,NA,NA
mother_gesture,259309,260429,1120,Brazil,B17,NA,NA,NA,NA
mother_gesture,267037,268199,1162,Brazil,B17,NA,NA,NA,NA
silence,283032,288402,5370,Brazil,B17,NA,NA,NA,NA
silence,289662,289682,20,Brazil,B17,NA,NA,NA,NA
silence,313942,318192,4250,Brazil,B17,NA,NA,NA,NA
silence,319892,322092,2200,Brazil,B17,NA,NA,NA,NA
silence,337178,337872,694,Brazil,B17,NA,NA,NA,NA
silence,338462,339072,610,Brazil,B17,NA,NA,NA,NA
silence,339752,341895,2143,Brazil,B17,NA,NA,NA,NA
child_gesture,344922,346062,1140,Brazil,B17,NA,NA,NA,NA
father_gesture,345724,346450,726,Brazil,B17,NA,NA,NA,NA
silence,347515,349135,1620,Brazil,B17,NA,NA,NA,NA
silence,350735,351652,917,Brazil,B17,NA,NA,NA,NA
silence,352258,353692,1434,Brazil,B17,NA,NA,NA,NA
silence,354782,355016,234,Brazil,B17,NA,NA,NA,NA
mother_gesture,356547,356811,264,Brazil,B17,NA,NA,NA,NA
silence,361182,370499,9317,Brazil,B17,NA,NA,NA,NA
silence,372666,377102,4436,Brazil,B17,NA,NA,NA,NA
silence,379085,394558,15473,Brazil,B17,NA,NA,NA,NA
silence,395734,403462,7728,Brazil,B17,NA,NA,NA,NA
silence,405562,408242,2680,Brazil,B17,NA,NA,NA,NA
silence,409679,412212,2533,Brazil,B17,NA,NA,NA,NA
silence,412822,414592,1770,Brazil,B17,NA,NA,NA,NA
child_gesture,441472,447402,5930,Brazil,B17,NA,NA,NA,NA
child,441554,442912,1358,Brazil,B17,NA,NA,NA,NA
silence,444882,445328,446,Brazil,B17,NA,NA,NA,NA
silence,448072,449592,1520,Brazil,B17,NA,NA,NA,NA
silence,473782,476402,2620,Brazil,B17,NA,NA,NA,NA
mother_gesture,482940,483336,396,Brazil,B17,NA,NA,NA,NA
silence,488227,488322,95,Brazil,B17,NA,NA,NA,NA
silence,492278,492282,4,Brazil,B17,NA,NA,NA,NA
mother_gesture,493197,494451,1254,Brazil,B17,NA,NA,NA,NA
silence,496512,497512,1000,Brazil,B17,NA,NA,NA,NA
silence,536282,536522,240,Brazil,B17,NA,NA,NA,NA
mother_gesture,539340,539769,429,Brazil,B17,NA,NA,NA,NA
silence,539972,542412,2440,Brazil,B17,NA,NA,NA,NA
silence,583912,587882,3970,Brazil,B17,NA,NA,NA,NA
silence,589482,593032,3550,Brazil,B17,NA,NA,NA,NA
silence,600072,600336,264,Brazil,B17,NA,NA,NA,NA
child,232,2230,1998,Brazil,B18,b,1,1,q
father,2823,3640,817,Brazil,B18,c,1,2,i
mother,3293,3781,488,Brazil,B18,c,1,3,a
child,3641,5060,1419,Brazil,B18,f,1,4,q
father,4706,5390,684,Brazil,B18,c,1,5,i
child,5358,8140,2782,Brazil,B18,f,1,6,a
father,7724,10020,2296,Brazil,B18,c,1,7,i
child,10426,11388,962,Brazil,B18,f,1,8,a
mother,11953,13842,1889,Brazil,B18,b,1,9,a
child,15570,16279,709,Brazil,B18,b,1,10,a
child,19850,22520,2670,Brazil,B18,b,1,11,NA
child,24744,29420,4676,Brazil,B18,b,1,12,a
father,29570,31220,1650,Brazil,B18,c,1,13,i
child,32135,33190,1055,Brazil,B18,m,1,14,a
mother,33460,34010,550,Brazil,B18,c,1,15,a
father,36900,37490,590,Brazil,B18,c,1,16,i
child,38361,39377,1016,Brazil,B18,f,1,17,a
mother,38730,39830,1100,Brazil,B18,c,1,18,a
mother,42070,42750,680,Brazil,B18,c,1,19,q
child,43120,43670,550,Brazil,B18,m,1,20,a
mother,44960,47960,3000,Brazil,B18,c,1,21,i
child,51290,52571,1281,Brazil,B18,m,1,22,a
mother,52689,53820,1131,Brazil,B18,c,1,23,q
child,54038,54960,922,Brazil,B18,m,1,24,a
mother,55900,57791,1891,Brazil,B18,c,1,25,a
child,58008,61150,3142,Brazil,B18,m,1,26,a
mother,63995,67040,3045,Brazil,B18,c,1,27,a
child,65850,67050,1200,Brazil,B18,c,1,28,a
child,69960,72280,2320,Brazil,B18,m,1,29,i
mother,72790,74210,1420,Brazil,B18,c,1,30,i
mother,77440,78900,1460,Brazil,B18,c,1,31,a
child,78420,80090,1670,Brazil,B18,m,1,32,a
father,69560,71722,2162,Brazil,B18,c,2,1,a
father,74100,75366,1266,Brazil,B18,c,2,2,i
child,75491,76183,692,Brazil,B18,f,2,3,a
mother,94310,95250,940,Brazil,B18,c,3,1,q
child,95638,96001,363,Brazil,B18,m,3,2,a
mother,98730,99370,640,Brazil,B18,c,3,3,i
child,104170,108940,4770,Brazil,B18,m,3,4,a
mother,108380,108845,465,Brazil,B18,c,3,5,i
child,109600,110850,1250,Brazil,B18,m,3,6,a
mother,131097,132632,1535,Brazil,B18,c,3,7,a
child,133330,136080,2750,Brazil,B18,m,3,8,q
mother,136212,137225,1013,Brazil,B18,c,3,9,i
child,137091,138130,1039,Brazil,B18,m,3,10,i
mother,140240,141630,1390,Brazil,B18,c,3,11,i
child,142512,143631,1119,Brazil,B18,m,3,12,q
mother,143930,144690,760,Brazil,B18,c,3,13,a
child,145470,147820,2350,Brazil,B18,f,3,14,q
child,149910,151010,1100,Brazil,B18,f,3,15,q
child,153960,154960,1000,Brazil,B18,f,3,16,q
mother,155741,157174,1433,Brazil,B18,c,3,17,q
child,157200,166060,8860,Brazil,B18,m,3,18,a
mother,165820,166420,600,Brazil,B18,c,3,19,a
mother,170618,172004,1386,Brazil,B18,f,3,20,a
child,171220,171764,544,Brazil,B18,b,3,21,a
child,175314,177486,2172,Brazil,B18,b,3,22,a
child,178854,181479,2625,Brazil,B18,m,3,23,a
mother,181097,182387,1290,Brazil,B18,c,3,24,q
mother,189270,190160,890,Brazil,B18,c,3,25,i
child,191390,193278,1888,Brazil,B18,m,3,26,a
mother,194970,200620,5650,Brazil,B18,c,3,27,a
child,196333,197278,945,Brazil,B18,m,3,28,a
child,209880,213180,3300,Brazil,B18,m,3,29,a
mother,210635,211310,675,Brazil,B18,c,3,30,a
child,221200,223710,2510,Brazil,B18,m,3,31,a
child,225912,226784,872,Brazil,B18,m,3,32,a
mother,226708,227186,478,Brazil,B18,m,3,33,a
child,227310,229158,1848,Brazil,B18,m,3,34,a
father,228700,230340,1640,Brazil,B18,c,3,35,i
child,231040,233080,2040,Brazil,B18,f,3,36,q
mother,233703,234330,627,Brazil,B18,c,3,37,a
child,234940,238990,4050,Brazil,B18,m,3,38,q
mother,239006,240812,1806,Brazil,B18,c,3,39,a
child,245710,246760,1050,Brazil,B18,m,3,40,a
mother,246830,247590,760,Brazil,B18,c,3,41,a
child,247590,250060,2470,Brazil,B18,m,3,42,q
mother,252970,254166,1196,Brazil,B18,c,3,43,a
child,260560,261080,520,Brazil,B18,m,3,44,a
mother,261260,261760,500,Brazil,B18,c,3,45,q
child,261701,262950,1249,Brazil,B18,m,3,46,a
mother,262950,267190,4240,Brazil,B18,c,3,47,a
child,124690,131100,6410,Brazil,B18,m,4,1,q
father,172440,173826,1386,Brazil,B18,m,4,2,i
child,284818,285399,581,Brazil,B18,m,5,1,a
mother,290782,291444,662,Brazil,B18,c,5,2,q
child,291670,292150,480,Brazil,B18,m,5,3,q
mother,292350,294680,2330,Brazil,B18,c,5,4,q
mother,301609,302508,899,Brazil,B18,c,5,5,a
child,302720,303585,865,Brazil,B18,m,5,6,a
mother,303564,304450,886,Brazil,B18,c,5,7,q
child,305432,306017,585,Brazil,B18,m,5,8,q
mother,306352,307295,943,Brazil,B18,c,5,9,q
child,307506,308119,613,Brazil,B18,m,5,10,a
mother,309200,311025,1825,Brazil,B18,c,5,11,a
child,311470,312838,1368,Brazil,B18,m,5,12,a
mother,312420,312937,517,Brazil,B18,c,5,13,q
child,313670,314210,540,Brazil,B18,m,5,14,a
mother,314400,315810,1410,Brazil,B18,c,5,15,a
child,315109,317670,2561,Brazil,B18,m,5,16,a
mother,319760,320400,640,Brazil,B18,c,5,17,i
mother,28790,29410,620,Brazil,B18,c,6,1,q
child,331390,332000,610,Brazil,B18,m,6,2,a
mother,332690,337540,4850,Brazil,B18,c,6,3,a
child,337610,339710,2100,Brazil,B18,m,6,4,a
mother,339740,340720,980,Brazil,B18,c,6,5,a
child,341070,341529,459,Brazil,B18,m,6,6,a
mother,341762,342560,798,Brazil,B18,c,6,7,a
child,343058,343685,627,Brazil,B18,m,6,8,q
child,345332,345933,601,Brazil,B18,m,6,9,a
mother,345920,346290,370,Brazil,B18,c,6,10,a
child,347190,348210,1020,Brazil,B18,m,6,11,a
mother,348148,349040,892,Brazil,B18,c,6,12,a
child,348917,351540,2623,Brazil,B18,m,6,13,a
mother,351160,352771,1611,Brazil,B18,c,6,14,a
child,354660,355046,386,Brazil,B18,m,6,15,a
mother,358581,362350,3769,Brazil,B18,c,6,16,i
child,364230,365023,793,Brazil,B18,m,6,17,a
mother,365030,366430,1400,Brazil,B18,c,6,18,a
child,365280,366260,980,Brazil,B18,m,6,19,a
mother,367086,367615,529,Brazil,B18,c,6,20,q
child,368188,369279,1091,Brazil,B18,m,6,21,a
mother,369534,370802,1268,Brazil,B18,c,6,22,a
child,371040,371360,320,Brazil,B18,m,6,23,a
mother,371653,372095,442,Brazil,B18,c,6,24,q
child,372329,373730,1401,Brazil,B18,m,6,25,a
child,379600,382350,2750,Brazil,B18,m,6,26,a
mother,382920,384250,1330,Brazil,B18,c,6,27,i
child,384360,384905,545,Brazil,B18,m,6,28,a
mother,390300,391060,760,Brazil,B18,c,6,29,a
child,391953,392830,877,Brazil,B18,m,6,30,a
mother,392620,395410,2790,Brazil,B18,c,6,31,q
child,395710,396510,800,Brazil,B18,m,6,32,a
mother,396697,401050,4353,Brazil,B18,c,6,33,a
child,401207,404790,3583,Brazil,B18,m,6,34,a
mother,404725,406320,1595,Brazil,B18,c,6,35,q
child,406713,408337,1624,Brazil,B18,m,6,36,a
mother,408381,411600,3219,Brazil,B18,c,6,37,a
child,412760,413227,467,Brazil,B18,m,6,38,a
mother,413910,414568,658,Brazil,B18,c,6,39,i
child,414970,417580,2610,Brazil,B18,m,6,40,a
mother,417578,418631,1053,Brazil,B18,c,6,41,a
child,419290,422970,3680,Brazil,B18,m,6,42,a
child,439206,446860,7654,Brazil,B18,f,6,43,i
mother,446711,447316,605,Brazil,B18,b,6,44,a
child,447748,450234,2486,Brazil,B18,f,6,45,a
mother,450310,451680,1370,Brazil,B18,c,6,46,a
child,452830,453321,491,Brazil,B18,m,6,47,q
mother,453693,454473,780,Brazil,B18,c,6,48,i
child,455420,456397,977,Brazil,B18,m,6,49,a
mother,456580,457500,920,Brazil,B18,c,6,50,a
child,457736,459700,1964,Brazil,B18,m,6,51,a
mother,460060,461042,982,Brazil,B18,c,6,52,i
child,461424,461961,537,Brazil,B18,m,6,53,a
mother,464880,465440,560,Brazil,B18,c,6,54,a
child,465960,486350,20390,Brazil,B18,m,6,55,a
mother,486650,487198,548,Brazil,B18,c,6,56,a
child,487655,488474,819,Brazil,B18,m,6,57,a
father,375859,377679,1820,Brazil,B18,m,7,1,a
mother,377918,378970,1052,Brazil,B18,f,7,2,a
child,505430,507110,1680,Brazil,B18,m,7,3,a
mother,507130,507740,610,Brazil,B18,c,7,4,q
child,507734,509770,2036,Brazil,B18,m,7,5,a
mother,509500,510878,1378,Brazil,B18,c,7,6,i
child,510848,512219,1371,Brazil,B18,m,7,7,a
mother,512410,513179,769,Brazil,B18,c,7,8,a
child,513286,513977,691,Brazil,B18,m,7,9,a
child,524941,529310,4369,Brazil,B18,m,8,1,a
mother,536890,537500,610,Brazil,B18,c,8,2,i
child,538220,539022,802,Brazil,B18,m,8,3,a
child,545630,547390,1760,Brazil,B18,m,8,4,a
child,550239,554000,3761,Brazil,B18,m,8,5,a
child,557600,558542,942,Brazil,B18,m,8,6,a
mother,563629,566850,3221,Brazil,B18,c,8,7,a
child,568280,568889,609,Brazil,B18,m,8,8,a
mother,569542,570169,627,Brazil,B18,c,8,9,a
child,571050,582860,11810,Brazil,B18,m,8,10,a
child,587610,594010,6400,Brazil,B18,m,8,11,a
child,429030,429660,630,Brazil,B18,m,20,1,a
silence,2230,2823,593,Brazil,B18,NA,NA,NA,NA
silence,10020,10426,406,Brazil,B18,NA,NA,NA,NA
silence,11388,11953,565,Brazil,B18,NA,NA,NA,NA
silence,13842,15570,1728,Brazil,B18,NA,NA,NA,NA
silence,16279,19850,3571,Brazil,B18,NA,NA,NA,NA
silence,22520,24744,2224,Brazil,B18,NA,NA,NA,NA
child_gesture,26756,27812,1056,Brazil,B18,NA,NA,NA,NA
silence,29420,29570,150,Brazil,B18,NA,NA,NA,NA
silence,31220,32135,915,Brazil,B18,NA,NA,NA,NA
silence,33190,33460,270,Brazil,B18,NA,NA,NA,NA
silence,34010,36900,2890,Brazil,B18,NA,NA,NA,NA
silence,37490,38361,871,Brazil,B18,NA,NA,NA,NA
silence,39830,42070,2240,Brazil,B18,NA,NA,NA,NA
silence,42750,43120,370,Brazil,B18,NA,NA,NA,NA
silence,43670,44960,1290,Brazil,B18,NA,NA,NA,NA
mother_gesture,46481,47860,1379,Brazil,B18,NA,NA,NA,NA
silence,47960,51290,3330,Brazil,B18,NA,NA,NA,NA
silence,52571,52689,118,Brazil,B18,NA,NA,NA,NA
silence,53820,54038,218,Brazil,B18,NA,NA,NA,NA
silence,54960,55900,940,Brazil,B18,NA,NA,NA,NA
silence,57791,58008,217,Brazil,B18,NA,NA,NA,NA
silence,61150,63995,2845,Brazil,B18,NA,NA,NA,NA
silence,67050,69560,2510,Brazil,B18,NA,NA,NA,NA
child_gesture,70211,73900,3689,Brazil,B18,NA,NA,NA,NA
silence,72280,72790,510,Brazil,B18,NA,NA,NA,NA
silence,75366,75491,125,Brazil,B18,NA,NA,NA,NA
silence,76183,77440,1257,Brazil,B18,NA,NA,NA,NA
child_gesture,79812,80241,429,Brazil,B18,NA,NA,NA,NA
silence,80090,94310,14220,Brazil,B18,NA,NA,NA,NA
silence,95250,95638,388,Brazil,B18,NA,NA,NA,NA
silence,96001,98730,2729,Brazil,B18,NA,NA,NA,NA
silence,99370,104170,4800,Brazil,B18,NA,NA,NA,NA
silence,108940,109600,660,Brazil,B18,NA,NA,NA,NA
silence,110850,124690,13840,Brazil,B18,NA,NA,NA,NA
silence,132632,133330,698,Brazil,B18,NA,NA,NA,NA
silence,136080,136212,132,Brazil,B18,NA,NA,NA,NA
silence,138130,140240,2110,Brazil,B18,NA,NA,NA,NA
silence,141630,142512,882,Brazil,B18,NA,NA,NA,NA
silence,143631,143930,299,Brazil,B18,NA,NA,NA,NA
silence,144690,145470,780,Brazil,B18,NA,NA,NA,NA
silence,147820,149910,2090,Brazil,B18,NA,NA,NA,NA
silence,151010,153960,2950,Brazil,B18,NA,NA,NA,NA
silence,154960,155741,781,Brazil,B18,NA,NA,NA,NA
silence,157174,157200,26,Brazil,B18,NA,NA,NA,NA
silence,166420,170618,4198,Brazil,B18,NA,NA,NA,NA
silence,172004,172440,436,Brazil,B18,NA,NA,NA,NA
silence,173826,175314,1488,Brazil,B18,NA,NA,NA,NA
silence,177486,178854,1368,Brazil,B18,NA,NA,NA,NA
silence,182387,189270,6883,Brazil,B18,NA,NA,NA,NA
silence,190160,191390,1230,Brazil,B18,NA,NA,NA,NA
silence,193278,194970,1692,Brazil,B18,NA,NA,NA,NA
silence,200620,209880,9260,Brazil,B18,NA,NA,NA,NA
silence,213180,221200,8020,Brazil,B18,NA,NA,NA,NA
silence,223710,225912,2202,Brazil,B18,NA,NA,NA,NA
silence,227186,227310,124,Brazil,B18,NA,NA,NA,NA
silence,230340,231040,700,Brazil,B18,NA,NA,NA,NA
silence,233080,233703,623,Brazil,B18,NA,NA,NA,NA
silence,234330,234940,610,Brazil,B18,NA,NA,NA,NA
child_gesture,235274,236187,913,Brazil,B18,NA,NA,NA,NA
silence,238990,239006,16,Brazil,B18,NA,NA,NA,NA
silence,240812,245710,4898,Brazil,B18,NA,NA,NA,NA
silence,246760,246830,70,Brazil,B18,NA,NA,NA,NA
silence,250060,252970,2910,Brazil,B18,NA,NA,NA,NA
silence,254166,260560,6394,Brazil,B18,NA,NA,NA,NA
silence,261080,261260,180,Brazil,B18,NA,NA,NA,NA
silence,267190,284818,17628,Brazil,B18,NA,NA,NA,NA
silence,285399,290782,5383,Brazil,B18,NA,NA,NA,NA
silence,291444,291670,226,Brazil,B18,NA,NA,NA,NA
silence,292150,292350,200,Brazil,B18,NA,NA,NA,NA
silence,294680,301609,6929,Brazil,B18,NA,NA,NA,NA
silence,302508,302720,212,Brazil,B18,NA,NA,NA,NA
silence,304450,305432,982,Brazil,B18,NA,NA,NA,NA
silence,306017,306352,335,Brazil,B18,NA,NA,NA,NA
silence,307295,307506,211,Brazil,B18,NA,NA,NA,NA
silence,308119,309200,1081,Brazil,B18,NA,NA,NA,NA
silence,311025,311470,445,Brazil,B18,NA,NA,NA,NA
silence,312937,313670,733,Brazil,B18,NA,NA,NA,NA
silence,314210,314400,190,Brazil,B18,NA,NA,NA,NA
silence,317670,319760,2090,Brazil,B18,NA,NA,NA,NA
silence,320400,331390,10990,Brazil,B18,NA,NA,NA,NA
silence,332000,332690,690,Brazil,B18,NA,NA,NA,NA
silence,337540,337610,70,Brazil,B18,NA,NA,NA,NA
silence,339710,339740,30,Brazil,B18,NA,NA,NA,NA
silence,340720,341070,350,Brazil,B18,NA,NA,NA,NA
silence,341529,341762,233,Brazil,B18,NA,NA,NA,NA
silence,342560,343058,498,Brazil,B18,NA,NA,NA,NA
silence,343685,343870,185,Brazil,B18,NA,NA,NA,NA
mother,343870,344900,1030,Brazil,B18,c,NA,NA,i
silence,344900,345332,432,Brazil,B18,NA,NA,NA,NA
silence,346290,347190,900,Brazil,B18,NA,NA,NA,NA
silence,352771,354660,1889,Brazil,B18,NA,NA,NA,NA
silence,355046,355746,700,Brazil,B18,NA,NA,NA,NA
mother,355746,356291,545,Brazil,B18,c,NA,NA,a
silence,356291,358581,2290,Brazil,B18,NA,NA,NA,NA
silence,362350,364230,1880,Brazil,B18,NA,NA,NA,NA
silence,365023,365030,7,Brazil,B18,NA,NA,NA,NA
silence,366430,367086,656,Brazil,B18,NA,NA,NA,NA
silence,367615,368188,573,Brazil,B18,NA,NA,NA,NA
silence,369279,369534,255,Brazil,B18,NA,NA,NA,NA
silence,370802,371040,238,Brazil,B18,NA,NA,NA,NA
silence,371360,371653,293,Brazil,B18,NA,NA,NA,NA
silence,372095,372329,234,Brazil,B18,NA,NA,NA,NA
silence,373730,375859,2129,Brazil,B18,NA,NA,NA,NA
silence,377679,377918,239,Brazil,B18,NA,NA,NA,NA
silence,378970,379600,630,Brazil,B18,NA,NA,NA,NA
silence,382350,382920,570,Brazil,B18,NA,NA,NA,NA
silence,384250,384360,110,Brazil,B18,NA,NA,NA,NA
silence,384905,390300,5395,Brazil,B18,NA,NA,NA,NA
silence,391060,391953,893,Brazil,B18,NA,NA,NA,NA
silence,395410,395710,300,Brazil,B18,NA,NA,NA,NA
silence,396510,396697,187,Brazil,B18,NA,NA,NA,NA
silence,401050,401207,157,Brazil,B18,NA,NA,NA,NA
silence,406320,406713,393,Brazil,B18,NA,NA,NA,NA
silence,408337,408381,44,Brazil,B18,NA,NA,NA,NA
silence,411600,412760,1160,Brazil,B18,NA,NA,NA,NA
silence,413227,413910,683,Brazil,B18,NA,NA,NA,NA
silence,414568,414970,402,Brazil,B18,NA,NA,NA,NA
silence,418631,419290,659,Brazil,B18,NA,NA,NA,NA
silence,422970,429030,6060,Brazil,B18,NA,NA,NA,NA
silence,429660,439206,9546,Brazil,B18,NA,NA,NA,NA
silence,447316,447748,432,Brazil,B18,NA,NA,NA,NA
silence,450234,450310,76,Brazil,B18,NA,NA,NA,NA
silence,451680,452830,1150,Brazil,B18,NA,NA,NA,NA
silence,453321,453693,372,Brazil,B18,NA,NA,NA,NA
silence,454473,455420,947,Brazil,B18,NA,NA,NA,NA
silence,456397,456580,183,Brazil,B18,NA,NA,NA,NA
silence,457500,457736,236,Brazil,B18,NA,NA,NA,NA
silence,459700,460060,360,Brazil,B18,NA,NA,NA,NA
silence,461042,461424,382,Brazil,B18,NA,NA,NA,NA
silence,461961,464880,2919,Brazil,B18,NA,NA,NA,NA
silence,465440,465960,520,Brazil,B18,NA,NA,NA,NA
silence,486350,486650,300,Brazil,B18,NA,NA,NA,NA
silence,487198,487655,457,Brazil,B18,NA,NA,NA,NA
silence,488474,505430,16956,Brazil,B18,NA,NA,NA,NA
silence,507110,507130,20,Brazil,B18,NA,NA,NA,NA
silence,512219,512410,191,Brazil,B18,NA,NA,NA,NA
silence,513179,513286,107,Brazil,B18,NA,NA,NA,NA
silence,513977,524941,10964,Brazil,B18,NA,NA,NA,NA
silence,529310,536890,7580,Brazil,B18,NA,NA,NA,NA
silence,537500,538220,720,Brazil,B18,NA,NA,NA,NA
silence,539022,545630,6608,Brazil,B18,NA,NA,NA,NA
silence,547390,550239,2849,Brazil,B18,NA,NA,NA,NA
silence,554000,557600,3600,Brazil,B18,NA,NA,NA,NA
silence,558542,563629,5087,Brazil,B18,NA,NA,NA,NA
silence,566850,568280,1430,Brazil,B18,NA,NA,NA,NA
silence,568889,569542,653,Brazil,B18,NA,NA,NA,NA
silence,570169,571050,881,Brazil,B18,NA,NA,NA,NA
silence,582860,587610,4750,Brazil,B18,NA,NA,NA,NA
mother,30,2640,2610,Ecuador,E01,c,1,1,i
mother,8980,9970,990,Ecuador,E01,f,2,1,a
father,11010,12510,1500,Ecuador,E01,m,2,2,a
child,9700,13590,3890,Ecuador,E01,m,3,1,q
mother,13960,15210,1250,Ecuador,E01,c,3,2,a
child,15510,16330,820,Ecuador,E01,m,3,3,q
mother,16420,17450,1030,Ecuador,E01,c,3,4,a
child,18810,24630,5820,Ecuador,E01,m,3,5,a
mother,36010,36870,860,Ecuador,E01,f,4,1,a
father,39010,40360,1350,Ecuador,E01,m,5,1,i
child,46920,47660,740,Ecuador,E01,m,6,1,q
mother,48910,52780,3870,Ecuador,E01,c,6,2,i
child,52540,53500,960,Ecuador,E01,f,6,3,a
child,56230,57060,830,Ecuador,E01,m,6,4,q
mother,57140,57750,610,Ecuador,E01,c,6,5,q
father,57610,58370,760,Ecuador,E01,c,6,6,i
child,59290,59960,670,Ecuador,E01,b,6,7,a
mother,60200,62340,2140,Ecuador,E01,c,6,8,a
child,61910,62770,860,Ecuador,E01,m,6,9,a
father,101690,102400,710,Ecuador,E01,m,7,1,a
mother,103650,104740,1090,Ecuador,E01,f,7,2,i
child,104760,106150,1390,Ecuador,E01,b,7,3,q
mother,107630,109470,1840,Ecuador,E01,c,7,4,i
child,110360,111330,970,Ecuador,E01,m,7,5,q
mother,112120,113080,960,Ecuador,E01,c,7,6,a
mother,115470,116270,800,Ecuador,E01,c,7,7,i
mother,119140,120760,1620,Ecuador,E01,c,7,8,i
child,120710,121740,1030,Ecuador,E01,m,7,9,a
mother,122060,125820,3760,Ecuador,E01,c,7,10,a
mother,138660,141780,3120,Ecuador,E01,c,8,1,i
father,152630,153960,1330,Ecuador,E01,m,9,1,a
father,157070,158840,1770,Ecuador,E01,m,9,2,a
mother,160180,162200,2020,Ecuador,E01,f,9,3,a
father,165090,166150,1060,Ecuador,E01,m,9,4,q
mother,171320,171860,540,Ecuador,E01,f,9,5,a
father,172850,174150,1300,Ecuador,E01,m,9,6,a
mother,178340,181670,3330,Ecuador,E01,f,9,7,a
child,165090,167990,2900,Ecuador,E01,m,10,1,a
child,169920,171000,1080,Ecuador,E01,b,10,2,a
child,181490,182630,1140,Ecuador,E01,b,11,1,a
father,189720,194200,4480,Ecuador,E01,m,12,1,a
mother,212090,219160,7070,Ecuador,E01,f,13,1,q
father,219440,221370,1930,Ecuador,E01,m,13,2,q
mother,221080,221980,900,Ecuador,E01,f,13,3,q
father,222610,223640,1030,Ecuador,E01,m,13,4,a
mother,228310,228980,670,Ecuador,E01,c,14,1,i
mother,232590,235530,2940,Ecuador,E01,c,14,2,i
father,235630,236960,1330,Ecuador,E01,c,14,3,i
mother,236850,238110,1260,Ecuador,E01,c,14,4,q
child,237890,239400,1510,Ecuador,E01,m,14,5,a
father,242720,243540,820,Ecuador,E01,c,14,6,i
mother,248240,249480,1240,Ecuador,E01,c,14,7,a
father,249940,250660,720,Ecuador,E01,c,14,8,q
child,230050,232630,2580,Ecuador,E01,m,15,1,q
father,252990,256730,3740,Ecuador,E01,c,16,1,a
child,260030,261200,1170,Ecuador,E01,f,17,1,i
mother,261440,262120,680,Ecuador,E01,c,17,2,q
child,262200,262990,790,Ecuador,E01,b,17,3,q
mother,263010,264170,1160,Ecuador,E01,c,17,4,a
father,267980,268940,960,Ecuador,E01,c,17,5,i
mother,271770,272650,880,Ecuador,E01,c,17,6,i
child,273670,274280,610,Ecuador,E01,m,17,7,a
father,282000,282710,710,Ecuador,E01,c,17,8,i
child,283550,284130,580,Ecuador,E01,f,17,9,q
father,284680,286430,1750,Ecuador,E01,c,17,10,a
child,291360,292070,710,Ecuador,E01,b,18,1,q
father,293280,294590,1310,Ecuador,E01,c,18,2,a
child,296300,297600,1300,Ecuador,E01,m,18,3,a
mother,297630,298870,1240,Ecuador,E01,c,19,1,i
mother,301670,307120,5450,Ecuador,E01,c,19,2,i
mother,309460,310540,1080,Ecuador,E01,c,19,3,a
child,313120,315140,2020,Ecuador,E01,m,19,4,q
mother,315110,316000,890,Ecuador,E01,c,19,5,a
mother,318530,320540,2010,Ecuador,E01,c,19,6,a
mother,345400,346400,1000,Ecuador,E01,c,20,1,q
child,346400,348670,2270,Ecuador,E01,b,21,1,a
mother,350090,351230,1140,Ecuador,E01,c,21,2,a
child,351300,356330,5030,Ecuador,E01,b,21,3,q
father,356460,358150,1690,Ecuador,E01,c,21,4,a
mother,367370,368080,710,Ecuador,E01,c,22,1,i
child,368240,370440,2200,Ecuador,E01,b,23,1,a
mother,370870,372120,1250,Ecuador,E01,c,23,2,a
child,375890,376800,910,Ecuador,E01,b,23,3,a
mother,378410,379270,860,Ecuador,E01,c,23,4,a
father,384950,390280,5330,Ecuador,E01,m,23,5,a
child,422790,423690,900,Ecuador,E01,b,24,1,a
mother,424320,424950,630,Ecuador,E01,c,24,2,a
child,425610,427070,1460,Ecuador,E01,m,24,3,q
father,442150,443440,1290,Ecuador,E01,m,25,1,q
mother,448180,449270,1090,Ecuador,E01,f,25,2,a
mother,466720,467360,640,Ecuador,E01,b,26,1,a
father,468060,469930,1870,Ecuador,E01,m,26,2,q
mother,470250,475390,5140,Ecuador,E01,f,26,3,a
father,476340,480240,3900,Ecuador,E01,m,26,4,a
father,548190,550250,2060,Ecuador,E01,m,27,1,q
mother,551370,552350,980,Ecuador,E01,f,27,2,a
father,552340,554520,2180,Ecuador,E01,m,28,1,a
mother,554650,555210,560,Ecuador,E01,f,28,2,a
father,556080,558970,2890,Ecuador,E01,m,28,3,a
mother,560450,561650,1200,Ecuador,E01,f,28,4,a
father,562810,564670,1860,Ecuador,E01,m,28,5,a
mother,566090,567320,1230,Ecuador,E01,f,29,1,q
father,567350,568480,1130,Ecuador,E01,m,29,2,a
mother,569760,570690,930,Ecuador,E01,f,29,3,a
mother,574300,575310,1010,Ecuador,E01,c,30,1,i
child,576580,577660,1080,Ecuador,E01,m,30,2,q
mother,577990,582270,4280,Ecuador,E01,c,30,3,i
father,583730,584530,800,Ecuador,E01,c,30,4,q
mother,584950,587650,2700,Ecuador,E01,c,30,5,a
child,591080,594640,3560,Ecuador,E01,m,30,6,a
father,587940,589060,1120,Ecuador,E01,m,31,1,a
silence,2640,8980,6340,Ecuador,E01,NA,NA,NA,NA
child_gesture,10151,11091,940,Ecuador,E01,NA,NA,NA,NA
father_gesture,11447,12132,685,Ecuador,E01,NA,NA,NA,NA
child_gesture,11903,12819,916,Ecuador,E01,NA,NA,NA,NA
child_gesture,13326,14384,1058,Ecuador,E01,NA,NA,NA,NA
silence,13590,13960,370,Ecuador,E01,NA,NA,NA,NA
silence,15210,15510,300,Ecuador,E01,NA,NA,NA,NA
silence,16330,16420,90,Ecuador,E01,NA,NA,NA,NA
silence,17450,18810,1360,Ecuador,E01,NA,NA,NA,NA
silence,24630,36010,11380,Ecuador,E01,NA,NA,NA,NA
silence,36870,39010,2140,Ecuador,E01,NA,NA,NA,NA
silence,40360,46920,6560,Ecuador,E01,NA,NA,NA,NA
child_gesture,47164,48069,905,Ecuador,E01,NA,NA,NA,NA
silence,47660,48910,1250,Ecuador,E01,NA,NA,NA,NA
mother_gesture,50600,52512,1912,Ecuador,E01,NA,NA,NA,NA
silence,53500,56230,2730,Ecuador,E01,NA,NA,NA,NA
silence,57060,57140,80,Ecuador,E01,NA,NA,NA,NA
silence,58370,59290,920,Ecuador,E01,NA,NA,NA,NA
silence,59960,60200,240,Ecuador,E01,NA,NA,NA,NA
silence,62770,101690,38920,Ecuador,E01,NA,NA,NA,NA
silence,102400,103650,1250,Ecuador,E01,NA,NA,NA,NA
silence,104740,104760,20,Ecuador,E01,NA,NA,NA,NA
silence,106150,107630,1480,Ecuador,E01,NA,NA,NA,NA
mother_gesture,107335,108799,1464,Ecuador,E01,NA,NA,NA,NA
silence,109470,110360,890,Ecuador,E01,NA,NA,NA,NA
silence,111330,112120,790,Ecuador,E01,NA,NA,NA,NA
silence,113080,115470,2390,Ecuador,E01,NA,NA,NA,NA
silence,116270,119140,2870,Ecuador,E01,NA,NA,NA,NA
silence,121740,122060,320,Ecuador,E01,NA,NA,NA,NA
silence,125820,138660,12840,Ecuador,E01,NA,NA,NA,NA
mother_gesture,139082,141308,2226,Ecuador,E01,NA,NA,NA,NA
silence,141780,152630,10850,Ecuador,E01,NA,NA,NA,NA
father_gesture,152447,153878,1431,Ecuador,E01,NA,NA,NA,NA
silence,153960,157070,3110,Ecuador,E01,NA,NA,NA,NA
silence,158840,160180,1340,Ecuador,E01,NA,NA,NA,NA
silence,162200,165090,2890,Ecuador,E01,NA,NA,NA,NA
father_gesture,164510,166637,2127,Ecuador,E01,NA,NA,NA,NA
silence,167990,169920,1930,Ecuador,E01,NA,NA,NA,NA
silence,171000,171320,320,Ecuador,E01,NA,NA,NA,NA
silence,171860,172850,990,Ecuador,E01,NA,NA,NA,NA
silence,174150,178340,4190,Ecuador,E01,NA,NA,NA,NA
silence,182630,189720,7090,Ecuador,E01,NA,NA,NA,NA
father_gesture,189055,190945,1890,Ecuador,E01,NA,NA,NA,NA
father_gesture,191821,192735,914,Ecuador,E01,NA,NA,NA,NA
silence,194200,212090,17890,Ecuador,E01,NA,NA,NA,NA
father_gesture,213850,215486,1636,Ecuador,E01,NA,NA,NA,NA
father_gesture,215660,216836,1176,Ecuador,E01,NA,NA,NA,NA
silence,219160,219440,280,Ecuador,E01,NA,NA,NA,NA
father_gesture,220520,221883,1363,Ecuador,E01,NA,NA,NA,NA
silence,221980,222610,630,Ecuador,E01,NA,NA,NA,NA
father_gesture,222600,224024,1424,Ecuador,E01,NA,NA,NA,NA
silence,223640,228310,4670,Ecuador,E01,NA,NA,NA,NA
silence,228980,230050,1070,Ecuador,E01,NA,NA,NA,NA
child_gesture,229860,231330,1470,Ecuador,E01,NA,NA,NA,NA
mother_gesture,233879,235722,1843,Ecuador,E01,NA,NA,NA,NA
silence,235530,235630,100,Ecuador,E01,NA,NA,NA,NA
silence,239400,242720,3320,Ecuador,E01,NA,NA,NA,NA
silence,243540,248240,4700,Ecuador,E01,NA,NA,NA,NA
father_gesture,248829,250269,1440,Ecuador,E01,NA,NA,NA,NA
silence,249480,249940,460,Ecuador,E01,NA,NA,NA,NA
silence,250660,252990,2330,Ecuador,E01,NA,NA,NA,NA
silence,256730,260030,3300,Ecuador,E01,NA,NA,NA,NA
silence,261200,261440,240,Ecuador,E01,NA,NA,NA,NA
silence,262120,262200,80,Ecuador,E01,NA,NA,NA,NA
silence,262990,263010,20,Ecuador,E01,NA,NA,NA,NA
silence,264170,267980,3810,Ecuador,E01,NA,NA,NA,NA
silence,268940,271770,2830,Ecuador,E01,NA,NA,NA,NA
silence,272650,273670,1020,Ecuador,E01,NA,NA,NA,NA
silence,274280,282000,7720,Ecuador,E01,NA,NA,NA,NA
silence,282710,283550,840,Ecuador,E01,NA,NA,NA,NA
father_gesture,283643,285415,1772,Ecuador,E01,NA,NA,NA,NA
silence,284130,284680,550,Ecuador,E01,NA,NA,NA,NA
silence,286430,291360,4930,Ecuador,E01,NA,NA,NA,NA
silence,292070,293280,1210,Ecuador,E01,NA,NA,NA,NA
silence,294590,296300,1710,Ecuador,E01,NA,NA,NA,NA
silence,297600,297630,30,Ecuador,E01,NA,NA,NA,NA
silence,298870,301670,2800,Ecuador,E01,NA,NA,NA,NA
mother_gesture,306490,307890,1400,Ecuador,E01,NA,NA,NA,NA
silence,307120,309460,2340,Ecuador,E01,NA,NA,NA,NA
silence,310540,313120,2580,Ecuador,E01,NA,NA,NA,NA
silence,316000,318530,2530,Ecuador,E01,NA,NA,NA,NA
silence,320540,345400,24860,Ecuador,E01,NA,NA,NA,NA
mother_gesture,345020,346514,1494,Ecuador,E01,NA,NA,NA,NA
child_gesture,346848,348953,2105,Ecuador,E01,NA,NA,NA,NA
silence,348670,350090,1420,Ecuador,E01,NA,NA,NA,NA
silence,351230,351300,70,Ecuador,E01,NA,NA,NA,NA
child_gesture,355300,356540,1240,Ecuador,E01,NA,NA,NA,NA
silence,356330,356460,130,Ecuador,E01,NA,NA,NA,NA
silence,358150,367370,9220,Ecuador,E01,NA,NA,NA,NA
silence,368080,368240,160,Ecuador,E01,NA,NA,NA,NA
silence,370440,370870,430,Ecuador,E01,NA,NA,NA,NA
silence,372120,375890,3770,Ecuador,E01,NA,NA,NA,NA
silence,376800,378410,1610,Ecuador,E01,NA,NA,NA,NA
silence,379270,384950,5680,Ecuador,E01,NA,NA,NA,NA
father_gesture,384499,386167,1668,Ecuador,E01,NA,NA,NA,NA
silence,390280,422790,32510,Ecuador,E01,NA,NA,NA,NA
silence,423690,424320,630,Ecuador,E01,NA,NA,NA,NA
silence,424950,425610,660,Ecuador,E01,NA,NA,NA,NA
silence,427070,442150,15080,Ecuador,E01,NA,NA,NA,NA
silence,443440,448180,4740,Ecuador,E01,NA,NA,NA,NA
silence,449270,466720,17450,Ecuador,E01,NA,NA,NA,NA
silence,467360,468060,700,Ecuador,E01,NA,NA,NA,NA
mother_gesture,469882,471986,2104,Ecuador,E01,NA,NA,NA,NA
silence,469930,470250,320,Ecuador,E01,NA,NA,NA,NA
silence,475390,476340,950,Ecuador,E01,NA,NA,NA,NA
silence,480240,548190,67950,Ecuador,E01,NA,NA,NA,NA
father_gesture,548160,549730,1570,Ecuador,E01,NA,NA,NA,NA
silence,550250,551370,1120,Ecuador,E01,NA,NA,NA,NA
silence,554520,554650,130,Ecuador,E01,NA,NA,NA,NA
silence,555210,556080,870,Ecuador,E01,NA,NA,NA,NA
silence,558970,560450,1480,Ecuador,E01,NA,NA,NA,NA
silence,561650,562810,1160,Ecuador,E01,NA,NA,NA,NA
silence,564670,566090,1420,Ecuador,E01,NA,NA,NA,NA
silence,567320,567350,30,Ecuador,E01,NA,NA,NA,NA
silence,568480,569760,1280,Ecuador,E01,NA,NA,NA,NA
silence,570690,574300,3610,Ecuador,E01,NA,NA,NA,NA
mother_gesture,573398,575408,2010,Ecuador,E01,NA,NA,NA,NA
silence,575310,576580,1270,Ecuador,E01,NA,NA,NA,NA
silence,577660,577990,330,Ecuador,E01,NA,NA,NA,NA
silence,582270,583730,1460,Ecuador,E01,NA,NA,NA,NA
silence,584530,584950,420,Ecuador,E01,NA,NA,NA,NA
mother_gesture,584543,586536,1993,Ecuador,E01,NA,NA,NA,NA
silence,587650,587940,290,Ecuador,E01,NA,NA,NA,NA
silence,589060,591080,2020,Ecuador,E01,NA,NA,NA,NA
mother,1050,1410,360,Ecuador,E02,f,1,1,a
father,1560,2390,830,Ecuador,E02,m,1,2,a
mother,2980,3800,820,Ecuador,E02,f,1,3,a
father,3790,6280,2490,Ecuador,E02,m,1,4,a
mother,5820,6840,1020,Ecuador,E02,f,1,5,i
father,6850,7280,430,Ecuador,E02,m,1,6,a
mother,12690,14020,1330,Ecuador,E02,c,2,1,i
father,13910,16790,2880,Ecuador,E02,c,2,2,a
mother,18080,19150,1070,Ecuador,E02,c,2,3,i
father,18630,19440,810,Ecuador,E02,c,2,4,i
child,19870,20530,660,Ecuador,E02,f,2,5,q
father,20760,22200,1440,Ecuador,E02,c,2,6,q
mother,31570,33900,2330,Ecuador,E02,c,2,7,i
mother,37720,39070,1350,Ecuador,E02,f,3,1,a
father,39710,40710,1000,Ecuador,E02,m,3,2,a
father,53030,60030,7000,Ecuador,E02,m,4,1,a
mother,60950,61690,740,Ecuador,E02,f,4,2,q
father,61810,65340,3530,Ecuador,E02,m,4,3,a
father,68140,70950,2810,Ecuador,E02,m,4,4,a
mother,74000,74850,850,Ecuador,E02,f,4,5,a
child,70490,71420,930,Ecuador,E02,b,5,1,a
father,86070,86680,610,Ecuador,E02,m,6,1,a
father,87850,88830,980,Ecuador,E02,c,7,1,q
mother,105040,106990,1950,Ecuador,E02,c,8,1,a
mother,109320,110080,760,Ecuador,E02,f,9,1,q
father,111110,112810,1700,Ecuador,E02,m,9,2,q
mother,117770,119370,1600,Ecuador,E02,f,9,3,a
father,120770,121700,930,Ecuador,E02,m,9,4,q
mother,121630,122400,770,Ecuador,E02,f,9,5,a
mother,127550,128510,960,Ecuador,E02,f,9,6,a
father,130110,131780,1670,Ecuador,E02,m,9,7,a
mother,148970,151230,2260,Ecuador,E02,c,10,1,i
father,155220,156480,1260,Ecuador,E02,c,10,2,a
father,164840,166120,1280,Ecuador,E02,c,10,3,i
child,166590,167270,680,Ecuador,E02,f,10,4,a
father,167290,168280,990,Ecuador,E02,c,10,5,a
father,171280,174510,3230,Ecuador,E02,c,10,6,a
child,177300,178160,860,Ecuador,E02,f,10,7,a
mother,177410,177910,500,Ecuador,E02,b,10,8,a
father,178240,179610,1370,Ecuador,E02,c,10,9,a
mother,188530,201250,12720,Ecuador,E02,c,11,1,i
child,199770,202060,2290,Ecuador,E02,m,11,2,a
mother,202240,202830,590,Ecuador,E02,c,11,3,a
father,213510,214710,1200,Ecuador,E02,c,12,1,i
father,217650,218840,1190,Ecuador,E02,c,13,1,i
mother,239320,240880,1560,Ecuador,E02,c,14,1,a
father,252300,253630,1330,Ecuador,E02,m,15,1,q
mother,254410,254950,540,Ecuador,E02,f,15,2,q
father,254960,255380,420,Ecuador,E02,m,15,3,a
mother,255360,255770,410,Ecuador,E02,f,15,4,a
father,257300,258520,1220,Ecuador,E02,m,15,5,q
mother,259520,260700,1180,Ecuador,E02,f,15,6,q
father,263720,264530,810,Ecuador,E02,m,15,7,q
mother,264580,266160,1580,Ecuador,E02,f,15,8,a
father,265070,267220,2150,Ecuador,E02,m,15,9,q
mother,268300,269290,990,Ecuador,E02,f,15,10,a
mother,274650,275201,551,Ecuador,E02,f,15,11,a
father,275870,276960,1090,Ecuador,E02,m,15,12,q
mother,276950,277430,480,Ecuador,E02,f,15,13,q
father,277450,278710,1260,Ecuador,E02,m,15,14,q
mother,278750,281249,2499,Ecuador,E02,f,15,15,a
father,279420,281600,2180,Ecuador,E02,m,15,16,q
mother,281680,282760,1080,Ecuador,E02,f,15,17,a
father,283300,283860,560,Ecuador,E02,m,15,18,a
mother,290970,292590,1620,Ecuador,E02,f,15,19,a
child,293640,295190,1550,Ecuador,E02,m,16,1,a
father,295070,296220,1150,Ecuador,E02,c,16,2,i
mother,295940,296410,470,Ecuador,E02,c,16,3,a
child,296460,297060,600,Ecuador,E02,m,16,4,q
mother,296880,297650,770,Ecuador,E02,c,16,5,q
child,297760,298300,540,Ecuador,E02,m,16,6,a
mother,298380,298980,600,Ecuador,E02,c,16,7,q
father,298550,299080,530,Ecuador,E02,c,16,8,q
child,298980,299420,440,Ecuador,E02,b,16,9,a
mother,299630,300520,890,Ecuador,E02,c,16,10,a
father,307560,308960,1400,Ecuador,E02,m,17,1,q
mother,309830,310420,590,Ecuador,E02,f,17,2,q
father,310550,311460,910,Ecuador,E02,c,18,1,a
mother,313360,315230,1870,Ecuador,E02,c,18,2,a
child,328630,329550,920,Ecuador,E02,f,19,1,a
father,330330,331120,790,Ecuador,E02,c,19,2,q
mother,332160,333270,1110,Ecuador,E02,c,19,3,a
child,334660,335680,1020,Ecuador,E02,m,19,4,a
mother,337040,342940,5900,Ecuador,E02,c,19,5,a
father,343770,344570,800,Ecuador,E02,c,19,6,i
child,345800,346690,890,Ecuador,E02,b,19,7,a
father,332620,335090,2470,Ecuador,E02,c,20,1,i
father,346800,351400,4600,Ecuador,E02,c,21,1,i
mother,351780,353110,1330,Ecuador,E02,c,21,2,i
father,354760,358750,3990,Ecuador,E02,c,21,3,a
father,359180,360280,1100,Ecuador,E02,c,21,4,i
child,361380,362630,1250,Ecuador,E02,f,21,5,a
father,363320,364470,1150,Ecuador,E02,c,21,6,i
child,356950,359210,2260,Ecuador,E02,f,22,1,a
child,364590,365480,890,Ecuador,E02,f,23,1,a
child,367730,369590,1860,Ecuador,E02,m,24,1,a
mother,368680,369430,750,Ecuador,E02,c,24,2,q
father,370740,371740,1000,Ecuador,E02,c,24,3,i
father,375230,376580,1350,Ecuador,E02,c,25,1,i
child,376940,377720,780,Ecuador,E02,f,25,2,a
father,378370,379390,1020,Ecuador,E02,c,25,3,a
mother,385260,392410,7150,Ecuador,E02,c,26,1,i
child,392460,393090,630,Ecuador,E02,b,26,2,a
mother,393220,394390,1170,Ecuador,E02,c,26,3,a
father,397740,398720,980,Ecuador,E02,c,26,4,i
mother,399400,405330,5930,Ecuador,E02,c,26,5,a
child,405390,406530,1140,Ecuador,E02,m,26,6,a
mother,406530,407310,780,Ecuador,E02,c,26,7,q
mother,413930,415880,1950,Ecuador,E02,c,26,8,i
father,415340,416240,900,Ecuador,E02,c,26,9,q
child,416940,418320,1380,Ecuador,E02,m,26,10,a
mother,417140,419590,2450,Ecuador,E02,c,26,11,i
child,419680,420160,480,Ecuador,E02,m,26,12,q
mother,420210,423190,2980,Ecuador,E02,c,26,13,a
father,421400,425560,4160,Ecuador,E02,c,26,14,a
father,448280,449860,1580,Ecuador,E02,m,27,1,q
mother,452730,460160,7430,Ecuador,E02,f,27,2,a
child,450500,451310,810,Ecuador,E02,f,28,1,a
mother,468930,470700,1770,Ecuador,E02,f,29,1,a
mother,472840,474020,1180,Ecuador,E02,f,29,2,a
father,474400,475740,1340,Ecuador,E02,m,29,3,a
mother,475810,480640,4830,Ecuador,E02,f,29,4,a
father,481890,483620,1730,Ecuador,E02,m,29,5,a
mother,484120,484870,750,Ecuador,E02,f,29,6,a
father,484810,485900,1090,Ecuador,E02,m,29,7,q
mother,486140,486620,480,Ecuador,E02,f,29,8,a
child,486380,487090,710,Ecuador,E02,f,30,1,a
father,487110,487650,540,Ecuador,E02,c,30,2,q
child,487710,488640,930,Ecuador,E02,f,30,3,i
father,513250,515250,2000,Ecuador,E02,m,31,1,a
mother,516120,519590,3470,Ecuador,E02,f,31,2,q
father,521310,522310,1000,Ecuador,E02,m,31,3,a
mother,522310,524270,1960,Ecuador,E02,f,31,4,a
father,524670,525770,1100,Ecuador,E02,m,31,5,a
mother,525860,528400,2540,Ecuador,E02,f,31,6,a
father,529760,530540,780,Ecuador,E02,m,31,7,q
mother,530580,532090,1510,Ecuador,E02,f,31,8,a
father,532950,533610,660,Ecuador,E02,m,31,9,q
mother,534170,538080,3910,Ecuador,E02,f,31,10,a
father,539610,540600,990,Ecuador,E02,m,31,11,a
mother,555340,556390,1050,Ecuador,E02,f,32,1,q
child,556920,559420,2500,Ecuador,E02,b,33,1,a
mother,559510,568730,9220,Ecuador,E02,c,33,2,i
mother,573670,574790,1120,Ecuador,E02,c,33,3,q
child,576030,576480,450,Ecuador,E02,m,33,4,a
mother,576580,580670,4090,Ecuador,E02,c,33,5,i
father,583460,584060,600,Ecuador,E02,c,33,6,i
mother,588570,591000,2430,Ecuador,E02,c,33,7,q
child,591350,591860,510,Ecuador,E02,m,33,8,q
mother,593830,597650,3820,Ecuador,E02,f,34,1,a
silence,1410,1560,150,Ecuador,E02,NA,NA,NA,NA
silence,2390,2980,590,Ecuador,E02,NA,NA,NA,NA
silence,6840,6850,10,Ecuador,E02,NA,NA,NA,NA
silence,7280,12690,5410,Ecuador,E02,NA,NA,NA,NA
silence,16790,18080,1290,Ecuador,E02,NA,NA,NA,NA
silence,19440,19870,430,Ecuador,E02,NA,NA,NA,NA
silence,20530,20760,230,Ecuador,E02,NA,NA,NA,NA
father_gesture,20647,22324,1677,Ecuador,E02,NA,NA,NA,NA
silence,22200,31570,9370,Ecuador,E02,NA,NA,NA,NA
silence,33900,37720,3820,Ecuador,E02,NA,NA,NA,NA
silence,39070,39710,640,Ecuador,E02,NA,NA,NA,NA
silence,40710,53030,12320,Ecuador,E02,NA,NA,NA,NA
silence,60030,60950,920,Ecuador,E02,NA,NA,NA,NA
silence,61690,61810,120,Ecuador,E02,NA,NA,NA,NA
silence,65340,68140,2800,Ecuador,E02,NA,NA,NA,NA
silence,71420,74000,2580,Ecuador,E02,NA,NA,NA,NA
silence,74850,86070,11220,Ecuador,E02,NA,NA,NA,NA
silence,86680,87850,1170,Ecuador,E02,NA,NA,NA,NA
silence,88830,105040,16210,Ecuador,E02,NA,NA,NA,NA
silence,106990,109320,2330,Ecuador,E02,NA,NA,NA,NA
silence,110080,111110,1030,Ecuador,E02,NA,NA,NA,NA
silence,112810,117770,4960,Ecuador,E02,NA,NA,NA,NA
silence,119370,120770,1400,Ecuador,E02,NA,NA,NA,NA
silence,122400,127550,5150,Ecuador,E02,NA,NA,NA,NA
silence,128510,130110,1600,Ecuador,E02,NA,NA,NA,NA
silence,131780,148970,17190,Ecuador,E02,NA,NA,NA,NA
silence,151230,155220,3990,Ecuador,E02,NA,NA,NA,NA
silence,156480,164840,8360,Ecuador,E02,NA,NA,NA,NA
silence,166120,166590,470,Ecuador,E02,NA,NA,NA,NA
silence,167270,167290,20,Ecuador,E02,NA,NA,NA,NA
silence,168280,171280,3000,Ecuador,E02,NA,NA,NA,NA
silence,174510,177300,2790,Ecuador,E02,NA,NA,NA,NA
silence,178160,178240,80,Ecuador,E02,NA,NA,NA,NA
silence,179610,188530,8920,Ecuador,E02,NA,NA,NA,NA
silence,202060,202240,180,Ecuador,E02,NA,NA,NA,NA
silence,202830,213510,10680,Ecuador,E02,NA,NA,NA,NA
silence,214710,217650,2940,Ecuador,E02,NA,NA,NA,NA
silence,218840,239320,20480,Ecuador,E02,NA,NA,NA,NA
silence,240880,252300,11420,Ecuador,E02,NA,NA,NA,NA
silence,253630,254410,780,Ecuador,E02,NA,NA,NA,NA
silence,254950,254960,10,Ecuador,E02,NA,NA,NA,NA
silence,255770,257300,1530,Ecuador,E02,NA,NA,NA,NA
silence,258520,259520,1000,Ecuador,E02,NA,NA,NA,NA
silence,260700,263720,3020,Ecuador,E02,NA,NA,NA,NA
silence,264530,264580,50,Ecuador,E02,NA,NA,NA,NA
silence,267220,268300,1080,Ecuador,E02,NA,NA,NA,NA
silence,269290,274650,5360,Ecuador,E02,NA,NA,NA,NA
silence,275201,275870,669,Ecuador,E02,NA,NA,NA,NA
silence,277430,277450,20,Ecuador,E02,NA,NA,NA,NA
silence,278710,278750,40,Ecuador,E02,NA,NA,NA,NA
silence,281600,281680,80,Ecuador,E02,NA,NA,NA,NA
silence,282760,283300,540,Ecuador,E02,NA,NA,NA,NA
silence,283860,290970,7110,Ecuador,E02,NA,NA,NA,NA
silence,292590,293640,1050,Ecuador,E02,NA,NA,NA,NA
silence,296410,296460,50,Ecuador,E02,NA,NA,NA,NA
silence,297650,297760,110,Ecuador,E02,NA,NA,NA,NA
silence,298300,298380,80,Ecuador,E02,NA,NA,NA,NA
silence,299420,299630,210,Ecuador,E02,NA,NA,NA,NA
silence,300520,307560,7040,Ecuador,E02,NA,NA,NA,NA
silence,308960,309830,870,Ecuador,E02,NA,NA,NA,NA
silence,310420,310550,130,Ecuador,E02,NA,NA,NA,NA
silence,311460,313360,1900,Ecuador,E02,NA,NA,NA,NA
silence,315230,328630,13400,Ecuador,E02,NA,NA,NA,NA
silence,329550,330330,780,Ecuador,E02,NA,NA,NA,NA
silence,331120,332160,1040,Ecuador,E02,NA,NA,NA,NA
silence,335680,337040,1360,Ecuador,E02,NA,NA,NA,NA
silence,342940,343770,830,Ecuador,E02,NA,NA,NA,NA
silence,344570,345800,1230,Ecuador,E02,NA,NA,NA,NA
silence,346690,346800,110,Ecuador,E02,NA,NA,NA,NA
silence,351400,351780,380,Ecuador,E02,NA,NA,NA,NA
silence,353110,354760,1650,Ecuador,E02,NA,NA,NA,NA
silence,360280,361380,1100,Ecuador,E02,NA,NA,NA,NA
silence,362630,363320,690,Ecuador,E02,NA,NA,NA,NA
silence,364470,364590,120,Ecuador,E02,NA,NA,NA,NA
silence,365480,367730,2250,Ecuador,E02,NA,NA,NA,NA
silence,369590,370740,1150,Ecuador,E02,NA,NA,NA,NA
silence,371740,375230,3490,Ecuador,E02,NA,NA,NA,NA
silence,376580,376940,360,Ecuador,E02,NA,NA,NA,NA
silence,377720,378370,650,Ecuador,E02,NA,NA,NA,NA
silence,379390,385260,5870,Ecuador,E02,NA,NA,NA,NA
silence,392410,392460,50,Ecuador,E02,NA,NA,NA,NA
silence,393090,393220,130,Ecuador,E02,NA,NA,NA,NA
silence,394390,397740,3350,Ecuador,E02,NA,NA,NA,NA
silence,398720,399400,680,Ecuador,E02,NA,NA,NA,NA
silence,405330,405390,60,Ecuador,E02,NA,NA,NA,NA
silence,407310,413930,6620,Ecuador,E02,NA,NA,NA,NA
silence,416240,416940,700,Ecuador,E02,NA,NA,NA,NA
mother_gesture,417653,419296,1643,Ecuador,E02,NA,NA,NA,NA
silence,419590,419680,90,Ecuador,E02,NA,NA,NA,NA
silence,420160,420210,50,Ecuador,E02,NA,NA,NA,NA
silence,425560,448280,22720,Ecuador,E02,NA,NA,NA,NA
silence,449860,450500,640,Ecuador,E02,NA,NA,NA,NA
silence,451310,452730,1420,Ecuador,E02,NA,NA,NA,NA
silence,460160,468930,8770,Ecuador,E02,NA,NA,NA,NA
silence,470700,472840,2140,Ecuador,E02,NA,NA,NA,NA
silence,474020,474400,380,Ecuador,E02,NA,NA,NA,NA
silence,475740,475810,70,Ecuador,E02,NA,NA,NA,NA
mother_gesture,477930,479470,1540,Ecuador,E02,NA,NA,NA,NA
silence,480640,481890,1250,Ecuador,E02,NA,NA,NA,NA
silence,483620,484120,500,Ecuador,E02,NA,NA,NA,NA
silence,485900,486140,240,Ecuador,E02,NA,NA,NA,NA
silence,487090,487110,20,Ecuador,E02,NA,NA,NA,NA
silence,487650,487710,60,Ecuador,E02,NA,NA,NA,NA
silence,488640,513250,24610,Ecuador,E02,NA,NA,NA,NA
silence,515250,516120,870,Ecuador,E02,NA,NA,NA,NA
silence,519590,521310,1720,Ecuador,E02,NA,NA,NA,NA
silence,524270,524670,400,Ecuador,E02,NA,NA,NA,NA
silence,525770,525860,90,Ecuador,E02,NA,NA,NA,NA
silence,528400,529760,1360,Ecuador,E02,NA,NA,NA,NA
silence,530540,530580,40,Ecuador,E02,NA,NA,NA,NA
silence,532090,532950,860,Ecuador,E02,NA,NA,NA,NA
silence,533610,534170,560,Ecuador,E02,NA,NA,NA,NA
silence,538080,539610,1530,Ecuador,E02,NA,NA,NA,NA
silence,540600,555340,14740,Ecuador,E02,NA,NA,NA,NA
silence,556390,556920,530,Ecuador,E02,NA,NA,NA,NA
silence,559420,559510,90,Ecuador,E02,NA,NA,NA,NA
silence,568730,573670,4940,Ecuador,E02,NA,NA,NA,NA
silence,574790,576030,1240,Ecuador,E02,NA,NA,NA,NA
silence,576480,576580,100,Ecuador,E02,NA,NA,NA,NA
silence,580670,583460,2790,Ecuador,E02,NA,NA,NA,NA
silence,584060,588570,4510,Ecuador,E02,NA,NA,NA,NA
silence,591000,591350,350,Ecuador,E02,NA,NA,NA,NA
silence,591860,593830,1970,Ecuador,E02,NA,NA,NA,NA
mother,490,1100,610,Ecuador,E03,c,1,1,a
child,16140,18400,2260,Ecuador,E03,m,2,1,a
mother,19260,19890,630,Ecuador,E03,c,2,2,i
child,19780,20690,910,Ecuador,E03,o,2,3,a
child,22990,23590,600,Ecuador,E03,m,3,1,i
mother,24280,25100,820,Ecuador,E03,c,3,2,q
child,24980,25720,740,Ecuador,E03,o,3,3,a
mother,26030,27360,1330,Ecuador,E03,c,3,4,a
child,28650,31020,2370,Ecuador,E03,m,3,5,a
child,32690,35420,2730,Ecuador,E03,m,3,6,a
child,39970,40400,430,Ecuador,E03,m,3,7,a
child,45380,58690,13310,Ecuador,E03,o,4,1,i
child,62580,64940,2360,Ecuador,E03,b,5,1,a
mother,64250,64860,610,Ecuador,E03,c,5,2,i
child,67810,70360,2550,Ecuador,E03,m,5,3,a
child,76820,78230,1410,Ecuador,E03,o,6,1,a
child,80930,83610,2680,Ecuador,E03,o,6,2,a
child,86170,88300,2130,Ecuador,E03,o,6,3,a
child,90270,93830,3560,Ecuador,E03,m,6,4,a
child,98300,100090,1790,Ecuador,E03,o,6,5,i
mother,102160,103140,980,Ecuador,E03,c,6,6,q
mother,105910,110800,4890,Ecuador,E03,c,7,1,i
child,118320,119960,1640,Ecuador,E03,m,8,1,a
mother,123290,125800,2510,Ecuador,E03,c,9,1,i
child,125760,129160,3400,Ecuador,E03,o,9,2,a
mother,129600,130920,1320,Ecuador,E03,c,9,3,a
child,130920,131350,430,Ecuador,E03,m,9,4,a
mother,137690,138570,880,Ecuador,E03,c,9,5,a
child,136770,137460,690,Ecuador,E03,f,10,1,a
child,137880,140209,2329,Ecuador,E03,f,10,2,i
mother,140770,142010,1240,Ecuador,E03,c,10,3,a
child,142430,145120,2690,Ecuador,E03,o,10,4,a
father,144560,145990,1430,Ecuador,E03,c,11,1,i
mother,145460,147790,2330,Ecuador,E03,c,11,2,a
mother,153330,154980,1650,Ecuador,E03,c,12,1,q
child,156910,157870,960,Ecuador,E03,m,12,2,a
child,164470,165350,880,Ecuador,E03,o,13,1,q
mother,167020,167450,430,Ecuador,E03,c,13,2,a
child,173230,174870,1640,Ecuador,E03,m,14,1,a
mother,179710,183070,3360,Ecuador,E03,o,15,1,i
mother,187690,189240,1550,Ecuador,E03,o,15,2,a
child,190040,190640,600,Ecuador,E03,o,16,1,a
father,194020,195210,1190,Ecuador,E03,m,17,1,i
mother,196660,197500,840,Ecuador,E03,o,18,1,i
mother,213720,215790,2070,Ecuador,E03,c,19,1,q
child,219200,221050,1850,Ecuador,E03,m,19,2,a
mother,220400,221800,1400,Ecuador,E03,c,19,3,q
child,222090,223720,1630,Ecuador,E03,m,19,4,a
child,226180,230770,4590,Ecuador,E03,m,19,5,a
child,232550,233510,960,Ecuador,E03,o,20,1,a
child,255060,258380,3320,Ecuador,E03,o,21,1,i
mother,257110,260079,2969,Ecuador,E03,c,22,1,a
child,263370,264270,900,Ecuador,E03,m,23,1,a
mother,265710,266280,570,Ecuador,E03,c,23,2,a
child,268960,269690,730,Ecuador,E03,m,23,3,a
child,277450,278550,1100,Ecuador,E03,o,24,1,a
child,285880,292120,6240,Ecuador,E03,o,25,1,i
mother,290970,291870,900,Ecuador,E03,c,26,1,q
child,300000,302130,2130,Ecuador,E03,m,26,2,a
mother,302260,302920,660,Ecuador,E03,c,26,3,a
father,315080,315710,630,Ecuador,E03,c,27,1,i
child,318360,319630,1270,Ecuador,E03,o,28,1,a
child,325150,326150,1000,Ecuador,E03,m,29,1,a
father,348830,350190,1360,Ecuador,E03,m,30,1,a
mother,350600,352460,1860,Ecuador,E03,f,30,2,a
mother,353160,354150,990,Ecuador,E03,f,30,3,a
child,350100,350740,640,Ecuador,E03,o,31,1,a
child,352370,353080,710,Ecuador,E03,o,31,2,a
child,363780,366400,2620,Ecuador,E03,o,32,1,a
mother,369040,369830,790,Ecuador,E03,c,32,2,a
child,369210,370950,1740,Ecuador,E03,m,32,3,a
child,383410,384090,680,Ecuador,E03,o,33,1,i
child,385580,389250,3670,Ecuador,E03,m,33,2,a
child,391440,397340,5900,Ecuador,E03,o,33,3,a
child,399830,404430,4600,Ecuador,E03,o,33,4,a
child,408530,409450,920,Ecuador,E03,b,34,1,a
child,426780,429570,2790,Ecuador,E03,m,35,1,a
child,434910,435810,900,Ecuador,E03,m,35,2,a
child,439720,440440,720,Ecuador,E03,b,36,1,a
mother,445500,446270,770,Ecuador,E03,c,37,1,i
child,446470,447250,780,Ecuador,E03,m,37,2,a
mother,448200,448970,770,Ecuador,E03,c,37,3,a
child,450340,451540,1200,Ecuador,E03,m,37,4,a
child,456690,457310,620,Ecuador,E03,b,37,5,a
child,475770,476630,860,Ecuador,E03,m,38,1,a
child,478750,480000,1250,Ecuador,E03,m,38,2,a
mother,481550,482620,1070,Ecuador,E03,c,38,3,a
child,483350,486530,3180,Ecuador,E03,m,38,4,a
child,491690,492660,970,Ecuador,E03,b,38,5,a
child,496770,499210,2440,Ecuador,E03,b,38,6,a
child,502300,503130,830,Ecuador,E03,b,38,7,a
child,508750,511360,2610,Ecuador,E03,m,39,1,a
mother,512090,517020,4930,Ecuador,E03,c,39,2,i
child,528490,531080,2590,Ecuador,E03,o,40,1,a
child,537970,539070,1100,Ecuador,E03,m,41,1,a
child,542290,543280,990,Ecuador,E03,m,41,2,a
child,563450,564270,820,Ecuador,E03,o,42,1,i
child,567210,571520,4310,Ecuador,E03,o,42,2,i
child,581530,591310,9780,Ecuador,E03,o,43,1,q
mother,591420,593840,2420,Ecuador,E03,c,43,2,i
silence,280,490,210,Ecuador,E03,NA,NA,NA,NA
silence,1100,16140,15040,Ecuador,E03,NA,NA,NA,NA
silence,18400,19260,860,Ecuador,E03,NA,NA,NA,NA
silence,20690,22990,2300,Ecuador,E03,NA,NA,NA,NA
silence,23590,24280,690,Ecuador,E03,NA,NA,NA,NA
silence,25720,26030,310,Ecuador,E03,NA,NA,NA,NA
mother_gesture,26488,27732,1244,Ecuador,E03,NA,NA,NA,NA
silence,27360,28650,1290,Ecuador,E03,NA,NA,NA,NA
silence,31020,32690,1670,Ecuador,E03,NA,NA,NA,NA
silence,35420,39970,4550,Ecuador,E03,NA,NA,NA,NA
silence,40400,45380,4980,Ecuador,E03,NA,NA,NA,NA
silence,58690,62580,3890,Ecuador,E03,NA,NA,NA,NA
silence,64940,67810,2870,Ecuador,E03,NA,NA,NA,NA
silence,70360,76820,6460,Ecuador,E03,NA,NA,NA,NA
silence,78230,80930,2700,Ecuador,E03,NA,NA,NA,NA
silence,83610,86170,2560,Ecuador,E03,NA,NA,NA,NA
silence,88300,90270,1970,Ecuador,E03,NA,NA,NA,NA
silence,93830,98300,4470,Ecuador,E03,NA,NA,NA,NA
silence,100090,102160,2070,Ecuador,E03,NA,NA,NA,NA
silence,103140,105910,2770,Ecuador,E03,NA,NA,NA,NA
silence,110800,118320,7520,Ecuador,E03,NA,NA,NA,NA
silence,119960,123290,3330,Ecuador,E03,NA,NA,NA,NA
silence,129160,129600,440,Ecuador,E03,NA,NA,NA,NA
silence,131350,136770,5420,Ecuador,E03,NA,NA,NA,NA
silence,137460,137690,230,Ecuador,E03,NA,NA,NA,NA
silence,140209,140770,561,Ecuador,E03,NA,NA,NA,NA
silence,142010,142430,420,Ecuador,E03,NA,NA,NA,NA
silence,147790,153330,5540,Ecuador,E03,NA,NA,NA,NA
mother_gesture,153466,155003,1537,Ecuador,E03,NA,NA,NA,NA
silence,154980,156910,1930,Ecuador,E03,NA,NA,NA,NA
silence,157870,164470,6600,Ecuador,E03,NA,NA,NA,NA
silence,165350,167020,1670,Ecuador,E03,NA,NA,NA,NA
silence,167450,173230,5780,Ecuador,E03,NA,NA,NA,NA
silence,174870,179710,4840,Ecuador,E03,NA,NA,NA,NA
silence,183070,187690,4620,Ecuador,E03,NA,NA,NA,NA
silence,189240,190040,800,Ecuador,E03,NA,NA,NA,NA
silence,190640,194020,3380,Ecuador,E03,NA,NA,NA,NA
father_gesture,193630,195319,1689,Ecuador,E03,NA,NA,NA,NA
silence,195210,196660,1450,Ecuador,E03,NA,NA,NA,NA
silence,197500,213720,16220,Ecuador,E03,NA,NA,NA,NA
silence,215790,219200,3410,Ecuador,E03,NA,NA,NA,NA
silence,221800,222090,290,Ecuador,E03,NA,NA,NA,NA
silence,223720,226180,2460,Ecuador,E03,NA,NA,NA,NA
silence,230770,232550,1780,Ecuador,E03,NA,NA,NA,NA
silence,233510,255060,21550,Ecuador,E03,NA,NA,NA,NA
silence,260079,263370,3291,Ecuador,E03,NA,NA,NA,NA
silence,264270,265710,1440,Ecuador,E03,NA,NA,NA,NA
silence,266280,268960,2680,Ecuador,E03,NA,NA,NA,NA
silence,269690,277450,7760,Ecuador,E03,NA,NA,NA,NA
silence,278550,285880,7330,Ecuador,E03,NA,NA,NA,NA
mother_gesture,292067,293771,1704,Ecuador,E03,NA,NA,NA,NA
silence,292120,300000,7880,Ecuador,E03,NA,NA,NA,NA
silence,302130,302260,130,Ecuador,E03,NA,NA,NA,NA
silence,302920,315080,12160,Ecuador,E03,NA,NA,NA,NA
silence,315710,318360,2650,Ecuador,E03,NA,NA,NA,NA
silence,319630,325150,5520,Ecuador,E03,NA,NA,NA,NA
silence,326150,348830,22680,Ecuador,E03,NA,NA,NA,NA
silence,353080,353160,80,Ecuador,E03,NA,NA,NA,NA
silence,354150,363780,9630,Ecuador,E03,NA,NA,NA,NA
silence,366400,369040,2640,Ecuador,E03,NA,NA,NA,NA
silence,370950,383410,12460,Ecuador,E03,NA,NA,NA,NA
silence,384090,385580,1490,Ecuador,E03,NA,NA,NA,NA
silence,389250,391440,2190,Ecuador,E03,NA,NA,NA,NA
silence,397340,399830,2490,Ecuador,E03,NA,NA,NA,NA
silence,404430,408530,4100,Ecuador,E03,NA,NA,NA,NA
silence,409450,426780,17330,Ecuador,E03,NA,NA,NA,NA
silence,429570,434910,5340,Ecuador,E03,NA,NA,NA,NA
silence,435810,439720,3910,Ecuador,E03,NA,NA,NA,NA
silence,440440,445500,5060,Ecuador,E03,NA,NA,NA,NA
silence,446270,446470,200,Ecuador,E03,NA,NA,NA,NA
silence,447250,448200,950,Ecuador,E03,NA,NA,NA,NA
mother_gesture,447760,449718,1958,Ecuador,E03,NA,NA,NA,NA
silence,448970,450340,1370,Ecuador,E03,NA,NA,NA,NA
silence,451540,456690,5150,Ecuador,E03,NA,NA,NA,NA
silence,457310,475770,18460,Ecuador,E03,NA,NA,NA,NA
silence,476630,478750,2120,Ecuador,E03,NA,NA,NA,NA
silence,480000,481550,1550,Ecuador,E03,NA,NA,NA,NA
silence,482620,483350,730,Ecuador,E03,NA,NA,NA,NA
silence,486530,491690,5160,Ecuador,E03,NA,NA,NA,NA
silence,492660,496770,4110,Ecuador,E03,NA,NA,NA,NA
silence,499210,502300,3090,Ecuador,E03,NA,NA,NA,NA
silence,503130,508750,5620,Ecuador,E03,NA,NA,NA,NA
silence,511360,512090,730,Ecuador,E03,NA,NA,NA,NA
silence,517020,528490,11470,Ecuador,E03,NA,NA,NA,NA
silence,531080,537970,6890,Ecuador,E03,NA,NA,NA,NA
silence,539070,542290,3220,Ecuador,E03,NA,NA,NA,NA
silence,543280,563450,20170,Ecuador,E03,NA,NA,NA,NA
silence,564270,567210,2940,Ecuador,E03,NA,NA,NA,NA
child_gesture,567510,571819,4309,Ecuador,E03,NA,NA,NA,NA
silence,571520,581530,10010,Ecuador,E03,NA,NA,NA,NA
mother_gesture,590880,592360,1480,Ecuador,E03,NA,NA,NA,NA
silence,591310,591420,110,Ecuador,E03,NA,NA,NA,NA
mother_gesture,592530,594790,2260,Ecuador,E03,NA,NA,NA,NA
silence,593840,595750,1910,Ecuador,E03,NA,NA,NA,NA
child,490,1100,610,Ecuador,E04,f,1,1,a
father,1000,2920,1920,Ecuador,E04,c,1,2,a
mother,2300,3570,1270,Ecuador,E04,c,2,1,i
child,4520,5270,750,Ecuador,E04,m,2,2,a
mother,5380,6200,820,Ecuador,E04,c,2,3,q
child,6200,6670,470,Ecuador,E04,c,2,4,a
mother,6700,9300,2600,Ecuador,E04,c,2,5,a
child,9530,10970,1440,Ecuador,E04,m,2,6,a
father,3450,3990,540,Ecuador,E04,m,3,1,a
mother,13170,17330,4160,Ecuador,E04,f,4,1,i
father,16590,18380,1790,Ecuador,E04,m,4,2,a
mother,20610,22480,1870,Ecuador,E04,f,4,3,a
father,23300,26570,3270,Ecuador,E04,m,4,4,a
mother,26530,28090,1560,Ecuador,E04,f,4,5,a
father,34070,35550,1480,Ecuador,E04,m,4,6,a
mother,36390,37210,820,Ecuador,E04,c,5,1,a
father,37010,37570,560,Ecuador,E04,b,5,2,NA
child,37990,38550,560,Ecuador,E04,b,6,1,a
mother,73350,74320,970,Ecuador,E04,f,7,1,i
mother,76760,78430,1670,Ecuador,E04,o,7,2,q
child,79710,80450,740,Ecuador,E04,b,8,1,a
mother,82500,83880,1380,Ecuador,E04,o,9,1,i
father,96220,97680,1460,Ecuador,E04,m,10,1,a
mother,98290,99550,1260,Ecuador,E04,c,11,1,a
child,100510,101660,1150,Ecuador,E04,m,11,2,a
mother,101520,102840,1320,Ecuador,E04,c,11,3,q
mother,110550,115490,4940,Ecuador,E04,f,12,1,a
father,115850,116730,880,Ecuador,E04,m,12,2,a
mother,127270,130010,2740,Ecuador,E04,f,13,1,a
child,149540,150720,1180,Ecuador,E04,b,14,1,a
father,151560,153670,2110,Ecuador,E04,c,14,2,q
mother,152550,158050,5500,Ecuador,E04,b,15,1,a
mother,159154,160440,1286,Ecuador,E04,c,16,1,q
child,159370,160420,1050,Ecuador,E04,c,16,2,a
mother,167980,169620,1640,Ecuador,E04,c,17,1,q
child,175610,180310,4700,Ecuador,E04,m,17,2,a
mother,180660,181830,1170,Ecuador,E04,c,17,3,a
child,181900,183850,1950,Ecuador,E04,m,17,4,a
mother,195740,197860,2120,Ecuador,E04,f,18,1,a
father,198110,200000,1890,Ecuador,E04,m,18,2,i
mother,258100,260240,2140,Ecuador,E04,c,18,3,i
father,260460,261300,840,Ecuador,E04,c,18,4,a
mother,262290,263290,1000,Ecuador,E04,f,18,5,q
father,262950,263890,940,Ecuador,E04,m,18,6,a
child,264940,265530,590,Ecuador,E04,f,18,7,a
mother,279310,280360,1050,Ecuador,E04,f,19,1,i
father,283780,284550,770,Ecuador,E04,m,19,2,a
child,289150,292510,3360,Ecuador,E04,f,20,1,i
mother,294610,297120,2510,Ecuador,E04,c,20,2,i
child,313770,315630,1860,Ecuador,E04,m,21,1,q
mother,315610,316970,1360,Ecuador,E04,c,21,2,a
child,345630,348400,2770,Ecuador,E04,b,22,1,a
father,366360,367360,1000,Ecuador,E04,c,23,1,q
child,367500,368040,540,Ecuador,E04,f,23,2,a
father,368290,369150,860,Ecuador,E04,c,23,3,i
father,371610,372350,740,Ecuador,E04,c,23,4,a
child,373610,374680,1070,Ecuador,E04,f,23,5,i
child,382510,384750,2240,Ecuador,E04,m,24,1,i
mother,384760,385810,1050,Ecuador,E04,c,24,2,a
mother,387940,389290,1350,Ecuador,E04,c,24,3,a
child,389150,390010,860,Ecuador,E04,m,24,4,a
mother,390400,391020,620,Ecuador,E04,c,24,5,a
child,400470,401410,940,Ecuador,E04,f,25,1,q
father,439980,441630,1650,Ecuador,E04,m,26,1,a
mother,442000,442550,550,Ecuador,E04,f,26,2,a
child,473470,476560,3090,Ecuador,E04,f,27,1,a
mother,476830,478220,1390,Ecuador,E04,b,27,2,a
child,480110,483050,2940,Ecuador,E04,m,28,1,a
child,483560,484200,640,Ecuador,E04,m,28,2,a
mother,487930,488750,820,Ecuador,E04,c,28,3,i
child,489960,491180,1220,Ecuador,E04,m,28,4,a
mother,491040,496330,5290,Ecuador,E04,c,28,5,q
child,495800,496600,800,Ecuador,E04,m,28,6,a
mother,498710,499880,1170,Ecuador,E04,c,28,7,a
father,504260,505770,1510,Ecuador,E04,c,28,8,i
mother,482370,482960,590,Ecuador,E04,f,29,1,a
father,483310,484240,930,Ecuador,E04,m,29,2,a
child,500200,500990,790,Ecuador,E04,m,29,3,i
mother,503440,504520,1080,Ecuador,E04,c,29,4,a
child,504640,506270,1630,Ecuador,E04,m,29,5,q
child,509090,511150,2060,Ecuador,E04,m,29,6,a
mother,511530,512810,1280,Ecuador,E04,c,29,7,a
mother,506790,507580,790,Ecuador,E04,f,30,1,a
father,508190,509390,1200,Ecuador,E04,m,30,2,a
father,594910,595610,700,Ecuador,E04,m,31,1,a
silence,3990,4520,530,Ecuador,E04,NA,NA,NA,NA
silence,5270,5380,110,Ecuador,E04,NA,NA,NA,NA
silence,6670,6700,30,Ecuador,E04,NA,NA,NA,NA
silence,9300,9530,230,Ecuador,E04,NA,NA,NA,NA
silence,10970,13170,2200,Ecuador,E04,NA,NA,NA,NA
silence,18380,20610,2230,Ecuador,E04,NA,NA,NA,NA
silence,22480,23300,820,Ecuador,E04,NA,NA,NA,NA
silence,28090,34070,5980,Ecuador,E04,NA,NA,NA,NA
silence,35550,36390,840,Ecuador,E04,NA,NA,NA,NA
silence,37570,37990,420,Ecuador,E04,NA,NA,NA,NA
silence,38550,73350,34800,Ecuador,E04,NA,NA,NA,NA
silence,74320,76760,2440,Ecuador,E04,NA,NA,NA,NA
silence,78430,79710,1280,Ecuador,E04,NA,NA,NA,NA
silence,80450,82500,2050,Ecuador,E04,NA,NA,NA,NA
silence,83880,96220,12340,Ecuador,E04,NA,NA,NA,NA
father_gesture,96553,98211,1658,Ecuador,E04,NA,NA,NA,NA
silence,97680,98290,610,Ecuador,E04,NA,NA,NA,NA
silence,99550,100510,960,Ecuador,E04,NA,NA,NA,NA
silence,102840,110550,7710,Ecuador,E04,NA,NA,NA,NA
silence,115490,115850,360,Ecuador,E04,NA,NA,NA,NA
silence,116730,127270,10540,Ecuador,E04,NA,NA,NA,NA
silence,130010,149540,19530,Ecuador,E04,NA,NA,NA,NA
silence,150720,151560,840,Ecuador,E04,NA,NA,NA,NA
silence,158050,159154,1104,Ecuador,E04,NA,NA,NA,NA
silence,160440,167980,7540,Ecuador,E04,NA,NA,NA,NA
silence,169620,175610,5990,Ecuador,E04,NA,NA,NA,NA
silence,180310,180660,350,Ecuador,E04,NA,NA,NA,NA
silence,181830,181900,70,Ecuador,E04,NA,NA,NA,NA
silence,183850,195740,11890,Ecuador,E04,NA,NA,NA,NA
silence,197860,198110,250,Ecuador,E04,NA,NA,NA,NA
silence,200000,258100,58100,Ecuador,E04,NA,NA,NA,NA
mother_gesture,258225,259644,1419,Ecuador,E04,NA,NA,NA,NA
silence,260240,260460,220,Ecuador,E04,NA,NA,NA,NA
silence,261300,262290,990,Ecuador,E04,NA,NA,NA,NA
silence,263890,264940,1050,Ecuador,E04,NA,NA,NA,NA
silence,265530,279310,13780,Ecuador,E04,NA,NA,NA,NA
silence,280360,283780,3420,Ecuador,E04,NA,NA,NA,NA
silence,284550,289150,4600,Ecuador,E04,NA,NA,NA,NA
silence,292510,294610,2100,Ecuador,E04,NA,NA,NA,NA
silence,297120,313770,16650,Ecuador,E04,NA,NA,NA,NA
silence,316970,345630,28660,Ecuador,E04,NA,NA,NA,NA
silence,348400,366360,17960,Ecuador,E04,NA,NA,NA,NA
silence,367360,367500,140,Ecuador,E04,NA,NA,NA,NA
silence,368040,368290,250,Ecuador,E04,NA,NA,NA,NA
silence,369150,371610,2460,Ecuador,E04,NA,NA,NA,NA
silence,372350,373610,1260,Ecuador,E04,NA,NA,NA,NA
silence,374680,382510,7830,Ecuador,E04,NA,NA,NA,NA
silence,384750,384760,10,Ecuador,E04,NA,NA,NA,NA
silence,385810,387940,2130,Ecuador,E04,NA,NA,NA,NA
silence,390010,390400,390,Ecuador,E04,NA,NA,NA,NA
silence,391020,400470,9450,Ecuador,E04,NA,NA,NA,NA
silence,401410,439980,38570,Ecuador,E04,NA,NA,NA,NA
silence,441630,442000,370,Ecuador,E04,NA,NA,NA,NA
silence,442550,473470,30920,Ecuador,E04,NA,NA,NA,NA
silence,476560,476830,270,Ecuador,E04,NA,NA,NA,NA
silence,478220,480110,1890,Ecuador,E04,NA,NA,NA,NA
silence,483050,483310,260,Ecuador,E04,NA,NA,NA,NA
silence,484240,487930,3690,Ecuador,E04,NA,NA,NA,NA
silence,488750,489960,1210,Ecuador,E04,NA,NA,NA,NA
silence,496600,498710,2110,Ecuador,E04,NA,NA,NA,NA
mother_gesture,498430,500344,1914,Ecuador,E04,NA,NA,NA,NA
silence,499880,500200,320,Ecuador,E04,NA,NA,NA,NA
silence,500990,503440,2450,Ecuador,E04,NA,NA,NA,NA
silence,506270,506790,520,Ecuador,E04,NA,NA,NA,NA
silence,507580,508190,610,Ecuador,E04,NA,NA,NA,NA
silence,511150,511530,380,Ecuador,E04,NA,NA,NA,NA
silence,512810,594910,82100,Ecuador,E04,NA,NA,NA,NA
mother,70,3280,3210,Ecuador,E05,c,1,1,q
child,4550,4960,410,Ecuador,E05,m,1,2,a
mother,4880,6670,1790,Ecuador,E05,c,1,3,a
father,6110,7280,1170,Ecuador,E05,c,1,4,i
child,7480,7900,420,Ecuador,E05,f,1,5,a
mother,7570,8450,880,Ecuador,E05,b,1,6,a
father,8520,10540,2020,Ecuador,E05,c,1,7,i
mother,9280,11210,1930,Ecuador,E05,c,1,8,q
child,11230,11710,480,Ecuador,E05,m,1,9,a
father,16130,19426,3296,Ecuador,E05,c,1,10,a
child,18590,19230,640,Ecuador,E05,m,1,11,a
mother,19540,22360,2820,Ecuador,E05,c,1,12,a
father,19690,20410,720,Ecuador,E05,c,1,13,a
child,22750,24100,1350,Ecuador,E05,b,1,14,a
father,12790,15430,2640,Ecuador,E05,m,2,1,a
mother,13150,15840,2690,Ecuador,E05,f,2,2,q
mother,23870,36610,12740,Ecuador,E05,c,3,1,a
father,28890,31850,2960,Ecuador,E05,m,3,2,a
mother,39310,41860,2550,Ecuador,E05,c,3,3,a
father,41950,47860,5910,Ecuador,E05,c,3,4,a
child,47200,48830,1630,Ecuador,E05,b,3,5,a
mother,48230,49020,790,Ecuador,E05,b,3,6,a
father,48620,57460,8840,Ecuador,E05,c,3,7,a
child,53560,54480,920,Ecuador,E05,f,3,8,a
mother,55870,56810,940,Ecuador,E05,c,3,9,a
child,57580,58220,640,Ecuador,E05,f,3,10,a
father,58950,70380,11430,Ecuador,E05,c,3,11,a
child,69950,70520,570,Ecuador,E05,f,3,12,a
father,78910,85150,6240,Ecuador,E05,c,3,13,i
mother,84580,85780,1200,Ecuador,E05,c,3,14,q
father,86010,86600,590,Ecuador,E05,c,3,15,a
mother,86470,86940,470,Ecuador,E05,c,3,16,q
child,86640,87210,570,Ecuador,E05,m,3,17,a
mother,87230,88280,1050,Ecuador,E05,c,3,18,a
father,87330,89310,1980,Ecuador,E05,c,3,19,a
child,88630,89100,470,Ecuador,E05,f,3,20,a
mother,90500,92910,2410,Ecuador,E05,c,3,21,a
father,91380,93230,1850,Ecuador,E05,c,3,22,a
child,93000,93650,650,Ecuador,E05,m,3,23,a
mother,93570,94370,800,Ecuador,E05,c,3,24,a
father,93830,95480,1650,Ecuador,E05,b,3,25,a
mother,96420,97580,1160,Ecuador,E05,c,3,26,a
father,96740,100430,3690,Ecuador,E05,c,3,27,a
father,72680,76340,3660,Ecuador,E05,m,4,1,a
father,104890,118850,13960,Ecuador,E05,c,5,1,i
father,120940,121620,680,Ecuador,E05,c,5,2,a
father,125340,126540,1200,Ecuador,E05,o,6,1,a
father,139030,143040,4010,Ecuador,E05,o,7,1,i
mother,141550,144720,3170,Ecuador,E05,o,7,2,a
mother,149380,152130,2750,Ecuador,E05,o,7,3,a
father,149410,152850,3440,Ecuador,E05,m,7,4,i
mother,156070,160280,4210,Ecuador,E05,o,7,5,a
father,159490,160600,1110,Ecuador,E05,o,7,6,a
father,169320,170260,940,Ecuador,E05,o,7,7,a
mother,169550,170540,990,Ecuador,E05,o,7,8,a
mother,173590,174720,1130,Ecuador,E05,o,7,9,a
father,183290,185640,2350,Ecuador,E05,o,7,10,a
mother,184510,188330,3820,Ecuador,E05,o,7,11,a
father,188280,189540,1260,Ecuador,E05,m,7,12,a
father,178190,179620,1430,Ecuador,E05,m,8,1,a
child,195930,197000,1070,Ecuador,E05,f,9,1,a
father,197200,199700,2500,Ecuador,E05,c,9,2,a
mother,198860,199340,480,Ecuador,E05,f,9,3,a
father,201290,201880,590,Ecuador,E05,o,10,1,q
mother,203140,203690,550,Ecuador,E05,o,10,2,a
father,203800,205760,1960,Ecuador,E05,o,10,3,a
father,208620,211500,2880,Ecuador,E05,c,11,1,a
mother,211190,212100,910,Ecuador,E05,f,11,2,a
father,212060,215770,3710,Ecuador,E05,c,11,3,a
mother,215870,217790,1920,Ecuador,E05,c,11,4,q
father,221770,223290,1520,Ecuador,E05,c,11,5,i
mother,226970,229200,2230,Ecuador,E05,f,12,1,q
father,229300,231770,2470,Ecuador,E05,m,12,2,a
father,233340,234480,1140,Ecuador,E05,m,12,3,a
child,230770,233080,2310,Ecuador,E05,b,13,1,a
mother,239630,241550,1920,Ecuador,E05,c,13,2,i
child,241080,241960,880,Ecuador,E05,m,13,3,a
mother,242230,244420,2190,Ecuador,E05,c,13,4,q
child,245460,246510,1050,Ecuador,E05,m,13,5,a
father,246650,249410,2760,Ecuador,E05,c,13,6,a
mother,247430,249080,1650,Ecuador,E05,c,13,7,a
mother,252180,255520,3340,Ecuador,E05,c,13,8,a
father,255670,256330,660,Ecuador,E05,b,13,9,a
child,256190,259963,3773,Ecuador,E05,b,13,10,a
child,265160,266140,980,Ecuador,E05,m,14,1,a
father,266130,267420,1290,Ecuador,E05,c,15,1,a
father,277770,278470,700,Ecuador,E05,o,16,1,a
father,282160,287640,5480,Ecuador,E05,c,17,1,i
father,296740,302380,5640,Ecuador,E05,c,17,2,i
father,306720,307960,1240,Ecuador,E05,b,18,1,a
child,310640,311610,970,Ecuador,E05,f,18,2,a
father,311690,316770,5080,Ecuador,E05,c,18,3,q
mother,311760,312850,1090,Ecuador,E05,c,18,4,a
mother,317130,318140,1010,Ecuador,E05,f,18,5,a
father,318170,319030,860,Ecuador,E05,m,18,6,a
mother,319280,320140,860,Ecuador,E05,f,18,7,a
mother,324280,326750,2470,Ecuador,E05,c,19,1,i
mother,330710,332870,2160,Ecuador,E05,f,20,1,q
father,332930,333480,550,Ecuador,E05,m,20,2,a
mother,333940,335700,1760,Ecuador,E05,f,20,3,a
father,336310,337240,930,Ecuador,E05,m,20,4,q
mother,337200,337990,790,Ecuador,E05,f,20,5,a
father,337960,344350,6390,Ecuador,E05,m,20,6,a
mother,343900,348310,4410,Ecuador,E05,f,20,7,a
father,353320,354330,1010,Ecuador,E05,m,20,8,a
mother,354370,355340,970,Ecuador,E05,f,20,9,a
father,355530,359850,4320,Ecuador,E05,m,20,10,a
mother,359860,360830,970,Ecuador,E05,f,20,11,a
father,364190,366160,1970,Ecuador,E05,m,20,12,a
mother,365500,366110,610,Ecuador,E05,f,20,13,a
mother,372300,373720,1420,Ecuador,E05,f,20,14,a
father,373800,374440,640,Ecuador,E05,m,20,15,q
mother,374660,376370,1710,Ecuador,E05,f,20,16,a
father,375840,376900,1060,Ecuador,E05,m,20,17,a
father,379950,380820,870,Ecuador,E05,m,20,18,a
mother,381080,384890,3810,Ecuador,E05,f,20,19,a
father,385230,385810,580,Ecuador,E05,m,20,20,a
mother,385900,387720,1820,Ecuador,E05,f,20,21,a
father,387650,388340,690,Ecuador,E05,m,20,22,a
child,342390,343170,780,Ecuador,E05,m,21,1,a
child,346080,346790,710,Ecuador,E05,m,21,2,a
child,384870,388580,3710,Ecuador,E05,m,22,1,a
mother,391020,393950,2930,Ecuador,E05,f,23,1,a
father,392490,394330,1840,Ecuador,E05,m,23,2,a
child,393380,395290,1910,Ecuador,E05,b,24,1,a
child,398190,399700,1510,Ecuador,E05,m,24,2,a
child,400710,401930,1220,Ecuador,E05,m,24,3,a
mother,401250,402130,880,Ecuador,E05,c,24,4,a
child,403160,404440,1280,Ecuador,E05,m,24,5,a
mother,404350,405090,740,Ecuador,E05,c,24,6,a
mother,394690,398970,4280,Ecuador,E05,f,25,1,a
father,400010,401280,1270,Ecuador,E05,m,25,2,a
father,415450,416290,840,Ecuador,E05,c,26,1,q
father,418390,420160,1770,Ecuador,E05,c,26,2,a
father,425440,431390,5950,Ecuador,E05,m,27,1,q
mother,432096,437990,5894,Ecuador,E05,f,27,2,q
father,437420,438340,920,Ecuador,E05,m,27,3,a
mother,442860,444380,1520,Ecuador,E05,f,27,4,a
father,444260,445730,1470,Ecuador,E05,m,28,1,q
mother,446300,450420,4120,Ecuador,E05,f,28,2,q
father,450470,451180,710,Ecuador,E05,m,28,3,a
mother,451410,454990,3580,Ecuador,E05,f,28,4,a
father,452820,456280,3460,Ecuador,E05,m,28,5,a
mother,456210,456820,610,Ecuador,E05,f,28,6,a
father,457240,458170,930,Ecuador,E05,m,29,1,a
mother,458100,458710,610,Ecuador,E05,f,29,2,a
father,458610,459210,600,Ecuador,E05,m,29,3,a
mother,461470,463820,2350,Ecuador,E05,f,30,1,a
father,463540,464280,740,Ecuador,E05,m,30,2,a
mother,464750,466670,1920,Ecuador,E05,f,30,3,a
father,466320,467070,750,Ecuador,E05,m,30,4,a
child,466950,467730,780,Ecuador,E05,m,31,1,a
mother,468750,472490,3740,Ecuador,E05,c,31,2,q
child,472700,473300,600,Ecuador,E05,m,31,3,a
mother,473140,476000,2860,Ecuador,E05,c,31,4,q
child,476080,476530,450,Ecuador,E05,m,31,5,a
mother,476640,478000,1360,Ecuador,E05,c,31,6,q
child,477980,478500,520,Ecuador,E05,m,31,7,a
mother,479130,479950,820,Ecuador,E05,c,31,8,a
child,479520,480730,1210,Ecuador,E05,m,31,9,a
father,481130,481920,790,Ecuador,E05,c,31,10,a
mother,481360,486080,4720,Ecuador,E05,c,31,11,a
child,482250,484810,2560,Ecuador,E05,m,31,12,a
father,483170,484020,850,Ecuador,E05,b,31,13,a
child,486330,487320,990,Ecuador,E05,b,31,14,a
mother,487160,488530,1370,Ecuador,E05,c,31,15,i
child,488740,494840,6100,Ecuador,E05,b,31,16,a
mother,490910,492490,1580,Ecuador,E05,f,32,1,i
father,492850,493410,560,Ecuador,E05,m,32,2,a
mother,495450,496880,1430,Ecuador,E05,f,32,3,a
father,497090,500230,3140,Ecuador,E05,m,32,4,a
mother,500310,502400,2090,Ecuador,E05,f,32,5,a
child,501390,502800,1410,Ecuador,E05,m,33,1,a
child,507490,508810,1320,Ecuador,E05,m,33,2,a
child,512060,512890,830,Ecuador,E05,b,33,3,a
child,514420,515660,1240,Ecuador,E05,m,33,4,a
father,515720,518200,2480,Ecuador,E05,c,33,5,i
mother,519070,519700,630,Ecuador,E05,c,33,6,a
child,521060,521920,860,Ecuador,E05,m,33,7,a
mother,521900,523220,1320,Ecuador,E05,c,33,8,i
father,501750,506890,5140,Ecuador,E05,m,34,1,a
mother,507180,508350,1170,Ecuador,E05,f,34,2,a
father,508910,512810,3900,Ecuador,E05,m,34,3,a
mother,512820,513510,690,Ecuador,E05,f,34,4,a
father,513190,514230,1040,Ecuador,E05,m,35,1,q
mother,530300,533150,2850,Ecuador,E05,f,36,1,a
father,533480,534600,1120,Ecuador,E05,m,36,2,a
mother,534700,536220,1520,Ecuador,E05,f,36,3,a
child,533950,534810,860,Ecuador,E05,b,37,1,a
child,535500,536170,670,Ecuador,E05,m,38,1,a
child,538640,540600,1960,Ecuador,E05,m,38,2,a
mother,539170,539860,690,Ecuador,E05,c,38,3,a
father,539810,540690,880,Ecuador,E05,m,38,4,q
mother,540500,541050,550,Ecuador,E05,f,38,5,q
father,541150,542940,1790,Ecuador,E05,m,38,6,a
mother,543200,546830,3630,Ecuador,E05,c,38,7,a
child,548390,549230,840,Ecuador,E05,m,38,8,a
mother,549010,551510,2500,Ecuador,E05,c,38,9,a
child,553040,553750,710,Ecuador,E05,m,38,10,a
father,553860,558230,4370,Ecuador,E05,m,38,11,q
mother,555140,558850,3710,Ecuador,E05,f,38,12,a
child,558580,562210,3630,Ecuador,E05,m,38,13,a
child,566180,567570,1390,Ecuador,E05,m,38,14,a
father,566370,572880,6510,Ecuador,E05,m,39,1,a
father,577680,581210,3530,Ecuador,E05,m,39,2,q
mother,579860,586420,6560,Ecuador,E05,f,39,3,a
father,586510,587390,880,Ecuador,E05,m,39,4,a
mother,590550,592290,1740,Ecuador,E05,f,40,1,q
father,592350,593000,650,Ecuador,E05,m,40,2,a
mother,592760,596230,3470,Ecuador,E05,f,40,3,a
father,596570,597340,770,Ecuador,E05,m,40,4,q
silence,3280,4550,1270,Ecuador,E05,NA,NA,NA,NA
silence,7280,7480,200,Ecuador,E05,NA,NA,NA,NA
silence,8450,8520,70,Ecuador,E05,NA,NA,NA,NA
father_gesture,9260,10762,1502,Ecuador,E05,NA,NA,NA,NA
silence,11210,11230,20,Ecuador,E05,NA,NA,NA,NA
silence,11710,12790,1080,Ecuador,E05,NA,NA,NA,NA
silence,15840,16130,290,Ecuador,E05,NA,NA,NA,NA
father_gesture,19242,20827,1585,Ecuador,E05,NA,NA,NA,NA
silence,19426,19540,114,Ecuador,E05,NA,NA,NA,NA
silence,22360,22750,390,Ecuador,E05,NA,NA,NA,NA
mother_gesture,28460,29917,1457,Ecuador,E05,NA,NA,NA,NA
mother_gesture,34854,36762,1908,Ecuador,E05,NA,NA,NA,NA
silence,36610,39310,2700,Ecuador,E05,NA,NA,NA,NA
silence,41860,41950,90,Ecuador,E05,NA,NA,NA,NA
silence,57460,57580,120,Ecuador,E05,NA,NA,NA,NA
silence,58220,58950,730,Ecuador,E05,NA,NA,NA,NA
father_gesture,62098,65311,3213,Ecuador,E05,NA,NA,NA,NA
father_gesture,65500,67194,1694,Ecuador,E05,NA,NA,NA,NA
silence,70520,72680,2160,Ecuador,E05,NA,NA,NA,NA
silence,76340,78910,2570,Ecuador,E05,NA,NA,NA,NA
father_gesture,78812,81317,2505,Ecuador,E05,NA,NA,NA,NA
father_gesture,81420,83461,2041,Ecuador,E05,NA,NA,NA,NA
father_gesture,83660,85218,1558,Ecuador,E05,NA,NA,NA,NA
silence,85780,86010,230,Ecuador,E05,NA,NA,NA,NA
father_gesture,86646,89460,2814,Ecuador,E05,NA,NA,NA,NA
silence,87210,87230,20,Ecuador,E05,NA,NA,NA,NA
silence,89310,90500,1190,Ecuador,E05,NA,NA,NA,NA
silence,95480,96420,940,Ecuador,E05,NA,NA,NA,NA
silence,100430,104890,4460,Ecuador,E05,NA,NA,NA,NA
silence,118850,120940,2090,Ecuador,E05,NA,NA,NA,NA
silence,121620,125340,3720,Ecuador,E05,NA,NA,NA,NA
child_gesture,125300,126458,1158,Ecuador,E05,NA,NA,NA,NA
silence,126540,139030,12490,Ecuador,E05,NA,NA,NA,NA
father_gesture,141381,143380,1999,Ecuador,E05,NA,NA,NA,NA
silence,144720,149380,4660,Ecuador,E05,NA,NA,NA,NA
father_gesture,149243,151469,2226,Ecuador,E05,NA,NA,NA,NA
silence,152850,156070,3220,Ecuador,E05,NA,NA,NA,NA
silence,160600,169320,8720,Ecuador,E05,NA,NA,NA,NA
silence,170540,173590,3050,Ecuador,E05,NA,NA,NA,NA
silence,174720,178190,3470,Ecuador,E05,NA,NA,NA,NA
silence,179620,183290,3670,Ecuador,E05,NA,NA,NA,NA
silence,189540,195930,6390,Ecuador,E05,NA,NA,NA,NA
silence,197000,197200,200,Ecuador,E05,NA,NA,NA,NA
silence,199700,201290,1590,Ecuador,E05,NA,NA,NA,NA
silence,201880,203140,1260,Ecuador,E05,NA,NA,NA,NA
silence,203690,203800,110,Ecuador,E05,NA,NA,NA,NA
silence,205760,208620,2860,Ecuador,E05,NA,NA,NA,NA
mother_gesture,214030,217176,3146,Ecuador,E05,NA,NA,NA,NA
silence,215770,215870,100,Ecuador,E05,NA,NA,NA,NA
silence,217790,221770,3980,Ecuador,E05,NA,NA,NA,NA
silence,223290,226970,3680,Ecuador,E05,NA,NA,NA,NA
silence,229200,229300,100,Ecuador,E05,NA,NA,NA,NA
silence,233080,233340,260,Ecuador,E05,NA,NA,NA,NA
silence,234480,239630,5150,Ecuador,E05,NA,NA,NA,NA
silence,241960,242230,270,Ecuador,E05,NA,NA,NA,NA
silence,244420,245460,1040,Ecuador,E05,NA,NA,NA,NA
silence,246510,246650,140,Ecuador,E05,NA,NA,NA,NA
mother_gesture,246705,248642,1937,Ecuador,E05,NA,NA,NA,NA
silence,249410,252180,2770,Ecuador,E05,NA,NA,NA,NA
silence,255520,255670,150,Ecuador,E05,NA,NA,NA,NA
silence,259963,265160,5197,Ecuador,E05,NA,NA,NA,NA
silence,267420,277770,10350,Ecuador,E05,NA,NA,NA,NA
silence,278470,282160,3690,Ecuador,E05,NA,NA,NA,NA
father_gesture,285110,287280,2170,Ecuador,E05,NA,NA,NA,NA
silence,287640,296740,9100,Ecuador,E05,NA,NA,NA,NA
father_gesture,297826,299201,1375,Ecuador,E05,NA,NA,NA,NA
father_gesture,300405,302211,1806,Ecuador,E05,NA,NA,NA,NA
silence,302380,306720,4340,Ecuador,E05,NA,NA,NA,NA
silence,307960,310640,2680,Ecuador,E05,NA,NA,NA,NA
child_gesture,310095,311693,1598,Ecuador,E05,NA,NA,NA,NA
silence,311610,311690,80,Ecuador,E05,NA,NA,NA,NA
silence,316770,317130,360,Ecuador,E05,NA,NA,NA,NA
silence,318140,318170,30,Ecuador,E05,NA,NA,NA,NA
silence,319030,319280,250,Ecuador,E05,NA,NA,NA,NA
silence,320140,324280,4140,Ecuador,E05,NA,NA,NA,NA
silence,326750,330710,3960,Ecuador,E05,NA,NA,NA,NA
silence,332870,332930,60,Ecuador,E05,NA,NA,NA,NA
silence,333480,333940,460,Ecuador,E05,NA,NA,NA,NA
silence,335700,336310,610,Ecuador,E05,NA,NA,NA,NA
silence,348310,353320,5010,Ecuador,E05,NA,NA,NA,NA
silence,354330,354370,40,Ecuador,E05,NA,NA,NA,NA
silence,355340,355530,190,Ecuador,E05,NA,NA,NA,NA
silence,359850,359860,10,Ecuador,E05,NA,NA,NA,NA
silence,360830,364190,3360,Ecuador,E05,NA,NA,NA,NA
silence,366160,372300,6140,Ecuador,E05,NA,NA,NA,NA
silence,373720,373800,80,Ecuador,E05,NA,NA,NA,NA
silence,374440,374660,220,Ecuador,E05,NA,NA,NA,NA
silence,376900,379950,3050,Ecuador,E05,NA,NA,NA,NA
silence,380820,381080,260,Ecuador,E05,NA,NA,NA,NA
silence,388580,391020,2440,Ecuador,E05,NA,NA,NA,NA
mother_gesture,393605,395657,2052,Ecuador,E05,NA,NA,NA,NA
silence,399700,400010,310,Ecuador,E05,NA,NA,NA,NA
silence,402130,403160,1030,Ecuador,E05,NA,NA,NA,NA
silence,405090,415450,10360,Ecuador,E05,NA,NA,NA,NA
silence,416290,418390,2100,Ecuador,E05,NA,NA,NA,NA
mother_gesture,417552,419092,1540,Ecuador,E05,NA,NA,NA,NA
silence,420160,425440,5280,Ecuador,E05,NA,NA,NA,NA
silence,431390,432096,706,Ecuador,E05,NA,NA,NA,NA
silence,438340,442860,4520,Ecuador,E05,NA,NA,NA,NA
silence,445730,446300,570,Ecuador,E05,NA,NA,NA,NA
silence,450420,450470,50,Ecuador,E05,NA,NA,NA,NA
silence,451180,451410,230,Ecuador,E05,NA,NA,NA,NA
silence,456820,457240,420,Ecuador,E05,NA,NA,NA,NA
silence,459210,461470,2260,Ecuador,E05,NA,NA,NA,NA
silence,464280,464750,470,Ecuador,E05,NA,NA,NA,NA
silence,467730,468750,1020,Ecuador,E05,NA,NA,NA,NA
silence,472490,472700,210,Ecuador,E05,NA,NA,NA,NA
silence,476000,476080,80,Ecuador,E05,NA,NA,NA,NA
silence,476530,476640,110,Ecuador,E05,NA,NA,NA,NA
silence,478500,479130,630,Ecuador,E05,NA,NA,NA,NA
silence,480730,481130,400,Ecuador,E05,NA,NA,NA,NA
silence,486080,486330,250,Ecuador,E05,NA,NA,NA,NA
silence,488530,488740,210,Ecuador,E05,NA,NA,NA,NA
silence,494840,495450,610,Ecuador,E05,NA,NA,NA,NA
silence,496880,497090,210,Ecuador,E05,NA,NA,NA,NA
silence,500230,500310,80,Ecuador,E05,NA,NA,NA,NA
silence,506890,507180,290,Ecuador,E05,NA,NA,NA,NA
silence,508810,508910,100,Ecuador,E05,NA,NA,NA,NA
silence,514230,514420,190,Ecuador,E05,NA,NA,NA,NA
silence,515660,515720,60,Ecuador,E05,NA,NA,NA,NA
father_gesture,516980,518250,1270,Ecuador,E05,NA,NA,NA,NA
silence,518200,519070,870,Ecuador,E05,NA,NA,NA,NA
silence,519700,521060,1360,Ecuador,E05,NA,NA,NA,NA
mother_gesture,521250,522469,1219,Ecuador,E05,NA,NA,NA,NA
mother_gesture,522469,523659,1190,Ecuador,E05,NA,NA,NA,NA
silence,523220,530300,7080,Ecuador,E05,NA,NA,NA,NA
silence,533150,533480,330,Ecuador,E05,NA,NA,NA,NA
silence,536220,538640,2420,Ecuador,E05,NA,NA,NA,NA
silence,541050,541150,100,Ecuador,E05,NA,NA,NA,NA
silence,542940,543200,260,Ecuador,E05,NA,NA,NA,NA
silence,546830,548390,1560,Ecuador,E05,NA,NA,NA,NA
silence,551510,553040,1530,Ecuador,E05,NA,NA,NA,NA
silence,553750,553860,110,Ecuador,E05,NA,NA,NA,NA
silence,562210,566180,3970,Ecuador,E05,NA,NA,NA,NA
silence,572880,577680,4800,Ecuador,E05,NA,NA,NA,NA
father_gesture,578111,579665,1554,Ecuador,E05,NA,NA,NA,NA
father_gesture,579970,581257,1287,Ecuador,E05,NA,NA,NA,NA
silence,586420,586510,90,Ecuador,E05,NA,NA,NA,NA
silence,587390,590550,3160,Ecuador,E05,NA,NA,NA,NA
silence,592290,592350,60,Ecuador,E05,NA,NA,NA,NA
mother_gesture,592670,594015,1345,Ecuador,E05,NA,NA,NA,NA
silence,596230,596570,340,Ecuador,E05,NA,NA,NA,NA
silence,597340,598960,1620,Ecuador,E05,NA,NA,NA,NA
mother,4050,38730,34680,Ecuador,E06,o,2,1,a
father,4640,36780,32140,Ecuador,E06,f,2,2,a
child,36300,36960,660,Ecuador,E06,f,2,3,a
father,37390,41210,3820,Ecuador,E06,c,2,4,a
mother,41740,42430,690,Ecuador,E06,c,2,5,a
child,42640,43920,1280,Ecuador,E06,b,3,1,a
mother,43250,47810,4560,Ecuador,E06,c,3,2,q
child,47870,48930,1060,Ecuador,E06,m,3,3,q
mother,48910,49330,420,Ecuador,E06,c,3,4,a
mother,49380,50860,1480,Ecuador,E06,f,4,1,a
child,49420,50310,890,Ecuador,E06,m,5,1,a
father,51560,54740,3180,Ecuador,E06,c,5,2,a
mother,57310,59940,2630,Ecuador,E06,c,5,3,a
father,58440,59720,1280,Ecuador,E06,c,5,4,a
child,61510,62830,1320,Ecuador,E06,f,5,5,a
father,64810,66850,2040,Ecuador,E06,c,5,6,a
mother,60010,61340,1330,Ecuador,E06,f,6,1,q
father,61350,62160,810,Ecuador,E06,m,6,2,a
mother,62390,65160,2770,Ecuador,E06,f,6,3,a
child,72670,77590,4920,Ecuador,E06,m,7,1,a
child,87820,92950,5130,Ecuador,E06,b,8,1,a
mother,93210,96380,3170,Ecuador,E06,c,8,2,a
child,95050,98630,3580,Ecuador,E06,m,8,3,a
mother,99350,104830,5480,Ecuador,E06,c,8,4,a
child,105600,106440,840,Ecuador,E06,m,8,5,a
mother,106960,109280,2320,Ecuador,E06,c,8,6,q
child,111850,113360,1510,Ecuador,E06,m,8,7,a
mother,113170,114490,1320,Ecuador,E06,c,8,8,q
child,114670,115210,540,Ecuador,E06,m,8,9,a
mother,96430,98190,1760,Ecuador,E06,f,9,1,a
father,111200,112720,1520,Ecuador,E06,m,10,1,a
father,115530,119730,4200,Ecuador,E06,c,11,1,q
child,119900,120610,710,Ecuador,E06,f,11,2,a
father,120520,121980,1460,Ecuador,E06,c,11,3,a
mother,122760,123740,980,Ecuador,E06,c,12,1,q
child,124070,125220,1150,Ecuador,E06,m,12,2,a
mother,125230,125910,680,Ecuador,E06,c,12,3,q
child,125790,126420,630,Ecuador,E06,m,12,4,a
mother,128560,129260,700,Ecuador,E06,c,12,5,a
mother,132250,134560,2310,Ecuador,E06,c,12,6,i
mother,145490,146620,1130,Ecuador,E06,f,13,1,q
father,146670,148230,1560,Ecuador,E06,m,13,2,a
mother,147350,148760,1410,Ecuador,E06,f,13,3,a
mother,150150,152460,2310,Ecuador,E06,f,13,4,a
mother,157390,158330,940,Ecuador,E06,c,14,1,q
child,158520,159150,630,Ecuador,E06,m,14,2,a
mother,159270,159690,420,Ecuador,E06,c,14,3,q
child,159730,160820,1090,Ecuador,E06,m,14,4,a
mother,164000,164900,900,Ecuador,E06,c,15,1,i
father,204530,206130,1600,Ecuador,E06,c,16,1,a
father,208560,212620,4060,Ecuador,E06,c,16,2,a
mother,213430,214810,1380,Ecuador,E06,c,17,1,a
child,214860,215560,700,Ecuador,E06,m,17,2,a
mother,215510,216340,830,Ecuador,E06,c,17,3,a
father,215920,218490,2570,Ecuador,E06,c,17,4,q
child,216420,219040,2620,Ecuador,E06,f,17,5,a
father,219150,220040,890,Ecuador,E06,c,17,6,a
mother,238000,239480,1480,Ecuador,E06,f,18,1,a
father,243210,246500,3290,Ecuador,E06,m,18,2,a
mother,248840,250010,1170,Ecuador,E06,f,18,3,a
mother,252980,255250,2270,Ecuador,E06,f,18,4,a
father,256920,258020,1100,Ecuador,E06,m,18,5,a
mother,258120,262280,4160,Ecuador,E06,c,19,1,i
child,262390,263500,1110,Ecuador,E06,m,19,2,a
mother,263540,264080,540,Ecuador,E06,c,19,3,a
child,282730,285070,2340,Ecuador,E06,m,20,1,a
father,285290,287830,2540,Ecuador,E06,c,20,2,a
mother,286100,286690,590,Ecuador,E06,c,20,3,a
child,289350,292450,3100,Ecuador,E06,m,20,4,q
mother,291060,291910,850,Ecuador,E06,c,20,5,q
mother,292970,293670,700,Ecuador,E06,c,20,6,a
child,294050,295540,1490,Ecuador,E06,m,20,7,q
mother,295550,296630,1080,Ecuador,E06,c,20,8,a
mother,299630,301360,1730,Ecuador,E06,f,21,1,a
father,308030,309110,1080,Ecuador,E06,m,21,2,a
mother,309170,309640,470,Ecuador,E06,f,21,3,q
father,309680,311120,1440,Ecuador,E06,m,21,4,q
mother,311340,313630,2290,Ecuador,E06,f,21,5,i
mother,315640,317090,1450,Ecuador,E06,f,22,1,q
mother,322850,323510,660,Ecuador,E06,c,23,1,a
mother,327250,328050,800,Ecuador,E06,c,23,2,a
father,329610,332260,2650,Ecuador,E06,c,24,1,a
mother,332260,333510,1250,Ecuador,E06,c,24,2,i
father,346260,348220,1960,Ecuador,E06,b,25,1,a
mother,358180,362020,3840,Ecuador,E06,c,26,1,q
child,361960,363410,1450,Ecuador,E06,m,26,2,a
mother,363280,363890,610,Ecuador,E06,c,26,3,a
mother,375520,376570,1050,Ecuador,E06,c,27,1,a
father,390420,391960,1540,Ecuador,E06,m,28,1,q
mother,392440,393510,1070,Ecuador,E06,c,28,2,q
child,394060,394700,640,Ecuador,E06,m,28,3,a
mother,394760,397780,3020,Ecuador,E06,c,28,4,q
father,398730,400100,1370,Ecuador,E06,m,28,5,a
mother,398930,400620,1690,Ecuador,E06,f,28,6,q
mother,404750,405930,1180,Ecuador,E06,f,28,7,a
mother,412340,415180,2840,Ecuador,E06,c,28,8,a
child,415310,416830,1520,Ecuador,E06,f,28,9,a
father,416830,417870,1040,Ecuador,E06,c,28,10,a
father,420350,423730,3380,Ecuador,E06,c,28,11,a
mother,424180,424840,660,Ecuador,E06,c,28,12,q
child,424780,426140,1360,Ecuador,E06,m,28,13,a
child,427100,428120,1020,Ecuador,E06,f,28,14,a
father,428210,429220,1010,Ecuador,E06,c,28,15,a
father,431200,433630,2430,Ecuador,E06,c,28,16,q
child,433910,435230,1320,Ecuador,E06,m,29,1,a
mother,434720,436550,1830,Ecuador,E06,c,29,2,a
child,436830,438160,1330,Ecuador,E06,m,29,3,q
mother,437920,440790,2870,Ecuador,E06,c,29,4,q
father,439870,442040,2170,Ecuador,E06,c,29,5,a
mother,441590,444950,3360,Ecuador,E06,f,29,6,a
child,443330,443810,480,Ecuador,E06,m,29,7,a
father,445400,447970,2570,Ecuador,E06,c,29,8,q
mother,447750,448890,1140,Ecuador,E06,c,29,9,q
child,448540,449490,950,Ecuador,E06,m,29,10,q
mother,449570,455590,6020,Ecuador,E06,c,29,11,a
child,450630,451170,540,Ecuador,E06,m,29,12,a
father,455310,461630,6320,Ecuador,E06,c,29,13,q
mother,463990,469840,5850,Ecuador,E06,c,30,1,i
child,473780,475120,1340,Ecuador,E06,m,31,1,a
mother,477590,479210,1620,Ecuador,E06,c,31,2,a
child,482320,484020,1700,Ecuador,E06,m,31,3,a
mother,484280,492510,8230,Ecuador,E06,c,31,4,q
child,487850,489280,1430,Ecuador,E06,m,31,5,q
child,492950,494030,1080,Ecuador,E06,m,31,6,a
mother,493750,494550,800,Ecuador,E06,c,31,7,q
mother,500600,502080,1480,Ecuador,E06,c,32,1,i
child,508870,510380,1510,Ecuador,E06,f,33,1,a
father,510330,515940,5610,Ecuador,E06,c,33,2,q
child,516380,516830,450,Ecuador,E06,f,33,3,a
father,516830,517710,880,Ecuador,E06,c,33,4,a
mother,525760,531310,5550,Ecuador,E06,c,34,1,a
child,531230,544750,13520,Ecuador,E06,b,34,2,a
mother,532640,554210,21570,Ecuador,E06,c,34,3,a
father,536200,545620,9420,Ecuador,E06,c,34,4,a
father,547950,552460,4510,Ecuador,E06,c,34,5,a
child,548190,562240,14050,Ecuador,E06,b,34,6,a
father,554520,555580,1060,Ecuador,E06,c,34,7,a
mother,554770,564450,9680,Ecuador,E06,c,34,8,a
father,561870,564330,2460,Ecuador,E06,c,34,9,a
child,565730,566480,750,Ecuador,E06,m,35,1,a
mother,566100,567290,1190,Ecuador,E06,c,35,2,q
child,567490,570270,2780,Ecuador,E06,m,35,3,a
mother,569440,569980,540,Ecuador,E06,c,36,1,a
mother,572000,578670,6670,Ecuador,E06,c,37,1,a
child,573620,582550,8930,Ecuador,E06,m,37,2,a
child,588050,594240,6190,Ecuador,E06,m,37,3,a
silence,1650,4050,2400,Ecuador,E06,NA,NA,NA,NA
silence,41210,41740,530,Ecuador,E06,NA,NA,NA,NA
silence,42430,42640,210,Ecuador,E06,NA,NA,NA,NA
silence,47810,47870,60,Ecuador,E06,NA,NA,NA,NA
silence,49330,49380,50,Ecuador,E06,NA,NA,NA,NA
silence,50860,51560,700,Ecuador,E06,NA,NA,NA,NA
silence,54740,57310,2570,Ecuador,E06,NA,NA,NA,NA
silence,59940,60010,70,Ecuador,E06,NA,NA,NA,NA
silence,61340,61350,10,Ecuador,E06,NA,NA,NA,NA
silence,66850,72670,5820,Ecuador,E06,NA,NA,NA,NA
silence,77590,87820,10230,Ecuador,E06,NA,NA,NA,NA
silence,92950,93210,260,Ecuador,E06,NA,NA,NA,NA
silence,98630,99350,720,Ecuador,E06,NA,NA,NA,NA
silence,104830,105600,770,Ecuador,E06,NA,NA,NA,NA
silence,106440,106960,520,Ecuador,E06,NA,NA,NA,NA
silence,109280,111200,1920,Ecuador,E06,NA,NA,NA,NA
silence,114490,114670,180,Ecuador,E06,NA,NA,NA,NA
silence,115210,115530,320,Ecuador,E06,NA,NA,NA,NA
silence,119730,119900,170,Ecuador,E06,NA,NA,NA,NA
silence,121980,122760,780,Ecuador,E06,NA,NA,NA,NA
silence,123740,124070,330,Ecuador,E06,NA,NA,NA,NA
silence,125220,125230,10,Ecuador,E06,NA,NA,NA,NA
silence,126420,128560,2140,Ecuador,E06,NA,NA,NA,NA
silence,129260,132250,2990,Ecuador,E06,NA,NA,NA,NA
silence,134560,145490,10930,Ecuador,E06,NA,NA,NA,NA
mother_gesture,145580,147260,1680,Ecuador,E06,NA,NA,NA,NA
silence,146620,146670,50,Ecuador,E06,NA,NA,NA,NA
mother_gesture,147400,149350,1950,Ecuador,E06,NA,NA,NA,NA
silence,148760,150150,1390,Ecuador,E06,NA,NA,NA,NA
mother_gesture,149720,152470,2750,Ecuador,E06,NA,NA,NA,NA
silence,152460,157390,4930,Ecuador,E06,NA,NA,NA,NA
silence,158330,158520,190,Ecuador,E06,NA,NA,NA,NA
silence,159150,159270,120,Ecuador,E06,NA,NA,NA,NA
silence,159690,159730,40,Ecuador,E06,NA,NA,NA,NA
silence,160820,164000,3180,Ecuador,E06,NA,NA,NA,NA
silence,164900,204530,39630,Ecuador,E06,NA,NA,NA,NA
silence,206130,208560,2430,Ecuador,E06,NA,NA,NA,NA
silence,212620,213430,810,Ecuador,E06,NA,NA,NA,NA
silence,214810,214860,50,Ecuador,E06,NA,NA,NA,NA
silence,219040,219150,110,Ecuador,E06,NA,NA,NA,NA
silence,220040,238000,17960,Ecuador,E06,NA,NA,NA,NA
silence,239480,243210,3730,Ecuador,E06,NA,NA,NA,NA
silence,246500,248840,2340,Ecuador,E06,NA,NA,NA,NA
silence,250010,252980,2970,Ecuador,E06,NA,NA,NA,NA
silence,255250,256920,1670,Ecuador,E06,NA,NA,NA,NA
silence,258020,258120,100,Ecuador,E06,NA,NA,NA,NA
silence,262280,262390,110,Ecuador,E06,NA,NA,NA,NA
silence,263500,263540,40,Ecuador,E06,NA,NA,NA,NA
silence,264080,282730,18650,Ecuador,E06,NA,NA,NA,NA
silence,285070,285290,220,Ecuador,E06,NA,NA,NA,NA
silence,287830,289350,1520,Ecuador,E06,NA,NA,NA,NA
silence,292450,292970,520,Ecuador,E06,NA,NA,NA,NA
silence,293670,294050,380,Ecuador,E06,NA,NA,NA,NA
silence,295540,295550,10,Ecuador,E06,NA,NA,NA,NA
silence,296630,299630,3000,Ecuador,E06,NA,NA,NA,NA
silence,301360,308030,6670,Ecuador,E06,NA,NA,NA,NA
silence,309110,309170,60,Ecuador,E06,NA,NA,NA,NA
silence,309640,309680,40,Ecuador,E06,NA,NA,NA,NA
silence,311120,311340,220,Ecuador,E06,NA,NA,NA,NA
silence,313630,315640,2010,Ecuador,E06,NA,NA,NA,NA
mother_gesture,315064,317164,2100,Ecuador,E06,NA,NA,NA,NA
silence,317090,322850,5760,Ecuador,E06,NA,NA,NA,NA
silence,323510,327250,3740,Ecuador,E06,NA,NA,NA,NA
silence,328050,329610,1560,Ecuador,E06,NA,NA,NA,NA
silence,333510,346260,12750,Ecuador,E06,NA,NA,NA,NA
silence,348220,358180,9960,Ecuador,E06,NA,NA,NA,NA
silence,363890,375520,11630,Ecuador,E06,NA,NA,NA,NA
silence,376570,390420,13850,Ecuador,E06,NA,NA,NA,NA
silence,391960,392440,480,Ecuador,E06,NA,NA,NA,NA
silence,393510,394060,550,Ecuador,E06,NA,NA,NA,NA
silence,394700,394760,60,Ecuador,E06,NA,NA,NA,NA
silence,397780,398730,950,Ecuador,E06,NA,NA,NA,NA
silence,400620,404750,4130,Ecuador,E06,NA,NA,NA,NA
silence,405930,412340,6410,Ecuador,E06,NA,NA,NA,NA
silence,415180,415310,130,Ecuador,E06,NA,NA,NA,NA
silence,417870,420350,2480,Ecuador,E06,NA,NA,NA,NA
silence,423730,424180,450,Ecuador,E06,NA,NA,NA,NA
silence,426140,427100,960,Ecuador,E06,NA,NA,NA,NA
silence,428120,428210,90,Ecuador,E06,NA,NA,NA,NA
silence,429220,431200,1980,Ecuador,E06,NA,NA,NA,NA
silence,433630,433910,280,Ecuador,E06,NA,NA,NA,NA
silence,436550,436830,280,Ecuador,E06,NA,NA,NA,NA
silence,444950,445400,450,Ecuador,E06,NA,NA,NA,NA
silence,449490,449570,80,Ecuador,E06,NA,NA,NA,NA
silence,461630,463990,2360,Ecuador,E06,NA,NA,NA,NA
silence,469840,473780,3940,Ecuador,E06,NA,NA,NA,NA
silence,475120,477590,2470,Ecuador,E06,NA,NA,NA,NA
silence,479210,482320,3110,Ecuador,E06,NA,NA,NA,NA
silence,484020,484280,260,Ecuador,E06,NA,NA,NA,NA
silence,492510,492950,440,Ecuador,E06,NA,NA,NA,NA
silence,494550,500600,6050,Ecuador,E06,NA,NA,NA,NA
mother_gesture,500051,501910,1859,Ecuador,E06,NA,NA,NA,NA
silence,502080,508870,6790,Ecuador,E06,NA,NA,NA,NA
silence,515940,516380,440,Ecuador,E06,NA,NA,NA,NA
silence,517710,525760,8050,Ecuador,E06,NA,NA,NA,NA
silence,564450,565730,1280,Ecuador,E06,NA,NA,NA,NA
silence,567290,567490,200,Ecuador,E06,NA,NA,NA,NA
silence,570270,572000,1730,Ecuador,E06,NA,NA,NA,NA
child_gesture,593793,596885,3092,Ecuador,E06,NA,NA,NA,NA
mother_gesture,594013,596714,2701,Ecuador,E06,NA,NA,NA,NA
mother,850,2560,1710,Ecuador,E07,f,1,1,a
father,2760,3600,840,Ecuador,E07,m,1,2,a
child,5010,5550,540,Ecuador,E07,f,2,1,a
father,6200,8380,2180,Ecuador,E07,c,2,2,a
child,16590,17410,820,Ecuador,E07,m,3,1,a
father,17400,19090,1690,Ecuador,E07,c,3,2,a
child,19000,20420,1420,Ecuador,E07,b,3,3,a
mother,20470,21460,990,Ecuador,E07,c,3,4,i
child,21370,22290,920,Ecuador,E07,b,3,5,a
mother,22720,25200,2480,Ecuador,E07,f,4,1,a
mother,26630,29180,2550,Ecuador,E07,f,4,2,i
father,31000,32240,1240,Ecuador,E07,m,4,3,i
child,32280,34960,2680,Ecuador,E07,m,4,4,a
mother,41550,42130,580,Ecuador,E07,c,4,5,i
child,42150,43410,1260,Ecuador,E07,m,4,6,a
father,42700,43740,1040,Ecuador,E07,c,4,7,a
mother,50620,51680,1060,Ecuador,E07,c,4,8,a
child,24600,25560,960,Ecuador,E07,o,5,1,i
father,37370,42030,4660,Ecuador,E07,c,6,1,a
mother,43760,45200,1440,Ecuador,E07,f,7,1,a
father,74560,75930,1370,Ecuador,E07,m,8,1,q
father,79910,86120,6210,Ecuador,E07,m,8,2,a
father,90080,92490,2410,Ecuador,E07,m,9,1,a
mother,93010,93690,680,Ecuador,E07,f,9,2,a
child,96100,96810,710,Ecuador,E07,m,10,1,a
father,99020,100320,1300,Ecuador,E07,m,11,1,i
mother,108700,111280,2580,Ecuador,E07,c,11,2,a
child,108700,109220,520,Ecuador,E07,b,11,3,a
child,110690,111500,810,Ecuador,E07,m,11,4,a
father,111610,111975,365,Ecuador,E07,c,11,5,q
mother,122760,128020,5260,Ecuador,E07,f,12,1,a
child,131880,133010,1130,Ecuador,E07,f,13,1,a
mother,147810,149000,1190,Ecuador,E07,c,14,1,i
child,167950,168650,700,Ecuador,E07,m,15,1,a
mother,199020,201640,2620,Ecuador,E07,f,16,1,a
father,204000,210890,6890,Ecuador,E07,m,16,2,a
mother,205390,205850,460,Ecuador,E07,f,16,3,a
mother,214650,218530,3880,Ecuador,E07,f,16,4,a
mother,223600,232500,8900,Ecuador,E07,c,17,1,q
child,233900,234470,570,Ecuador,E07,m,17,2,a
child,236680,239410,2730,Ecuador,E07,m,17,3,a
father,234990,237200,2210,Ecuador,E07,m,18,1,a
mother,241850,242950,1100,Ecuador,E07,f,18,2,a
mother,247020,247990,970,Ecuador,E07,f,19,1,a
father,248850,249330,480,Ecuador,E07,m,19,2,q
mother,249760,255030,5270,Ecuador,E07,f,19,3,a
father,258550,273000,14450,Ecuador,E07,m,19,4,a
child,261610,263510,1900,Ecuador,E07,b,20,1,a
child,271490,276580,5090,Ecuador,E07,m,20,2,a
father,279180,280570,1390,Ecuador,E07,c,20,3,a
mother,282190,283220,1030,Ecuador,E07,f,21,1,q
father,283250,283910,660,Ecuador,E07,m,21,2,a
father,287050,290510,3460,Ecuador,E07,m,21,3,a
father,293170,298950,5780,Ecuador,E07,m,22,1,a
father,305460,311080,5620,Ecuador,E07,m,22,2,a
father,314320,315070,750,Ecuador,E07,m,23,1,a
father,320690,322670,1980,Ecuador,E07,m,24,1,a
mother,329440,332900,3460,Ecuador,E07,f,24,2,a
mother,355960,357650,1690,Ecuador,E07,f,25,1,q
father,357630,358440,810,Ecuador,E07,m,25,2,a
child,371790,373620,1830,Ecuador,E07,m,26,1,a
mother,373460,378100,4640,Ecuador,E07,c,26,2,i
father,379460,381630,2170,Ecuador,E07,m,27,1,q
father,384900,386550,1650,Ecuador,E07,m,27,2,q
mother,388120,389480,1360,Ecuador,E07,c,28,1,i
father,389550,390670,1120,Ecuador,E07,m,28,2,i
mother,395480,399320,3840,Ecuador,E07,c,28,3,i
mother,400650,403360,2710,Ecuador,E07,f,29,1,a
mother,406410,407630,1220,Ecuador,E07,f,29,2,a
mother,410550,411870,1320,Ecuador,E07,f,30,1,q
father,417940,421900,3960,Ecuador,E07,c,31,1,a
child,424530,425190,660,Ecuador,E07,f,31,2,a
father,427040,428260,1220,Ecuador,E07,c,31,3,i
mother,431800,434610,2810,Ecuador,E07,c,31,4,a
child,435230,435860,630,Ecuador,E07,m,31,5,a
mother,435920,436660,740,Ecuador,E07,c,31,6,a
child,437250,437900,650,Ecuador,E07,m,31,7,a
mother,437490,438710,1220,Ecuador,E07,c,31,8,i
mother,470630,471970,1340,Ecuador,E07,f,32,1,a
child,487030,490110,3080,Ecuador,E07,f,33,1,i
father,491890,495820,3930,Ecuador,E07,m,33,2,i
mother,496750,497440,690,Ecuador,E07,f,33,3,q
father,498910,500420,1510,Ecuador,E07,m,33,4,a
mother,504380,505770,1390,Ecuador,E07,f,33,5,i
child,512030,513310,1280,Ecuador,E07,m,33,6,a
mother,512760,514090,1330,Ecuador,E07,c,33,7,i
child,515250,516410,1160,Ecuador,E07,m,33,8,a
mother,517820,518610,790,Ecuador,E07,c,33,9,q
father,520030,522500,2470,Ecuador,E07,c,34,1,a
child,522460,526400,3940,Ecuador,E07,NA,34,2,a
father,527090,528060,970,Ecuador,E07,c,34,3,q
mother,528560,529640,1080,Ecuador,E07,f,34,4,a
father,533300,534860,1560,Ecuador,E07,c,34,5,i
father,553860,556070,2210,Ecuador,E07,c,35,1,i
father,558440,561670,3230,Ecuador,E07,c,35,2,a
mother,561860,562660,800,Ecuador,E07,b,35,3,a
father,563840,566960,3120,Ecuador,E07,m,35,4,q
father,571950,573870,1920,Ecuador,E07,m,36,1,a
father,578210,599130,20920,Ecuador,E07,m,36,2,a
child,594710,596410,1700,Ecuador,E07,o,37,1,a
silence,2560,2760,200,Ecuador,E07,NA,NA,NA,NA
silence,3600,5010,1410,Ecuador,E07,NA,NA,NA,NA
silence,5550,6200,650,Ecuador,E07,NA,NA,NA,NA
silence,8380,16590,8210,Ecuador,E07,NA,NA,NA,NA
silence,20420,20470,50,Ecuador,E07,NA,NA,NA,NA
silence,22290,22720,430,Ecuador,E07,NA,NA,NA,NA
silence,25560,26630,1070,Ecuador,E07,NA,NA,NA,NA
silence,29180,31000,1820,Ecuador,E07,NA,NA,NA,NA
silence,32240,32280,40,Ecuador,E07,NA,NA,NA,NA
silence,34960,37370,2410,Ecuador,E07,NA,NA,NA,NA
silence,42130,42150,20,Ecuador,E07,NA,NA,NA,NA
silence,43740,43760,20,Ecuador,E07,NA,NA,NA,NA
silence,45200,50620,5420,Ecuador,E07,NA,NA,NA,NA
silence,51680,74560,22880,Ecuador,E07,NA,NA,NA,NA
silence,75930,79910,3980,Ecuador,E07,NA,NA,NA,NA
silence,86120,90080,3960,Ecuador,E07,NA,NA,NA,NA
silence,92490,93010,520,Ecuador,E07,NA,NA,NA,NA
silence,93690,96100,2410,Ecuador,E07,NA,NA,NA,NA
child_gesture,96505,100076,3571,Ecuador,E07,NA,NA,NA,NA
silence,96810,99020,2210,Ecuador,E07,NA,NA,NA,NA
father_gesture,99580,100540,960,Ecuador,E07,NA,NA,NA,NA
silence,100320,108700,8380,Ecuador,E07,NA,NA,NA,NA
silence,111500,111610,110,Ecuador,E07,NA,NA,NA,NA
silence,111975,122760,10785,Ecuador,E07,NA,NA,NA,NA
silence,128020,131880,3860,Ecuador,E07,NA,NA,NA,NA
silence,133010,147810,14800,Ecuador,E07,NA,NA,NA,NA
silence,149000,167950,18950,Ecuador,E07,NA,NA,NA,NA
silence,168650,199020,30370,Ecuador,E07,NA,NA,NA,NA
silence,201640,204000,2360,Ecuador,E07,NA,NA,NA,NA
silence,210890,214650,3760,Ecuador,E07,NA,NA,NA,NA
silence,218530,223600,5070,Ecuador,E07,NA,NA,NA,NA
silence,232500,233900,1400,Ecuador,E07,NA,NA,NA,NA
silence,234470,234990,520,Ecuador,E07,NA,NA,NA,NA
silence,239410,241850,2440,Ecuador,E07,NA,NA,NA,NA
silence,242950,247020,4070,Ecuador,E07,NA,NA,NA,NA
silence,247990,248850,860,Ecuador,E07,NA,NA,NA,NA
silence,249330,249760,430,Ecuador,E07,NA,NA,NA,NA
silence,255030,258550,3520,Ecuador,E07,NA,NA,NA,NA
father_gesture,267800,269240,1440,Ecuador,E07,NA,NA,NA,NA
silence,276580,279180,2600,Ecuador,E07,NA,NA,NA,NA
silence,280570,282190,1620,Ecuador,E07,NA,NA,NA,NA
silence,283220,283250,30,Ecuador,E07,NA,NA,NA,NA
silence,283910,287050,3140,Ecuador,E07,NA,NA,NA,NA
silence,290510,293170,2660,Ecuador,E07,NA,NA,NA,NA
silence,298950,305460,6510,Ecuador,E07,NA,NA,NA,NA
silence,311080,314320,3240,Ecuador,E07,NA,NA,NA,NA
silence,315070,320690,5620,Ecuador,E07,NA,NA,NA,NA
silence,322670,329440,6770,Ecuador,E07,NA,NA,NA,NA
mother_gesture,330370,331450,1080,Ecuador,E07,NA,NA,NA,NA
silence,332900,355960,23060,Ecuador,E07,NA,NA,NA,NA
silence,358440,371790,13350,Ecuador,E07,NA,NA,NA,NA
silence,378100,379460,1360,Ecuador,E07,NA,NA,NA,NA
silence,381630,384900,3270,Ecuador,E07,NA,NA,NA,NA
silence,386550,388120,1570,Ecuador,E07,NA,NA,NA,NA
silence,389480,389550,70,Ecuador,E07,NA,NA,NA,NA
silence,390670,395480,4810,Ecuador,E07,NA,NA,NA,NA
silence,399320,400650,1330,Ecuador,E07,NA,NA,NA,NA
silence,403360,406410,3050,Ecuador,E07,NA,NA,NA,NA
silence,407630,410550,2920,Ecuador,E07,NA,NA,NA,NA
silence,411870,417940,6070,Ecuador,E07,NA,NA,NA,NA
silence,421900,424530,2630,Ecuador,E07,NA,NA,NA,NA
silence,425190,427040,1850,Ecuador,E07,NA,NA,NA,NA
silence,428260,431800,3540,Ecuador,E07,NA,NA,NA,NA
silence,434610,435230,620,Ecuador,E07,NA,NA,NA,NA
silence,435860,435920,60,Ecuador,E07,NA,NA,NA,NA
mother_gesture,436620,438060,1440,Ecuador,E07,NA,NA,NA,NA
silence,436660,437250,590,Ecuador,E07,NA,NA,NA,NA
silence,438710,470630,31920,Ecuador,E07,NA,NA,NA,NA
silence,471970,487030,15060,Ecuador,E07,NA,NA,NA,NA
child_gesture,489020,490520,1500,Ecuador,E07,NA,NA,NA,NA
silence,490110,491890,1780,Ecuador,E07,NA,NA,NA,NA
silence,495820,496750,930,Ecuador,E07,NA,NA,NA,NA
silence,497440,498910,1470,Ecuador,E07,NA,NA,NA,NA
silence,500420,504380,3960,Ecuador,E07,NA,NA,NA,NA
silence,505770,512030,6260,Ecuador,E07,NA,NA,NA,NA
silence,514090,515250,1160,Ecuador,E07,NA,NA,NA,NA
silence,516410,517820,1410,Ecuador,E07,NA,NA,NA,NA
silence,518610,520030,1420,Ecuador,E07,NA,NA,NA,NA
silence,526400,527090,690,Ecuador,E07,NA,NA,NA,NA
silence,528060,528560,500,Ecuador,E07,NA,NA,NA,NA
silence,529640,533300,3660,Ecuador,E07,NA,NA,NA,NA
silence,534860,553860,19000,Ecuador,E07,NA,NA,NA,NA
silence,556070,558440,2370,Ecuador,E07,NA,NA,NA,NA
silence,561670,561860,190,Ecuador,E07,NA,NA,NA,NA
silence,562660,563840,1180,Ecuador,E07,NA,NA,NA,NA
silence,566960,571950,4990,Ecuador,E07,NA,NA,NA,NA
silence,573870,578210,4340,Ecuador,E07,NA,NA,NA,NA
father_gesture,580790,582436,1646,Ecuador,E07,NA,NA,NA,NA
father_gesture,595327,599280,3953,Ecuador,E07,NA,NA,NA,NA
father,910,2144,1234,Ecuador,E08,b,1,1,a
child,2133,11891,9758,Ecuador,E08,b,1,2,a
child,13395,15284,1889,Ecuador,E08,f,1,3,a
father,14738,17660,2922,Ecuador,E08,c,1,4,i
father,20491,21422,931,Ecuador,E08,c,1,5,a
child,21670,28422,6752,Ecuador,E08,m,1,6,a
mother,27119,28629,1510,Ecuador,E08,c,1,7,a
father,28753,29850,1097,Ecuador,E08,c,1,8,a
father,33829,35084,1255,Ecuador,E08,c,1,9,a
child,34450,38105,3655,Ecuador,E08,f,1,10,a
father,38105,39422,1317,Ecuador,E08,c,1,11,q
father,42326,48346,6020,Ecuador,E08,c,1,12,a
child,48505,50229,1724,Ecuador,E08,f,1,13,a
father,49498,50595,1097,Ecuador,E08,c,1,14,q
child,51022,53112,2090,Ecuador,E08,f,1,15,a
child,54146,59443,5297,Ecuador,E08,b,1,16,a
father,58608,59746,1138,Ecuador,E08,c,1,17,q
mother,59595,61395,1800,Ecuador,E08,f,1,18,a
child,60691,63395,2704,Ecuador,E08,b,1,19,a
father,60802,66098,5296,Ecuador,E08,c,1,20,i
child,65291,70546,5255,Ecuador,E08,b,1,21,a
father,67822,72657,4835,Ecuador,E08,c,1,22,a
child,72022,77077,5055,Ecuador,E08,b,1,23,a
father,77429,78650,1221,Ecuador,E08,c,1,24,i
child,78643,80643,2000,Ecuador,E08,f,1,25,a
father,80788,81602,814,Ecuador,E08,c,1,26,a
child,81353,82677,1324,Ecuador,E08,f,1,27,a
father,82188,84167,1979,Ecuador,E08,c,1,28,a
child,83664,86664,3000,Ecuador,E08,f,1,29,a
mother,11236,13388,2152,Ecuador,E08,f,2,1,q
mother,53229,54312,1083,Ecuador,E08,f,3,1,q
mother,75995,77450,1455,Ecuador,E08,f,4,1,i
father,86898,88677,1779,Ecuador,E08,o,5,1,a
father,94974,95939,965,Ecuador,E08,c,6,1,a
child,137002,142746,5744,Ecuador,E08,f,7,1,a
father,139395,140050,655,Ecuador,E08,c,7,2,a
child,155788,158464,2676,Ecuador,E08,f,8,1,a
father,159077,159967,890,Ecuador,E08,c,8,2,a
child,159974,161139,1165,Ecuador,E08,f,8,3,a
father,174298,175002,704,Ecuador,E08,m,9,1,q
mother,194333,195567,1234,Ecuador,E08,b,10,1,a
mother,198705,200402,1697,Ecuador,E08,f,11,1,q
father,200898,204519,3621,Ecuador,E08,m,11,2,i
mother,204436,204926,490,Ecuador,E08,f,11,3,a
child,236615,238939,2324,Ecuador,E08,f,12,1,a
father,239222,246608,7386,Ecuador,E08,c,12,2,a
child,244257,244898,641,Ecuador,E08,c,12,3,a
father,249712,251002,1290,Ecuador,E08,c,12,4,a
father,269153,270126,973,Ecuador,E08,c,13,1,a
mother,284181,285981,1800,Ecuador,E08,f,14,1,a
mother,290870,295802,4932,Ecuador,E08,f,14,2,a
father,296064,296684,620,Ecuador,E08,m,14,3,a
mother,297070,298491,1421,Ecuador,E08,f,14,4,a
father,299360,301146,1786,Ecuador,E08,m,14,5,a
mother,303919,305822,1903,Ecuador,E08,f,14,6,a
father,313153,314608,1455,Ecuador,E08,m,15,1,q
mother,314676,315266,590,Ecuador,E08,f,15,2,a
father,315464,318167,2703,Ecuador,E08,m,15,3,a
mother,317491,318933,1442,Ecuador,E08,f,16,1,a
mother,323850,324643,793,Ecuador,E08,b,17,1,q
father,325195,325822,627,Ecuador,E08,c,17,2,i
child,326174,329643,3469,Ecuador,E08,f,17,3,a
father,334608,335664,1056,Ecuador,E08,c,17,4,i
mother,343602,355243,11641,Ecuador,E08,b,17,5,a
father,355677,356912,1235,Ecuador,E08,m,17,6,q
mother,357340,358064,724,Ecuador,E08,f,17,7,a
father,374753,376540,1787,Ecuador,E08,m,18,1,q
mother,376622,377533,911,Ecuador,E08,f,18,2,a
father,377643,378271,628,Ecuador,E08,m,18,3,a
mother,378367,379477,1110,Ecuador,E08,f,18,4,a
father,379484,380181,697,Ecuador,E08,m,18,5,a
mother,380615,381312,697,Ecuador,E08,f,18,6,a
father,382277,386698,4421,Ecuador,E08,m,18,7,a
mother,387395,388326,931,Ecuador,E08,f,18,8,a
father,388353,389229,876,Ecuador,E08,m,18,9,q
mother,389726,391202,1476,Ecuador,E08,f,18,10,a
mother,398464,402774,4310,Ecuador,E08,f,18,11,a
child,376126,378533,2407,Ecuador,E08,f,19,1,a
mother,412291,415084,2793,Ecuador,E08,b,19,2,i
child,415829,417671,1842,Ecuador,E08,m,19,3,a
mother,417243,419388,2145,Ecuador,E08,c,19,4,i
father,418629,421133,2504,Ecuador,E08,m,19,5,a
child,422546,424519,1973,Ecuador,E08,b,19,6,a
father,424153,425567,1414,Ecuador,E08,c,19,7,q
child,425533,431774,6241,Ecuador,E08,b,19,8,a
mother,429802,433560,3758,Ecuador,E08,f,19,9,a
father,434050,436526,2476,Ecuador,E08,c,19,10,a
child,437098,441298,4200,Ecuador,E08,m,19,11,a
father,437181,442022,4841,Ecuador,E08,c,19,12,i
mother,441188,442726,1538,Ecuador,E08,c,19,13,i
child,447057,448602,1545,Ecuador,E08,m,19,14,a
mother,447898,451312,3414,Ecuador,E08,c,19,15,a
child,451622,453174,1552,Ecuador,E08,m,19,16,a
mother,452767,453684,917,Ecuador,E08,c,19,17,i
father,453788,454905,1117,Ecuador,E08,c,19,18,i
father,461553,466367,4814,Ecuador,E08,c,19,19,a
mother,482609,487064,4455,Ecuador,E08,o,20,1,a
mother,490988,492677,1689,Ecuador,E08,o,20,2,a
mother,494770,495822,1052,Ecuador,E08,f,20,3,a
father,497159,498822,1663,Ecuador,E08,m,20,4,i
father,500264,503567,3303,Ecuador,E08,o,20,5,a
mother,515215,517167,1952,Ecuador,E08,f,21,1,a
father,525436,527912,2476,Ecuador,E08,m,22,1,a
father,536271,537174,903,Ecuador,E08,m,23,1,q
mother,537277,538160,883,Ecuador,E08,m,23,2,a
father,539871,543622,3751,Ecuador,E08,c,23,3,q
child,542940,544243,1303,Ecuador,E08,f,23,4,a
mother,550567,552360,1793,Ecuador,E08,f,24,1,q
father,552367,553112,745,Ecuador,E08,m,24,2,a
silence,854,910,56,Ecuador,E08,NA,NA,NA,NA
silence,13388,13395,7,Ecuador,E08,NA,NA,NA,NA
silence,17660,20491,2831,Ecuador,E08,NA,NA,NA,NA
silence,21422,21670,248,Ecuador,E08,NA,NA,NA,NA
silence,28629,28753,124,Ecuador,E08,NA,NA,NA,NA
silence,29850,33829,3979,Ecuador,E08,NA,NA,NA,NA
silence,39422,42326,2904,Ecuador,E08,NA,NA,NA,NA
silence,48346,48505,159,Ecuador,E08,NA,NA,NA,NA
silence,50595,51022,427,Ecuador,E08,NA,NA,NA,NA
silence,53112,53229,117,Ecuador,E08,NA,NA,NA,NA
silence,80643,80788,145,Ecuador,E08,NA,NA,NA,NA
silence,86664,86898,234,Ecuador,E08,NA,NA,NA,NA
silence,88677,94974,6297,Ecuador,E08,NA,NA,NA,NA
silence,95939,137002,41063,Ecuador,E08,NA,NA,NA,NA
silence,142746,155788,13042,Ecuador,E08,NA,NA,NA,NA
silence,158464,159077,613,Ecuador,E08,NA,NA,NA,NA
silence,159967,159974,7,Ecuador,E08,NA,NA,NA,NA
silence,161139,174298,13159,Ecuador,E08,NA,NA,NA,NA
silence,175002,194333,19331,Ecuador,E08,NA,NA,NA,NA
silence,195567,198705,3138,Ecuador,E08,NA,NA,NA,NA
silence,200402,200898,496,Ecuador,E08,NA,NA,NA,NA
silence,204926,236615,31689,Ecuador,E08,NA,NA,NA,NA
silence,238939,239222,283,Ecuador,E08,NA,NA,NA,NA
father_gesture,244091,248572,4481,Ecuador,E08,NA,NA,NA,NA
silence,246608,249712,3104,Ecuador,E08,NA,NA,NA,NA
silence,251002,269153,18151,Ecuador,E08,NA,NA,NA,NA
silence,270126,284181,14055,Ecuador,E08,NA,NA,NA,NA
silence,285981,290870,4889,Ecuador,E08,NA,NA,NA,NA
silence,295802,296064,262,Ecuador,E08,NA,NA,NA,NA
silence,296684,297070,386,Ecuador,E08,NA,NA,NA,NA
silence,298491,299360,869,Ecuador,E08,NA,NA,NA,NA
silence,301146,303919,2773,Ecuador,E08,NA,NA,NA,NA
silence,305822,313153,7331,Ecuador,E08,NA,NA,NA,NA
silence,314608,314676,68,Ecuador,E08,NA,NA,NA,NA
silence,315266,315464,198,Ecuador,E08,NA,NA,NA,NA
father_gesture,317248,319251,2003,Ecuador,E08,NA,NA,NA,NA
silence,318933,323850,4917,Ecuador,E08,NA,NA,NA,NA
silence,324643,325195,552,Ecuador,E08,NA,NA,NA,NA
silence,325822,326174,352,Ecuador,E08,NA,NA,NA,NA
silence,329643,334608,4965,Ecuador,E08,NA,NA,NA,NA
silence,335664,343602,7938,Ecuador,E08,NA,NA,NA,NA
silence,355243,355677,434,Ecuador,E08,NA,NA,NA,NA
silence,356912,357340,428,Ecuador,E08,NA,NA,NA,NA
silence,358064,374753,16689,Ecuador,E08,NA,NA,NA,NA
silence,379477,379484,7,Ecuador,E08,NA,NA,NA,NA
silence,380181,380615,434,Ecuador,E08,NA,NA,NA,NA
silence,381312,382277,965,Ecuador,E08,NA,NA,NA,NA
silence,386698,387395,697,Ecuador,E08,NA,NA,NA,NA
silence,388326,388353,27,Ecuador,E08,NA,NA,NA,NA
silence,389229,389726,497,Ecuador,E08,NA,NA,NA,NA
silence,391202,398464,7262,Ecuador,E08,NA,NA,NA,NA
silence,402774,412291,9517,Ecuador,E08,NA,NA,NA,NA
silence,415084,415829,745,Ecuador,E08,NA,NA,NA,NA
silence,421133,422546,1413,Ecuador,E08,NA,NA,NA,NA
silence,433560,434050,490,Ecuador,E08,NA,NA,NA,NA
silence,436526,437098,572,Ecuador,E08,NA,NA,NA,NA
silence,442726,447057,4331,Ecuador,E08,NA,NA,NA,NA
mother_gesture,448663,451275,2612,Ecuador,E08,NA,NA,NA,NA
silence,451312,451622,310,Ecuador,E08,NA,NA,NA,NA
silence,453684,453788,104,Ecuador,E08,NA,NA,NA,NA
silence,454905,461553,6648,Ecuador,E08,NA,NA,NA,NA
silence,466367,482609,16242,Ecuador,E08,NA,NA,NA,NA
silence,487064,490988,3924,Ecuador,E08,NA,NA,NA,NA
silence,492677,494770,2093,Ecuador,E08,NA,NA,NA,NA
silence,495822,497159,1337,Ecuador,E08,NA,NA,NA,NA
silence,498822,500264,1442,Ecuador,E08,NA,NA,NA,NA
silence,503567,515215,11648,Ecuador,E08,NA,NA,NA,NA
mother_gesture,515538,517241,1703,Ecuador,E08,NA,NA,NA,NA
silence,517167,525436,8269,Ecuador,E08,NA,NA,NA,NA
silence,527912,536271,8359,Ecuador,E08,NA,NA,NA,NA
silence,537174,537277,103,Ecuador,E08,NA,NA,NA,NA
silence,538160,539871,1711,Ecuador,E08,NA,NA,NA,NA
silence,544243,550567,6324,Ecuador,E08,NA,NA,NA,NA
silence,552360,552367,7,Ecuador,E08,NA,NA,NA,NA
child,2410,2950,540,Ecuador,E09,b,1,1,a
mother,5970,30050,24080,Ecuador,E09,o,2,1,a
child,23240,27270,4030,Ecuador,E09,f,3,1,a
mother,31230,32300,1070,Ecuador,E09,c,3,2,a
father,33070,35060,1990,Ecuador,E09,c,3,3,a
mother,37410,42260,4850,Ecuador,E09,c,3,4,a
child,45860,46510,650,Ecuador,E09,m,3,5,a
mother,47480,48990,1510,Ecuador,E09,c,3,6,i
child,54900,57500,2600,Ecuador,E09,m,3,7,a
mother,58230,60170,1940,Ecuador,E09,c,3,8,a
child,62160,62850,690,Ecuador,E09,m,3,9,a
mother,63200,63940,740,Ecuador,E09,c,3,10,a
father,63440,65110,1670,Ecuador,E09,m,4,1,q
mother,65650,66060,410,Ecuador,E09,f,4,2,q
father,66080,67500,1420,Ecuador,E09,m,4,3,q
mother,67510,68350,840,Ecuador,E09,f,4,4,a
mother,71020,72120,1100,Ecuador,E09,f,4,5,q
father,72220,72840,620,Ecuador,E09,m,4,6,a
mother,72800,73550,750,Ecuador,E09,f,4,7,a
child,68410,69050,640,Ecuador,E09,b,5,1,a
mother,75260,76850,1590,Ecuador,E09,f,6,1,a
mother,81870,97850,15980,Ecuador,E09,f,6,2,a
father,99460,101900,2440,Ecuador,E09,m,6,3,q
mother,102050,110040,7990,Ecuador,E09,f,6,4,q
father,109990,110590,600,Ecuador,E09,m,6,5,a
mother,110620,118220,7600,Ecuador,E09,f,6,6,a
father,117480,118310,830,Ecuador,E09,m,6,7,a
mother,118640,120630,1990,Ecuador,E09,f,6,8,a
child,139910,140480,570,Ecuador,E09,m,7,1,a
mother,141910,146630,4720,Ecuador,E09,c,7,2,a
father,148060,148850,790,Ecuador,E09,c,7,3,q
child,151870,152530,660,Ecuador,E09,f,7,4,a
father,152640,153140,500,Ecuador,E09,c,7,5,a
child,156050,157810,1760,Ecuador,E09,f,7,6,q
father,157720,158390,670,Ecuador,E09,c,7,7,a
child,158780,160800,2020,Ecuador,E09,f,7,8,a
mother,160890,163560,2670,Ecuador,E09,c,7,9,a
father,163540,164280,740,Ecuador,E09,c,7,10,a
child,164450,165490,1040,Ecuador,E09,m,7,11,q
mother,168140,169230,1090,Ecuador,E09,c,7,12,i
mother,180850,182090,1240,Ecuador,E09,c,8,1,i
child,189600,190350,750,Ecuador,E09,m,8,2,a
father,193600,194750,1150,Ecuador,E09,m,9,1,i
mother,195380,196320,940,Ecuador,E09,f,9,2,q
child,209510,210280,770,Ecuador,E09,b,10,1,a
father,213860,214550,690,Ecuador,E09,c,10,2,i
mother,220520,222300,1780,Ecuador,E09,f,11,1,a
father,221900,225910,4010,Ecuador,E09,m,11,2,q
mother,225620,226350,730,Ecuador,E09,f,11,3,a
father,227770,229650,1880,Ecuador,E09,m,11,4,q
father,232140,233730,1590,Ecuador,E09,m,11,5,a
mother,233000,239210,6210,Ecuador,E09,f,11,6,a
father,237910,239980,2070,Ecuador,E09,m,11,7,a
mother,240210,252850,12640,Ecuador,E09,f,11,8,a
father,253770,254520,750,Ecuador,E09,m,11,9,q
mother,255260,257370,2110,Ecuador,E09,f,11,10,a
father,258420,263020,4600,Ecuador,E09,m,11,11,a
mother,268130,281910,13780,Ecuador,E09,f,11,12,a
mother,284110,285400,1290,Ecuador,E09,f,11,13,a
father,285760,287650,1890,Ecuador,E09,m,11,14,q
mother,288100,290160,2060,Ecuador,E09,f,11,15,a
father,294020,296030,2010,Ecuador,E09,m,11,16,q
mother,296010,296690,680,Ecuador,E09,f,11,17,a
father,296320,297160,840,Ecuador,E09,m,11,18,a
child,287890,291720,3830,Ecuador,E09,m,12,1,a
child,301680,302300,620,Ecuador,E09,m,13,1,a
mother,301920,303520,1600,Ecuador,E09,c,13,2,a
father,304180,305060,880,Ecuador,E09,c,13,3,q
child,307470,308100,630,Ecuador,E09,b,13,4,a
father,309250,309960,710,Ecuador,E09,c,13,5,q
mother,312160,313770,1610,Ecuador,E09,c,14,1,i
child,313810,314320,510,Ecuador,E09,m,14,2,a
father,315190,318140,2950,Ecuador,E09,c,14,3,i
mother,317720,318880,1160,Ecuador,E09,b,14,4,a
father,319720,320690,970,Ecuador,E09,c,14,5,a
mother,320750,321900,1150,Ecuador,E09,f,14,6,a
father,332640,334320,1680,Ecuador,E09,c,15,1,a
child,334380,334960,580,Ecuador,E09,f,15,2,a
father,335040,335940,900,Ecuador,E09,c,15,3,q
child,336130,341280,5150,Ecuador,E09,f,15,4,a
father,340540,341340,800,Ecuador,E09,c,15,5,a
child,341910,347000,5090,Ecuador,E09,m,15,6,a
mother,347410,349090,1680,Ecuador,E09,c,15,7,a
child,349220,349860,640,Ecuador,E09,m,15,8,a
father,349700,351080,1380,Ecuador,E09,c,15,9,q
child,351150,351660,510,Ecuador,E09,f,15,10,a
mother,354020,355420,1400,Ecuador,E09,c,15,11,i
mother,358690,360180,1490,Ecuador,E09,c,15,12,i
father,384060,384640,580,Ecuador,E09,m,16,1,a
mother,385320,386240,920,Ecuador,E09,f,16,2,a
father,386400,387100,700,Ecuador,E09,m,16,3,a
mother,387380,388000,620,Ecuador,E09,f,16,4,a
child,390570,392560,1990,Ecuador,E09,f,17,1,a
father,391690,392430,740,Ecuador,E09,c,17,2,q
child,396240,397270,1030,Ecuador,E09,f,17,3,a
mother,398180,402360,4180,Ecuador,E09,c,17,4,q
child,406780,407550,770,Ecuador,E09,b,18,1,a
father,415070,417720,2650,Ecuador,E09,c,18,2,a
child,418660,420070,1410,Ecuador,E09,f,18,3,a
father,419360,420810,1450,Ecuador,E09,c,18,4,q
child,421660,422400,740,Ecuador,E09,f,18,5,a
father,422050,422840,790,Ecuador,E09,c,18,6,i
mother,423190,424890,1700,Ecuador,E09,c,18,7,a
father,424590,425470,880,Ecuador,E09,c,18,8,a
child,426590,428700,2110,Ecuador,E09,f,18,9,a
father,428350,429040,690,Ecuador,E09,c,18,10,a
mother,407490,410290,2800,Ecuador,E09,f,19,1,q
mother,441250,443760,2510,Ecuador,E09,f,20,1,a
child,443080,444330,1250,Ecuador,E09,m,20,2,a
child,449530,450190,660,Ecuador,E09,m,20,3,a
father,460520,461320,800,Ecuador,E09,m,21,1,q
mother,461270,465430,4160,Ecuador,E09,f,22,1,a
father,465080,465910,830,Ecuador,E09,m,22,2,a
mother,468070,468860,790,Ecuador,E09,f,22,3,a
mother,480900,483070,2170,Ecuador,E09,c,23,1,i
child,484370,485190,820,Ecuador,E09,m,23,2,a
mother,484860,486710,1850,Ecuador,E09,c,23,3,a
child,490570,498110,7540,Ecuador,E09,m,23,4,a
mother,516440,517340,900,Ecuador,E09,c,24,1,a
child,527210,527790,580,Ecuador,E09,m,25,1,a
mother,563370,566770,3400,Ecuador,E09,c,25,2,a
father,579320,580460,1140,Ecuador,E09,o,26,1,a
father,588880,590190,1310,Ecuador,E09,o,26,2,q
child,583290,584740,1450,Ecuador,E09,f,27,1,a
mother,589840,591610,1770,Ecuador,E09,c,28,1,a
child,591640,592200,560,Ecuador,E09,m,28,2,a
silence,2950,5970,3020,Ecuador,E09,NA,NA,NA,NA
child_gesture,25800,27791,1991,Ecuador,E09,NA,NA,NA,NA
silence,30050,31230,1180,Ecuador,E09,NA,NA,NA,NA
silence,32300,33070,770,Ecuador,E09,NA,NA,NA,NA
silence,35060,37410,2350,Ecuador,E09,NA,NA,NA,NA
silence,42260,45860,3600,Ecuador,E09,NA,NA,NA,NA
silence,46510,47480,970,Ecuador,E09,NA,NA,NA,NA
mother_gesture,47950,49030,1080,Ecuador,E09,NA,NA,NA,NA
silence,48990,54900,5910,Ecuador,E09,NA,NA,NA,NA
silence,57500,58230,730,Ecuador,E09,NA,NA,NA,NA
silence,60170,62160,1990,Ecuador,E09,NA,NA,NA,NA
silence,62850,63200,350,Ecuador,E09,NA,NA,NA,NA
silence,65110,65650,540,Ecuador,E09,NA,NA,NA,NA
silence,66060,66080,20,Ecuador,E09,NA,NA,NA,NA
silence,67500,67510,10,Ecuador,E09,NA,NA,NA,NA
silence,68350,68410,60,Ecuador,E09,NA,NA,NA,NA
silence,69050,71020,1970,Ecuador,E09,NA,NA,NA,NA
silence,72120,72220,100,Ecuador,E09,NA,NA,NA,NA
silence,73550,75260,1710,Ecuador,E09,NA,NA,NA,NA
silence,76850,81870,5020,Ecuador,E09,NA,NA,NA,NA
mother_gesture,89966,91345,1379,Ecuador,E09,NA,NA,NA,NA
silence,97850,99460,1610,Ecuador,E09,NA,NA,NA,NA
silence,101900,102050,150,Ecuador,E09,NA,NA,NA,NA
silence,110590,110620,30,Ecuador,E09,NA,NA,NA,NA
silence,118310,118640,330,Ecuador,E09,NA,NA,NA,NA
silence,120630,139910,19280,Ecuador,E09,NA,NA,NA,NA
silence,140480,141910,1430,Ecuador,E09,NA,NA,NA,NA
silence,146630,148060,1430,Ecuador,E09,NA,NA,NA,NA
silence,148850,151870,3020,Ecuador,E09,NA,NA,NA,NA
silence,152530,152640,110,Ecuador,E09,NA,NA,NA,NA
silence,153140,156050,2910,Ecuador,E09,NA,NA,NA,NA
silence,158390,158780,390,Ecuador,E09,NA,NA,NA,NA
silence,160800,160890,90,Ecuador,E09,NA,NA,NA,NA
silence,164280,164450,170,Ecuador,E09,NA,NA,NA,NA
silence,165490,168140,2650,Ecuador,E09,NA,NA,NA,NA
silence,169230,180850,11620,Ecuador,E09,NA,NA,NA,NA
mother_gesture,180726,182556,1830,Ecuador,E09,NA,NA,NA,NA
silence,182090,189600,7510,Ecuador,E09,NA,NA,NA,NA
silence,190350,193600,3250,Ecuador,E09,NA,NA,NA,NA
silence,194750,195380,630,Ecuador,E09,NA,NA,NA,NA
silence,196320,209510,13190,Ecuador,E09,NA,NA,NA,NA
silence,210280,213860,3580,Ecuador,E09,NA,NA,NA,NA
father_gesture,213676,215147,1471,Ecuador,E09,NA,NA,NA,NA
silence,214550,220520,5970,Ecuador,E09,NA,NA,NA,NA
silence,226350,227770,1420,Ecuador,E09,NA,NA,NA,NA
silence,229650,232140,2490,Ecuador,E09,NA,NA,NA,NA
mother_gesture,236471,238497,2026,Ecuador,E09,NA,NA,NA,NA
silence,239980,240210,230,Ecuador,E09,NA,NA,NA,NA
mother_gesture,249490,252806,3316,Ecuador,E09,NA,NA,NA,NA
silence,252850,253770,920,Ecuador,E09,NA,NA,NA,NA
silence,254520,255260,740,Ecuador,E09,NA,NA,NA,NA
silence,257370,258420,1050,Ecuador,E09,NA,NA,NA,NA
silence,263020,268130,5110,Ecuador,E09,NA,NA,NA,NA
mother_gesture,267583,269714,2131,Ecuador,E09,NA,NA,NA,NA
mother_gesture,271905,273254,1349,Ecuador,E09,NA,NA,NA,NA
mother_gesture,274513,276223,1710,Ecuador,E09,NA,NA,NA,NA
silence,281910,284110,2200,Ecuador,E09,NA,NA,NA,NA
silence,285400,285760,360,Ecuador,E09,NA,NA,NA,NA
father_gesture,287082,288518,1436,Ecuador,E09,NA,NA,NA,NA
silence,287650,287890,240,Ecuador,E09,NA,NA,NA,NA
mother_gesture,289006,291288,2282,Ecuador,E09,NA,NA,NA,NA
silence,291720,294020,2300,Ecuador,E09,NA,NA,NA,NA
silence,297160,301680,4520,Ecuador,E09,NA,NA,NA,NA
silence,303520,304180,660,Ecuador,E09,NA,NA,NA,NA
silence,305060,307470,2410,Ecuador,E09,NA,NA,NA,NA
silence,308100,309250,1150,Ecuador,E09,NA,NA,NA,NA
silence,309960,312160,2200,Ecuador,E09,NA,NA,NA,NA
silence,313770,313810,40,Ecuador,E09,NA,NA,NA,NA
silence,314320,315190,870,Ecuador,E09,NA,NA,NA,NA
silence,318880,319720,840,Ecuador,E09,NA,NA,NA,NA
mother_gesture,320465,322355,1890,Ecuador,E09,NA,NA,NA,NA
silence,320690,320750,60,Ecuador,E09,NA,NA,NA,NA
silence,321900,332640,10740,Ecuador,E09,NA,NA,NA,NA
silence,334320,334380,60,Ecuador,E09,NA,NA,NA,NA
silence,334960,335040,80,Ecuador,E09,NA,NA,NA,NA
silence,335940,336130,190,Ecuador,E09,NA,NA,NA,NA
silence,341340,341910,570,Ecuador,E09,NA,NA,NA,NA
silence,347000,347410,410,Ecuador,E09,NA,NA,NA,NA
silence,349090,349220,130,Ecuador,E09,NA,NA,NA,NA
silence,351080,351150,70,Ecuador,E09,NA,NA,NA,NA
silence,351660,354020,2360,Ecuador,E09,NA,NA,NA,NA
silence,355420,358690,3270,Ecuador,E09,NA,NA,NA,NA
mother_gesture,358770,360463,1693,Ecuador,E09,NA,NA,NA,NA
silence,360180,384060,23880,Ecuador,E09,NA,NA,NA,NA
silence,384640,385320,680,Ecuador,E09,NA,NA,NA,NA
silence,386240,386400,160,Ecuador,E09,NA,NA,NA,NA
silence,387100,387380,280,Ecuador,E09,NA,NA,NA,NA
silence,388000,390570,2570,Ecuador,E09,NA,NA,NA,NA
silence,392560,396240,3680,Ecuador,E09,NA,NA,NA,NA
silence,397270,398180,910,Ecuador,E09,NA,NA,NA,NA
silence,402360,406780,4420,Ecuador,E09,NA,NA,NA,NA
mother_gesture,407905,409585,1680,Ecuador,E09,NA,NA,NA,NA
silence,410290,415070,4780,Ecuador,E09,NA,NA,NA,NA
silence,417720,418660,940,Ecuador,E09,NA,NA,NA,NA
silence,420810,421660,850,Ecuador,E09,NA,NA,NA,NA
mother_gesture,422558,424867,2309,Ecuador,E09,NA,NA,NA,NA
silence,422840,423190,350,Ecuador,E09,NA,NA,NA,NA
father_gesture,424365,425019,654,Ecuador,E09,NA,NA,NA,NA
father_gesture,425019,425665,646,Ecuador,E09,NA,NA,NA,NA
silence,425470,426590,1120,Ecuador,E09,NA,NA,NA,NA
silence,429040,441250,12210,Ecuador,E09,NA,NA,NA,NA
silence,444330,449530,5200,Ecuador,E09,NA,NA,NA,NA
silence,450190,460520,10330,Ecuador,E09,NA,NA,NA,NA
father_gesture,464935,466285,1350,Ecuador,E09,NA,NA,NA,NA
silence,465910,468070,2160,Ecuador,E09,NA,NA,NA,NA
silence,468860,480900,12040,Ecuador,E09,NA,NA,NA,NA
mother_gesture,481214,483044,1830,Ecuador,E09,NA,NA,NA,NA
silence,483070,484370,1300,Ecuador,E09,NA,NA,NA,NA
mother_gesture,484930,486160,1230,Ecuador,E09,NA,NA,NA,NA
mother_gesture,486160,487360,1200,Ecuador,E09,NA,NA,NA,NA
silence,486710,490570,3860,Ecuador,E09,NA,NA,NA,NA
silence,498110,516440,18330,Ecuador,E09,NA,NA,NA,NA
silence,517340,527210,9870,Ecuador,E09,NA,NA,NA,NA
silence,527790,563370,35580,Ecuador,E09,NA,NA,NA,NA
silence,566770,579320,12550,Ecuador,E09,NA,NA,NA,NA
silence,580460,583290,2830,Ecuador,E09,NA,NA,NA,NA
silence,584740,588880,4140,Ecuador,E09,NA,NA,NA,NA
mother_gesture,589810,591310,1500,Ecuador,E09,NA,NA,NA,NA
silence,591610,591640,30,Ecuador,E09,NA,NA,NA,NA
child,3750,4540,790,Ecuador,E10,m,1,1,a
mother,4380,5960,1580,Ecuador,E10,c,1,2,a
mother,7670,61640,53970,Ecuador,E10,o,2,1,a
child,44940,45810,870,Ecuador,E10,f,3,1,a
father,57930,59780,1850,Ecuador,E10,c,4,1,a
child,60170,60720,550,Ecuador,E10,f,4,2,a
father,61120,61710,590,Ecuador,E10,c,4,3,a
child,62960,65430,2470,Ecuador,E10,m,5,1,a
mother,64640,67390,2750,Ecuador,E10,c,5,2,q
child,68360,68960,600,Ecuador,E10,m,5,3,q
mother,68460,70070,1610,Ecuador,E10,c,5,4,q
child,71560,73290,1730,Ecuador,E10,m,5,5,a
father,82800,85270,2470,Ecuador,E10,c,5,6,i
child,86000,96800,10800,Ecuador,E10,f,5,7,a
father,94600,96240,1640,Ecuador,E10,c,5,8,i
child,100510,101230,720,Ecuador,E10,f,5,9,a
mother,102350,104210,1860,Ecuador,E10,c,5,10,i
child,103790,104600,810,Ecuador,E10,m,5,11,a
mother,105430,108060,2630,Ecuador,E10,c,5,12,a
mother,111450,113710,2260,Ecuador,E10,c,5,13,i
child,114640,115120,480,Ecuador,E10,m,5,14,a
mother,115180,115630,450,Ecuador,E10,c,5,15,q
child,116360,119420,3060,Ecuador,E10,m,5,16,a
mother,122610,124230,1620,Ecuador,E10,c,5,17,i
child,127600,128150,550,Ecuador,E10,m,5,18,a
mother,131340,133090,1750,Ecuador,E10,c,5,19,i
child,138370,141420,3050,Ecuador,E10,m,5,20,a
mother,143250,144770,1520,Ecuador,E10,c,5,21,i
child,143300,143750,450,Ecuador,E10,m,5,22,a
mother,150800,152130,1330,Ecuador,E10,c,5,23,i
child,153040,154920,1880,Ecuador,E10,c,5,24,a
father,154570,155690,1120,Ecuador,E10,m,6,1,q
mother,155700,156100,400,Ecuador,E10,f,6,2,q
father,156070,157040,970,Ecuador,E10,m,6,3,q
mother,156980,157820,840,Ecuador,E10,f,6,4,a
child,159730,160890,1160,Ecuador,E10,m,7,1,a
mother,164040,165220,1180,Ecuador,E10,o,8,1,a
father,167740,169450,1710,Ecuador,E10,m,9,1,q
mother,170210,172180,1970,Ecuador,E10,f,9,2,a
mother,179040,180620,1580,Ecuador,E10,c,10,1,i
father,187130,188900,1770,Ecuador,E10,b,11,1,q
mother,189180,189690,510,Ecuador,E10,f,11,2,a
child,191160,192430,1270,Ecuador,E10,b,12,1,a
mother,191900,194390,2490,Ecuador,E10,c,12,2,a
father,215270,217690,2420,Ecuador,E10,c,13,1,a
child,217980,218790,810,Ecuador,E10,b,13,2,a
mother,218480,219560,1080,Ecuador,E10,c,13,3,a
child,219960,220500,540,Ecuador,E10,m,13,4,a
mother,220950,222300,1350,Ecuador,E10,c,13,5,a
child,232880,234040,1160,Ecuador,E10,f,14,1,a
child,238450,243070,4620,Ecuador,E10,b,14,2,a
child,247640,250770,3130,Ecuador,E10,b,14,3,a
father,251270,252950,1680,Ecuador,E10,c,14,4,i
child,254100,255610,1510,Ecuador,E10,f,14,5,a
father,255750,256550,800,Ecuador,E10,c,14,6,a
child,257010,260410,3400,Ecuador,E10,m,14,7,a
mother,266190,267460,1270,Ecuador,E10,o,15,1,a
father,287810,289970,2160,Ecuador,E10,m,16,1,q
mother,297070,298900,1830,Ecuador,E10,f,16,2,q
father,298250,298910,660,Ecuador,E10,m,16,3,a
father,301220,302790,1570,Ecuador,E10,m,16,4,q
mother,304160,305360,1200,Ecuador,E10,f,16,5,q
father,305670,306200,530,Ecuador,E10,m,16,6,a
child,293560,294850,1290,Ecuador,E10,b,17,1,a
child,305290,309070,3780,Ecuador,E10,b,18,1,a
mother,306970,308610,1640,Ecuador,E10,f,19,1,a
father,310000,311290,1290,Ecuador,E10,m,19,2,q
mother,311380,311560,180,Ecuador,E10,f,19,3,a
father,311600,312520,920,Ecuador,E10,m,19,4,q
mother,312460,312760,300,Ecuador,E10,f,19,5,a
father,314230,316000,1770,Ecuador,E10,m,19,6,a
mother,316010,316760,750,Ecuador,E10,f,19,7,a
child,312850,314000,1150,Ecuador,E10,f,20,1,a
child,319710,323670,3960,Ecuador,E10,b,20,2,a
child,328200,333050,4850,Ecuador,E10,b,20,3,a
child,340580,343240,2660,Ecuador,E10,b,20,4,a
father,339410,340390,980,Ecuador,E10,m,21,1,i
child,362880,363690,810,Ecuador,E10,f,21,2,a
child,366290,368360,2070,Ecuador,E10,f,21,3,a
child,373620,374640,1020,Ecuador,E10,f,21,4,a
child,402810,404420,1610,Ecuador,E10,m,21,5,a
mother,371480,374650,3170,Ecuador,E10,f,22,1,a
mother,376140,391330,15190,Ecuador,E10,f,22,2,a
mother,394340,402730,8390,Ecuador,E10,f,22,3,a
father,409640,410360,720,Ecuador,E10,m,22,4,a
mother,410880,412110,1230,Ecuador,E10,f,22,5,a
mother,415440,429610,14170,Ecuador,E10,f,23,1,a
mother,439950,442090,2140,Ecuador,E10,f,23,2,a
child,416550,417930,1380,Ecuador,E10,b,24,1,a
child,420120,421880,1760,Ecuador,E10,b,24,2,a
child,425380,426230,850,Ecuador,E10,m,24,3,a
child,435300,438430,3130,Ecuador,E10,b,24,4,a
child,443950,446950,3000,Ecuador,E10,b,24,5,a
mother,458110,458970,860,Ecuador,E10,c,24,6,q
child,459740,461040,1300,Ecuador,E10,m,24,7,a
mother,461240,461800,560,Ecuador,E10,c,24,8,q
child,464570,469360,4790,Ecuador,E10,m,24,9,a
child,472970,473930,960,Ecuador,E10,m,24,10,a
mother,474060,475940,1880,Ecuador,E10,c,24,11,q
child,478020,484040,6020,Ecuador,E10,m,24,12,a
father,488630,490220,1590,Ecuador,E10,c,24,13,a
mother,491510,493140,1630,Ecuador,E10,c,24,14,a
child,491880,494820,2940,Ecuador,E10,b,24,15,a
child,501160,501760,600,Ecuador,E10,f,25,1,a
father,508380,509970,1590,Ecuador,E10,c,25,2,a
mother,514380,515460,1080,Ecuador,E10,c,25,3,i
child,528410,529720,1310,Ecuador,E10,f,26,1,a
father,529970,532860,2890,Ecuador,E10,c,26,2,a
mother,537830,540810,2980,Ecuador,E10,o,27,1,a
father,542800,543290,490,Ecuador,E10,m,28,1,a
mother,544130,544790,660,Ecuador,E10,f,28,2,a
child,546490,551250,4760,Ecuador,E10,b,28,3,a
child,553770,555430,1660,Ecuador,E10,f,28,4,a
father,555220,557180,1960,Ecuador,E10,c,28,5,a
mother,573610,574380,770,Ecuador,E10,c,28,6,a
child,574710,575610,900,Ecuador,E10,c,28,7,a
mother,574960,579790,4830,Ecuador,E10,c,28,8,a
father,584360,584870,510,Ecuador,E10,c,28,9,i
father,580410,582430,2020,Ecuador,E10,m,29,1,i
child,584150,588730,4580,Ecuador,E10,m,29,2,i
child,589360,590130,770,Ecuador,E10,f,30,1,i
father,590110,591670,1560,Ecuador,E10,c,30,2,i
child,592520,594000,1480,Ecuador,E10,f,30,3,a
silence,5960,7670,1710,Ecuador,E10,NA,NA,NA,NA
silence,61710,62960,1250,Ecuador,E10,NA,NA,NA,NA
child_gesture,62430,64182,1752,Ecuador,E10,NA,NA,NA,NA
child_gesture,64320,65724,1404,Ecuador,E10,NA,NA,NA,NA
silence,67390,68360,970,Ecuador,E10,NA,NA,NA,NA
silence,70070,71560,1490,Ecuador,E10,NA,NA,NA,NA
silence,73290,82800,9510,Ecuador,E10,NA,NA,NA,NA
silence,85270,86000,730,Ecuador,E10,NA,NA,NA,NA
silence,96800,100510,3710,Ecuador,E10,NA,NA,NA,NA
silence,101230,102350,1120,Ecuador,E10,NA,NA,NA,NA
silence,104600,105430,830,Ecuador,E10,NA,NA,NA,NA
silence,108060,111450,3390,Ecuador,E10,NA,NA,NA,NA
silence,113710,114640,930,Ecuador,E10,NA,NA,NA,NA
silence,115120,115180,60,Ecuador,E10,NA,NA,NA,NA
silence,115630,116360,730,Ecuador,E10,NA,NA,NA,NA
silence,119420,122610,3190,Ecuador,E10,NA,NA,NA,NA
silence,124230,127600,3370,Ecuador,E10,NA,NA,NA,NA
silence,128150,131340,3190,Ecuador,E10,NA,NA,NA,NA
silence,133090,138370,5280,Ecuador,E10,NA,NA,NA,NA
silence,141420,143250,1830,Ecuador,E10,NA,NA,NA,NA
silence,144770,150800,6030,Ecuador,E10,NA,NA,NA,NA
silence,152130,153040,910,Ecuador,E10,NA,NA,NA,NA
silence,155690,155700,10,Ecuador,E10,NA,NA,NA,NA
silence,157820,159730,1910,Ecuador,E10,NA,NA,NA,NA
silence,160890,164040,3150,Ecuador,E10,NA,NA,NA,NA
silence,165220,167740,2520,Ecuador,E10,NA,NA,NA,NA
silence,169450,170210,760,Ecuador,E10,NA,NA,NA,NA
silence,172180,179040,6860,Ecuador,E10,NA,NA,NA,NA
silence,180620,187130,6510,Ecuador,E10,NA,NA,NA,NA
silence,188900,189180,280,Ecuador,E10,NA,NA,NA,NA
silence,189690,191160,1470,Ecuador,E10,NA,NA,NA,NA
silence,194390,215270,20880,Ecuador,E10,NA,NA,NA,NA
mother_gesture,217530,218730,1200,Ecuador,E10,NA,NA,NA,NA
silence,217690,217980,290,Ecuador,E10,NA,NA,NA,NA
silence,219560,219960,400,Ecuador,E10,NA,NA,NA,NA
silence,220500,220950,450,Ecuador,E10,NA,NA,NA,NA
silence,222300,232880,10580,Ecuador,E10,NA,NA,NA,NA
silence,234040,238450,4410,Ecuador,E10,NA,NA,NA,NA
silence,243070,247640,4570,Ecuador,E10,NA,NA,NA,NA
silence,250770,251270,500,Ecuador,E10,NA,NA,NA,NA
silence,252950,254100,1150,Ecuador,E10,NA,NA,NA,NA
silence,255610,255750,140,Ecuador,E10,NA,NA,NA,NA
silence,256550,257010,460,Ecuador,E10,NA,NA,NA,NA
silence,260410,266190,5780,Ecuador,E10,NA,NA,NA,NA
silence,267460,287810,20350,Ecuador,E10,NA,NA,NA,NA
silence,289970,293560,3590,Ecuador,E10,NA,NA,NA,NA
silence,294850,297070,2220,Ecuador,E10,NA,NA,NA,NA
silence,298910,301220,2310,Ecuador,E10,NA,NA,NA,NA
silence,302790,304160,1370,Ecuador,E10,NA,NA,NA,NA
silence,309070,310000,930,Ecuador,E10,NA,NA,NA,NA
silence,311290,311380,90,Ecuador,E10,NA,NA,NA,NA
silence,311560,311600,40,Ecuador,E10,NA,NA,NA,NA
silence,312760,312850,90,Ecuador,E10,NA,NA,NA,NA
silence,314000,314230,230,Ecuador,E10,NA,NA,NA,NA
silence,316000,316010,10,Ecuador,E10,NA,NA,NA,NA
silence,316760,319710,2950,Ecuador,E10,NA,NA,NA,NA
silence,323670,328200,4530,Ecuador,E10,NA,NA,NA,NA
silence,333050,339410,6360,Ecuador,E10,NA,NA,NA,NA
silence,340390,340580,190,Ecuador,E10,NA,NA,NA,NA
silence,343240,362880,19640,Ecuador,E10,NA,NA,NA,NA
silence,363690,366290,2600,Ecuador,E10,NA,NA,NA,NA
silence,368360,371480,3120,Ecuador,E10,NA,NA,NA,NA
silence,374650,376140,1490,Ecuador,E10,NA,NA,NA,NA
silence,391330,394340,3010,Ecuador,E10,NA,NA,NA,NA
silence,402730,402810,80,Ecuador,E10,NA,NA,NA,NA
silence,404420,409640,5220,Ecuador,E10,NA,NA,NA,NA
silence,410360,410880,520,Ecuador,E10,NA,NA,NA,NA
silence,412110,415440,3330,Ecuador,E10,NA,NA,NA,NA
silence,429610,435300,5690,Ecuador,E10,NA,NA,NA,NA
silence,438430,439950,1520,Ecuador,E10,NA,NA,NA,NA
silence,442090,443950,1860,Ecuador,E10,NA,NA,NA,NA
silence,446950,458110,11160,Ecuador,E10,NA,NA,NA,NA
silence,458970,459740,770,Ecuador,E10,NA,NA,NA,NA
silence,461040,461240,200,Ecuador,E10,NA,NA,NA,NA
silence,461800,464570,2770,Ecuador,E10,NA,NA,NA,NA
silence,469360,472970,3610,Ecuador,E10,NA,NA,NA,NA
silence,473930,474060,130,Ecuador,E10,NA,NA,NA,NA
silence,475940,478020,2080,Ecuador,E10,NA,NA,NA,NA
silence,484040,488630,4590,Ecuador,E10,NA,NA,NA,NA
silence,490220,491510,1290,Ecuador,E10,NA,NA,NA,NA
silence,494820,501160,6340,Ecuador,E10,NA,NA,NA,NA
silence,501760,508380,6620,Ecuador,E10,NA,NA,NA,NA
silence,509970,514380,4410,Ecuador,E10,NA,NA,NA,NA
silence,515460,528410,12950,Ecuador,E10,NA,NA,NA,NA
silence,529720,529970,250,Ecuador,E10,NA,NA,NA,NA
silence,532860,537830,4970,Ecuador,E10,NA,NA,NA,NA
mother_gesture,538690,539530,840,Ecuador,E10,NA,NA,NA,NA
silence,540810,542800,1990,Ecuador,E10,NA,NA,NA,NA
silence,543290,544130,840,Ecuador,E10,NA,NA,NA,NA
silence,544790,546490,1700,Ecuador,E10,NA,NA,NA,NA
silence,551250,553770,2520,Ecuador,E10,NA,NA,NA,NA
silence,557180,573610,16430,Ecuador,E10,NA,NA,NA,NA
silence,574380,574710,330,Ecuador,E10,NA,NA,NA,NA
mother_gesture,575790,577478,1688,Ecuador,E10,NA,NA,NA,NA
silence,579790,580410,620,Ecuador,E10,NA,NA,NA,NA
silence,582430,584150,1720,Ecuador,E10,NA,NA,NA,NA
silence,588730,589360,630,Ecuador,E10,NA,NA,NA,NA
silence,591670,592520,850,Ecuador,E10,NA,NA,NA,NA
father,2220,3310,1090,Ecuador,E11,m,1,1,i
father,12250,15250,3000,Ecuador,E11,m,1,2,i
mother,14310,15670,1360,Ecuador,E11,f,1,3,a
child,6920,8650,1730,Ecuador,E11,f,2,1,a
father,7070,9900,2830,Ecuador,E11,c,2,2,q
mother,34670,36200,1530,Ecuador,E11,c,3,1,i
child,35560,36880,1320,Ecuador,E11,m,3,2,i
mother,37410,39820,2410,Ecuador,E11,c,3,3,a
child,45640,46970,1330,Ecuador,E11,m,3,4,a
father,51050,53400,2350,Ecuador,E11,m,4,1,q
mother,53220,54150,930,Ecuador,E11,f,4,2,a
child,60810,62130,1320,Ecuador,E11,b,5,1,a
mother,84100,85000,900,Ecuador,E11,c,5,2,a
child,85840,87150,1310,Ecuador,E11,m,5,3,a
mother,96430,97340,910,Ecuador,E11,c,5,4,i
mother,99120,99900,780,Ecuador,E11,c,5,5,i
mother,103360,104220,860,Ecuador,E11,c,5,6,i
mother,109500,110710,1210,Ecuador,E11,c,5,7,i
child,122690,123560,870,Ecuador,E11,m,5,8,a
mother,123730,124920,1190,Ecuador,E11,c,5,9,i
mother,127680,128290,610,Ecuador,E11,c,5,10,a
father,164490,165280,790,Ecuador,E11,c,5,11,a
child,165550,166230,680,Ecuador,E11,f,5,12,a
father,166310,167400,1090,Ecuador,E11,c,5,13,a
mother,169510,172220,2710,Ecuador,E11,c,5,14,i
father,172880,173860,980,Ecuador,E11,c,5,15,i
child,177610,179470,1860,Ecuador,E11,f,5,16,i
father,179350,180430,1080,Ecuador,E11,c,5,17,a
child,180340,182670,2330,Ecuador,E11,m,5,18,a
father,184960,186610,1650,Ecuador,E11,m,6,1,q
mother,186270,187240,970,Ecuador,E11,f,6,2,a
father,187690,188430,740,Ecuador,E11,m,6,3,q
mother,188730,190220,1490,Ecuador,E11,f,6,4,a
father,190290,191060,770,Ecuador,E11,m,6,5,q
mother,192710,194550,1840,Ecuador,E11,f,6,6,a
father,195070,195910,840,Ecuador,E11,m,6,7,q
mother,195660,196270,610,Ecuador,E11,f,6,8,a
father,196770,198080,1310,Ecuador,E11,m,6,9,i
mother,198290,199550,1260,Ecuador,E11,f,6,10,a
child,198210,199770,1560,Ecuador,E11,f,7,1,a
child,218710,221800,3090,Ecuador,E11,f,7,2,a
child,228120,229370,1250,Ecuador,E11,f,7,3,a
mother,254080,256090,2010,Ecuador,E11,c,8,1,a
child,256040,256510,470,Ecuador,E11,m,8,2,a
mother,263640,264650,1010,Ecuador,E11,c,8,3,i
mother,268810,271050,2240,Ecuador,E11,c,8,4,i
child,270170,271420,1250,Ecuador,E11,m,8,5,i
mother,271530,272500,970,Ecuador,E11,c,8,6,q
child,272540,275040,2500,Ecuador,E11,m,8,7,a
mother,277210,278720,1510,Ecuador,E11,c,8,8,i
mother,290310,293570,3260,Ecuador,E11,c,9,1,i
child,294570,297180,2610,Ecuador,E11,m,9,2,a
father,299410,300810,1400,Ecuador,E11,c,9,3,q
child,325940,327230,1290,Ecuador,E11,m,10,1,a
child,329860,330420,560,Ecuador,E11,m,10,2,a
mother,330050,331620,1570,Ecuador,E11,c,10,3,i
child,331040,332500,1460,Ecuador,E11,f,10,4,a
father,332630,333470,840,Ecuador,E11,c,10,5,q
child,333430,334070,640,Ecuador,E11,f,10,6,a
father,339050,339990,940,Ecuador,E11,c,10,7,q
child,339850,342300,2450,Ecuador,E11,f,10,8,a
child,343780,348840,5060,Ecuador,E11,f,10,9,a
father,352360,353550,1190,Ecuador,E11,c,10,10,q
child,353430,354030,600,Ecuador,E11,f,10,11,a
father,355460,356290,830,Ecuador,E11,c,10,12,a
child,357020,358500,1480,Ecuador,E11,f,10,13,a
father,359880,360900,1020,Ecuador,E11,c,10,14,a
mother,342860,344230,1370,Ecuador,E11,c,11,1,i
father,378220,379110,890,Ecuador,E11,c,12,1,q
child,379230,379950,720,Ecuador,E11,f,12,2,a
father,380860,381710,850,Ecuador,E11,c,12,3,q
child,382360,385520,3160,Ecuador,E11,f,12,4,a
father,385830,386500,670,Ecuador,E11,c,12,5,a
father,388250,388980,730,Ecuador,E11,c,12,6,q
child,392030,393370,1340,Ecuador,E11,m,12,7,a
father,412640,413790,1150,Ecuador,E11,c,13,1,a
child,416630,418610,1980,Ecuador,E11,b,14,1,a
mother,422300,423500,1200,Ecuador,E11,c,15,1,q
child,426100,427810,1710,Ecuador,E11,m,15,2,a
father,434420,435140,720,Ecuador,E11,c,15,3,i
child,436740,437820,1080,Ecuador,E11,f,15,4,i
father,451720,455110,3390,Ecuador,E11,c,15,5,q
mother,488190,489410,1220,Ecuador,E11,c,16,1,q
child,491540,492590,1050,Ecuador,E11,m,16,2,a
child,518760,519700,940,Ecuador,E11,m,17,1,a
mother,519750,520700,950,Ecuador,E11,c,17,2,q
child,520410,521410,1000,Ecuador,E11,c,17,3,a
mother,522430,524920,2490,Ecuador,E11,c,17,4,q
child,526960,527700,740,Ecuador,E11,m,17,5,i
mother,528540,529240,700,Ecuador,E11,c,17,6,q
child,529080,530560,1480,Ecuador,E11,m,17,7,a
mother,532770,533810,1040,Ecuador,E11,c,17,8,q
child,533370,533990,620,Ecuador,E11,m,17,9,a
mother,534370,535940,1570,Ecuador,E11,c,17,10,a
child,538280,539390,1110,Ecuador,E11,m,17,11,a
child,545340,547930,2590,Ecuador,E11,m,17,12,a
mother,547830,550080,2250,Ecuador,E11,f,18,1,a
father,549550,550240,690,Ecuador,E11,m,18,2,a
child,551230,551980,750,Ecuador,E11,f,18,3,a
father,552300,553010,710,Ecuador,E11,m,18,4,a
child,558010,561030,3020,Ecuador,E11,m,18,5,i
father,561840,562900,1060,Ecuador,E11,c,19,1,a
child,563600,564550,950,Ecuador,E11,f,19,2,a
father,564660,565430,770,Ecuador,E11,c,19,3,a
child,565940,566790,850,Ecuador,E11,f,19,4,q
child,581200,583450,2250,Ecuador,E11,f,20,1,a
father,582140,583040,900,Ecuador,E11,c,20,2,q
child,587060,590090,3030,Ecuador,E11,f,20,3,a
father,587290,587870,580,Ecuador,E11,c,20,4,a
father,593830,595150,1320,Ecuador,E11,m,21,1,q
mother,598850,599590,740,Ecuador,E11,f,21,2,a
silence,3310,6920,3610,Ecuador,E11,NA,NA,NA,NA
silence,9900,12250,2350,Ecuador,E11,NA,NA,NA,NA
silence,15670,34670,19000,Ecuador,E11,NA,NA,NA,NA
silence,36880,37410,530,Ecuador,E11,NA,NA,NA,NA
silence,39820,45640,5820,Ecuador,E11,NA,NA,NA,NA
silence,46970,51050,4080,Ecuador,E11,NA,NA,NA,NA
silence,54150,60810,6660,Ecuador,E11,NA,NA,NA,NA
silence,62130,84100,21970,Ecuador,E11,NA,NA,NA,NA
silence,85000,85840,840,Ecuador,E11,NA,NA,NA,NA
silence,87150,96430,9280,Ecuador,E11,NA,NA,NA,NA
silence,97340,99120,1780,Ecuador,E11,NA,NA,NA,NA
silence,99900,103360,3460,Ecuador,E11,NA,NA,NA,NA
silence,104220,109500,5280,Ecuador,E11,NA,NA,NA,NA
silence,110710,122690,11980,Ecuador,E11,NA,NA,NA,NA
silence,123560,123730,170,Ecuador,E11,NA,NA,NA,NA
silence,124920,127680,2760,Ecuador,E11,NA,NA,NA,NA
silence,128290,164490,36200,Ecuador,E11,NA,NA,NA,NA
silence,165280,165550,270,Ecuador,E11,NA,NA,NA,NA
silence,166230,166310,80,Ecuador,E11,NA,NA,NA,NA
silence,167400,169510,2110,Ecuador,E11,NA,NA,NA,NA
mother_gesture,171689,173431,1742,Ecuador,E11,NA,NA,NA,NA
silence,172220,172880,660,Ecuador,E11,NA,NA,NA,NA
silence,173860,177610,3750,Ecuador,E11,NA,NA,NA,NA
father_gesture,179470,181320,1850,Ecuador,E11,NA,NA,NA,NA
silence,182670,184960,2290,Ecuador,E11,NA,NA,NA,NA
silence,187240,187690,450,Ecuador,E11,NA,NA,NA,NA
silence,188430,188730,300,Ecuador,E11,NA,NA,NA,NA
silence,190220,190290,70,Ecuador,E11,NA,NA,NA,NA
silence,191060,192710,1650,Ecuador,E11,NA,NA,NA,NA
silence,194550,195070,520,Ecuador,E11,NA,NA,NA,NA
silence,196270,196770,500,Ecuador,E11,NA,NA,NA,NA
silence,198080,198210,130,Ecuador,E11,NA,NA,NA,NA
silence,199770,218710,18940,Ecuador,E11,NA,NA,NA,NA
father,221790,222810,1020,Ecuador,E11,c,NA,NA,a
silence,222810,228120,5310,Ecuador,E11,NA,NA,NA,NA
silence,229370,254080,24710,Ecuador,E11,NA,NA,NA,NA
silence,256510,263640,7130,Ecuador,E11,NA,NA,NA,NA
silence,264650,268810,4160,Ecuador,E11,NA,NA,NA,NA
silence,271420,271530,110,Ecuador,E11,NA,NA,NA,NA
silence,272500,272540,40,Ecuador,E11,NA,NA,NA,NA
silence,275040,277210,2170,Ecuador,E11,NA,NA,NA,NA
silence,278720,290310,11590,Ecuador,E11,NA,NA,NA,NA
mother_gesture,290040,292875,2835,Ecuador,E11,NA,NA,NA,NA
silence,293570,294570,1000,Ecuador,E11,NA,NA,NA,NA
silence,297180,299410,2230,Ecuador,E11,NA,NA,NA,NA
silence,300810,325940,25130,Ecuador,E11,NA,NA,NA,NA
silence,327230,329860,2630,Ecuador,E11,NA,NA,NA,NA
silence,332500,332630,130,Ecuador,E11,NA,NA,NA,NA
silence,334070,339050,4980,Ecuador,E11,NA,NA,NA,NA
silence,342300,342860,560,Ecuador,E11,NA,NA,NA,NA
silence,348840,352360,3520,Ecuador,E11,NA,NA,NA,NA
silence,354030,355460,1430,Ecuador,E11,NA,NA,NA,NA
silence,356290,357020,730,Ecuador,E11,NA,NA,NA,NA
silence,358500,359880,1380,Ecuador,E11,NA,NA,NA,NA
silence,360900,378220,17320,Ecuador,E11,NA,NA,NA,NA
silence,379110,379230,120,Ecuador,E11,NA,NA,NA,NA
silence,379950,380860,910,Ecuador,E11,NA,NA,NA,NA
silence,381710,382360,650,Ecuador,E11,NA,NA,NA,NA
silence,385520,385830,310,Ecuador,E11,NA,NA,NA,NA
silence,386500,388250,1750,Ecuador,E11,NA,NA,NA,NA
silence,388980,392030,3050,Ecuador,E11,NA,NA,NA,NA
silence,393370,412640,19270,Ecuador,E11,NA,NA,NA,NA
silence,413790,416630,2840,Ecuador,E11,NA,NA,NA,NA
silence,418610,422300,3690,Ecuador,E11,NA,NA,NA,NA
silence,423500,426100,2600,Ecuador,E11,NA,NA,NA,NA
silence,427810,434420,6610,Ecuador,E11,NA,NA,NA,NA
silence,435140,436740,1600,Ecuador,E11,NA,NA,NA,NA
silence,437820,451720,13900,Ecuador,E11,NA,NA,NA,NA
silence,455110,488190,33080,Ecuador,E11,NA,NA,NA,NA
silence,489410,491540,2130,Ecuador,E11,NA,NA,NA,NA
silence,492590,518760,26170,Ecuador,E11,NA,NA,NA,NA
silence,519700,519750,50,Ecuador,E11,NA,NA,NA,NA
silence,521410,522430,1020,Ecuador,E11,NA,NA,NA,NA
silence,524920,526960,2040,Ecuador,E11,NA,NA,NA,NA
silence,527700,528540,840,Ecuador,E11,NA,NA,NA,NA
silence,530560,532770,2210,Ecuador,E11,NA,NA,NA,NA
silence,533990,534370,380,Ecuador,E11,NA,NA,NA,NA
silence,535940,538280,2340,Ecuador,E11,NA,NA,NA,NA
silence,539390,545340,5950,Ecuador,E11,NA,NA,NA,NA
silence,550240,551230,990,Ecuador,E11,NA,NA,NA,NA
silence,551980,552300,320,Ecuador,E11,NA,NA,NA,NA
silence,553010,558010,5000,Ecuador,E11,NA,NA,NA,NA
silence,561030,561840,810,Ecuador,E11,NA,NA,NA,NA
silence,562900,563600,700,Ecuador,E11,NA,NA,NA,NA
silence,564550,564660,110,Ecuador,E11,NA,NA,NA,NA
silence,565430,565940,510,Ecuador,E11,NA,NA,NA,NA
silence,566790,581200,14410,Ecuador,E11,NA,NA,NA,NA
silence,583450,587060,3610,Ecuador,E11,NA,NA,NA,NA
silence,590090,593830,3740,Ecuador,E11,NA,NA,NA,NA
silence,595150,598850,3700,Ecuador,E11,NA,NA,NA,NA
child,1220,1670,450,Ecuador,E12,m,1,1,a
father,1280,3290,2010,Ecuador,E12,c,2,1,i
mother,3680,5330,1650,Ecuador,E12,c,2,2,i
father,5090,6540,1450,Ecuador,E12,c,2,3,i
father,11230,12060,830,Ecuador,E12,c,2,4,i
father,19700,20480,780,Ecuador,E12,c,2,5,i
mother,7420,8410,990,Ecuador,E12,c,3,1,a
mother,10570,19460,8890,Ecuador,E12,c,3,2,a
father,26710,28060,1350,Ecuador,E12,c,4,1,q
child,27990,28520,530,Ecuador,E12,f,4,2,a
child,30400,31040,640,Ecuador,E12,f,4,3,a
father,29260,30270,1010,Ecuador,E12,m,5,1,i
father,33480,34840,1360,Ecuador,E12,c,6,1,q
child,35020,35750,730,Ecuador,E12,f,6,2,a
father,38840,40910,2070,Ecuador,E12,c,6,3,i
child,41520,44580,3060,Ecuador,E12,f,6,4,a
father,45280,46200,920,Ecuador,E12,c,6,5,q
child,46430,50630,4200,Ecuador,E12,f,6,6,a
father,50860,51320,460,Ecuador,E12,c,6,7,a
mother,56810,58160,1350,Ecuador,E12,b,7,1,a
child,59020,59630,610,Ecuador,E12,m,7,2,q
father,59040,60200,1160,Ecuador,E12,m,7,3,i
father,63880,65260,1380,Ecuador,E12,m,7,4,a
father,67280,70030,2750,Ecuador,E12,m,7,5,i
mother,73110,77610,4500,Ecuador,E12,c,7,6,a
child,77630,78260,630,Ecuador,E12,m,7,7,a
mother,79280,88910,9630,Ecuador,E12,b,7,8,q
father,93150,97430,4280,Ecuador,E12,c,7,9,q
father,100870,103530,2660,Ecuador,E12,b,7,10,q
mother,106160,108610,2450,Ecuador,E12,c,7,11,i
father,107610,108720,1110,Ecuador,E12,c,7,12,a
child,108730,109370,640,Ecuador,E12,f,7,13,a
father,111880,113510,1630,Ecuador,E12,c,7,14,a
father,118730,120340,1610,Ecuador,E12,m,7,15,a
child,122110,123460,1350,Ecuador,E12,m,7,16,i
father,123090,124980,1890,Ecuador,E12,m,7,17,i
father,130290,131680,1390,Ecuador,E12,c,7,18,a
father,133020,138030,5010,Ecuador,E12,m,7,19,a
child,139630,140560,930,Ecuador,E12,b,7,20,a
mother,140630,145110,4480,Ecuador,E12,f,7,21,a
father,149490,150380,890,Ecuador,E12,c,7,22,q
father,154860,155620,760,Ecuador,E12,c,7,23,a
father,163120,171250,8130,Ecuador,E12,m,7,24,a
mother,147270,149240,1970,Ecuador,E12,f,8,1,a
mother,153960,158450,4490,Ecuador,E12,c,9,1,i
child,169870,170390,520,Ecuador,E12,m,9,2,q
mother,171870,172730,860,Ecuador,E12,c,9,3,i
mother,175530,180770,5240,Ecuador,E12,c,9,4,i
father,184650,188770,4120,Ecuador,E12,c,9,5,a
child,190980,191720,740,Ecuador,E12,f,9,6,a
father,191440,192350,910,Ecuador,E12,c,9,7,q
child,192420,192980,560,Ecuador,E12,f,9,8,a
father,193650,195610,1960,Ecuador,E12,c,9,9,q
child,195870,196440,570,Ecuador,E12,f,9,10,a
father,196780,198600,1820,Ecuador,E12,c,9,11,a
child,199940,205290,5350,Ecuador,E12,f,9,12,a
child,216240,217030,790,Ecuador,E12,m,9,13,a
mother,217390,217880,490,Ecuador,E12,c,9,14,q
child,218250,218980,730,Ecuador,E12,m,9,15,a
mother,218520,222350,3830,Ecuador,E12,c,9,16,a
child,222960,227260,4300,Ecuador,E12,m,9,17,a
mother,223920,224520,600,Ecuador,E12,c,9,18,a
father,224060,225540,1480,Ecuador,E12,b,9,19,a
mother,225970,226600,630,Ecuador,E12,f,9,20,q
father,226210,227150,940,Ecuador,E12,m,9,21,a
mother,228250,229050,800,Ecuador,E12,f,9,22,a
father,228650,230010,1360,Ecuador,E12,m,9,23,a
child,228380,229960,1580,Ecuador,E12,m,10,1,a
child,230850,231800,950,Ecuador,E12,m,10,2,q
mother,231770,233750,1980,Ecuador,E12,c,10,3,a
child,234250,235640,1390,Ecuador,E12,m,10,4,a
father,238130,238910,780,Ecuador,E12,c,10,5,q
father,240440,241120,680,Ecuador,E12,c,10,6,q
child,241620,243510,1890,Ecuador,E12,f,10,7,a
mother,243390,253010,9620,Ecuador,E12,c,10,8,a
child,252240,253420,1180,Ecuador,E12,m,10,9,a
mother,253710,254640,930,Ecuador,E12,c,10,10,a
child,256270,258740,2470,Ecuador,E12,m,10,11,i
father,257310,258550,1240,Ecuador,E12,m,10,12,a
mother,258520,259390,870,Ecuador,E12,c,10,13,a
child,259350,261990,2640,Ecuador,E12,m,10,14,a
father,263000,265360,2360,Ecuador,E12,c,10,15,a
mother,267510,269090,1580,Ecuador,E12,c,10,16,i
father,269070,271650,2580,Ecuador,E12,c,10,17,a
child,272010,273720,1710,Ecuador,E12,m,10,18,a
mother,273250,273880,630,Ecuador,E12,c,10,19,a
father,275790,279260,3470,Ecuador,E12,m,11,1,q
mother,279180,279980,800,Ecuador,E12,f,11,2,q
father,279920,280860,940,Ecuador,E12,m,11,3,q
mother,282100,284280,2180,Ecuador,E12,f,11,4,a
father,284400,284960,560,Ecuador,E12,m,11,5,q
mother,290560,291340,780,Ecuador,E12,f,11,6,q
father,296590,300770,4180,Ecuador,E12,m,11,7,a
mother,302940,304000,1060,Ecuador,E12,f,11,8,a
father,305380,306180,800,Ecuador,E12,m,11,9,a
mother,306350,310110,3760,Ecuador,E12,f,11,10,a
father,311940,314750,2810,Ecuador,E12,m,11,11,a
mother,284990,286310,1320,Ecuador,E12,f,12,1,a
child,320720,322780,2060,Ecuador,E12,b,13,1,a
mother,323760,324340,580,Ecuador,E12,c,13,2,a
child,324360,329300,4940,Ecuador,E12,m,13,3,a
father,353920,355670,1750,Ecuador,E12,m,14,1,q
mother,356240,356850,610,Ecuador,E12,f,14,2,a
father,356710,357740,1030,Ecuador,E12,m,14,3,q
mother,358690,359260,570,Ecuador,E12,f,14,4,a
father,359410,360100,690,Ecuador,E12,m,14,5,q
mother,360470,361070,600,Ecuador,E12,f,14,6,a
father,361110,362100,990,Ecuador,E12,m,14,7,q
mother,362390,365900,3510,Ecuador,E12,f,14,8,a
father,366820,368000,1180,Ecuador,E12,m,14,9,q
mother,367940,369530,1590,Ecuador,E12,f,14,10,a
father,369800,370920,1120,Ecuador,E12,m,14,11,q
mother,370560,375130,4570,Ecuador,E12,f,14,12,a
child,375150,375800,650,Ecuador,E12,m,15,1,a
father,381100,386590,5490,Ecuador,E12,m,16,1,a
father,389230,390920,1690,Ecuador,E12,m,16,2,a
father,393280,394440,1160,Ecuador,E12,m,16,3,a
mother,396210,400080,3870,Ecuador,E12,c,17,1,q
child,400020,402920,2900,Ecuador,E12,m,17,2,q
mother,404050,405490,1440,Ecuador,E12,c,17,3,q
child,405970,407730,1760,Ecuador,E12,m,17,4,q
mother,410750,412100,1350,Ecuador,E12,c,17,5,q
child,412500,414300,1800,Ecuador,E12,m,17,6,a
mother,415530,416810,1280,Ecuador,E12,c,17,7,q
child,417060,418830,1770,Ecuador,E12,m,17,8,a
mother,421790,423340,1550,Ecuador,E12,f,17,9,a
child,423910,425540,1630,Ecuador,E12,m,17,10,a
mother,428460,429090,630,Ecuador,E12,c,17,11,i
father,433680,435920,2240,Ecuador,E12,c,18,1,i
mother,436160,437130,970,Ecuador,E12,c,18,2,i
father,438680,439350,670,Ecuador,E12,c,18,3,a
mother,438960,439620,660,Ecuador,E12,c,18,4,a
father,439800,440500,700,Ecuador,E12,c,18,5,a
father,447040,448500,1460,Ecuador,E12,c,18,6,q
mother,448830,452000,3170,Ecuador,E12,c,19,1,q
mother,454050,455130,1080,Ecuador,E12,c,19,2,q
father,456150,456780,630,Ecuador,E12,c,19,3,a
mother,462700,463260,560,Ecuador,E12,c,19,4,i
mother,471670,472220,550,Ecuador,E12,c,19,5,i
father,472940,474350,1410,Ecuador,E12,m,19,6,i
mother,492170,493420,1250,Ecuador,E12,c,20,1,i
mother,496960,497970,1010,Ecuador,E12,f,21,1,a
father,533240,534060,820,Ecuador,E12,c,22,1,a
father,536330,537530,1200,Ecuador,E12,c,22,2,q
child,537920,538750,830,Ecuador,E12,f,22,3,a
father,541850,545230,3380,Ecuador,E12,c,22,4,a
child,545810,548560,2750,Ecuador,E12,f,22,5,a
father,548640,551500,2860,Ecuador,E12,c,22,6,a
child,551090,553940,2850,Ecuador,E12,f,22,7,a
father,554180,555110,930,Ecuador,E12,c,22,8,a
child,555320,556220,900,Ecuador,E12,f,22,9,a
father,556250,557280,1030,Ecuador,E12,c,22,10,a
child,556840,557530,690,Ecuador,E12,f,22,11,a
father,557820,560820,3000,Ecuador,E12,c,22,12,a
child,558550,561008,2458,Ecuador,E12,f,22,13,a
father,561110,561690,580,Ecuador,E12,c,22,14,a
mother,562760,565310,2550,Ecuador,E12,o,23,1,i
father,566540,567430,890,Ecuador,E12,o,23,2,a
mother,567450,568100,650,Ecuador,E12,o,23,3,i
father,572470,573040,570,Ecuador,E12,c,24,1,i
father,575350,577750,2400,Ecuador,E12,c,24,2,i
father,581090,582670,1580,Ecuador,E12,c,24,3,i
father,592150,593020,870,Ecuador,E12,c,24,4,i
child,593050,593500,450,Ecuador,E12,f,24,5,a
father,593550,595760,2210,Ecuador,E12,c,24,6,i
child,596400,597040,640,Ecuador,E12,f,24,7,a
silence,740,1220,480,Ecuador,E12,NA,NA,NA,NA
father_gesture,1785,4409,2624,Ecuador,E12,NA,NA,NA,NA
silence,3290,3680,390,Ecuador,E12,NA,NA,NA,NA
mother_gesture,3367,5398,2031,Ecuador,E12,NA,NA,NA,NA
mother_gesture,5740,7039,1299,Ecuador,E12,NA,NA,NA,NA
silence,6540,7420,880,Ecuador,E12,NA,NA,NA,NA
silence,8410,10570,2160,Ecuador,E12,NA,NA,NA,NA
mother_gesture,10988,12863,1875,Ecuador,E12,NA,NA,NA,NA
mother_gesture,14970,16087,1117,Ecuador,E12,NA,NA,NA,NA
mother_gesture,16750,18684,1934,Ecuador,E12,NA,NA,NA,NA
silence,19460,19700,240,Ecuador,E12,NA,NA,NA,NA
silence,20480,26710,6230,Ecuador,E12,NA,NA,NA,NA
silence,28520,29260,740,Ecuador,E12,NA,NA,NA,NA
silence,30270,30400,130,Ecuador,E12,NA,NA,NA,NA
silence,31040,33480,2440,Ecuador,E12,NA,NA,NA,NA
silence,34840,35020,180,Ecuador,E12,NA,NA,NA,NA
silence,35750,38840,3090,Ecuador,E12,NA,NA,NA,NA
silence,40910,41520,610,Ecuador,E12,NA,NA,NA,NA
silence,44580,45280,700,Ecuador,E12,NA,NA,NA,NA
silence,46200,46430,230,Ecuador,E12,NA,NA,NA,NA
silence,50630,50860,230,Ecuador,E12,NA,NA,NA,NA
silence,51320,56810,5490,Ecuador,E12,NA,NA,NA,NA
silence,58160,59020,860,Ecuador,E12,NA,NA,NA,NA
father_gesture,59870,61694,1824,Ecuador,E12,NA,NA,NA,NA
silence,60200,63880,3680,Ecuador,E12,NA,NA,NA,NA
father_gesture,65136,67927,2791,Ecuador,E12,NA,NA,NA,NA
silence,65260,67280,2020,Ecuador,E12,NA,NA,NA,NA
silence,70030,73110,3080,Ecuador,E12,NA,NA,NA,NA
silence,77610,77630,20,Ecuador,E12,NA,NA,NA,NA
silence,78260,79280,1020,Ecuador,E12,NA,NA,NA,NA
silence,88910,93150,4240,Ecuador,E12,NA,NA,NA,NA
silence,97430,100870,3440,Ecuador,E12,NA,NA,NA,NA
silence,103530,106160,2630,Ecuador,E12,NA,NA,NA,NA
silence,108720,108730,10,Ecuador,E12,NA,NA,NA,NA
silence,109370,111880,2510,Ecuador,E12,NA,NA,NA,NA
silence,113510,118730,5220,Ecuador,E12,NA,NA,NA,NA
silence,120340,122110,1770,Ecuador,E12,NA,NA,NA,NA
silence,124980,130290,5310,Ecuador,E12,NA,NA,NA,NA
silence,131680,133020,1340,Ecuador,E12,NA,NA,NA,NA
silence,138030,139630,1600,Ecuador,E12,NA,NA,NA,NA
silence,140560,140630,70,Ecuador,E12,NA,NA,NA,NA
silence,145110,147270,2160,Ecuador,E12,NA,NA,NA,NA
silence,149240,149490,250,Ecuador,E12,NA,NA,NA,NA
silence,150380,153960,3580,Ecuador,E12,NA,NA,NA,NA
silence,158450,163120,4670,Ecuador,E12,NA,NA,NA,NA
silence,171250,171870,620,Ecuador,E12,NA,NA,NA,NA
silence,172730,175530,2800,Ecuador,E12,NA,NA,NA,NA
silence,180770,184650,3880,Ecuador,E12,NA,NA,NA,NA
silence,188770,190980,2210,Ecuador,E12,NA,NA,NA,NA
silence,192350,192420,70,Ecuador,E12,NA,NA,NA,NA
silence,192980,193650,670,Ecuador,E12,NA,NA,NA,NA
silence,195610,195870,260,Ecuador,E12,NA,NA,NA,NA
silence,196440,196780,340,Ecuador,E12,NA,NA,NA,NA
silence,198600,199940,1340,Ecuador,E12,NA,NA,NA,NA
silence,205290,216240,10950,Ecuador,E12,NA,NA,NA,NA
silence,217030,217390,360,Ecuador,E12,NA,NA,NA,NA
silence,217880,218250,370,Ecuador,E12,NA,NA,NA,NA
mother_gesture,218110,220700,2590,Ecuador,E12,NA,NA,NA,NA
silence,222350,222960,610,Ecuador,E12,NA,NA,NA,NA
silence,227260,228250,990,Ecuador,E12,NA,NA,NA,NA
silence,230010,230850,840,Ecuador,E12,NA,NA,NA,NA
mother_gesture,232632,234181,1549,Ecuador,E12,NA,NA,NA,NA
silence,233750,234250,500,Ecuador,E12,NA,NA,NA,NA
silence,235640,238130,2490,Ecuador,E12,NA,NA,NA,NA
silence,238910,240440,1530,Ecuador,E12,NA,NA,NA,NA
silence,241120,241620,500,Ecuador,E12,NA,NA,NA,NA
silence,253420,253710,290,Ecuador,E12,NA,NA,NA,NA
silence,254640,256270,1630,Ecuador,E12,NA,NA,NA,NA
silence,261990,263000,1010,Ecuador,E12,NA,NA,NA,NA
father_gesture,263611,265508,1897,Ecuador,E12,NA,NA,NA,NA
silence,265360,267510,2150,Ecuador,E12,NA,NA,NA,NA
father_gesture,269060,271552,2492,Ecuador,E12,NA,NA,NA,NA
silence,271650,272010,360,Ecuador,E12,NA,NA,NA,NA
silence,273880,275790,1910,Ecuador,E12,NA,NA,NA,NA
silence,280860,282100,1240,Ecuador,E12,NA,NA,NA,NA
silence,284280,284400,120,Ecuador,E12,NA,NA,NA,NA
silence,284960,284990,30,Ecuador,E12,NA,NA,NA,NA
silence,286310,290560,4250,Ecuador,E12,NA,NA,NA,NA
silence,291340,296590,5250,Ecuador,E12,NA,NA,NA,NA
silence,300770,302940,2170,Ecuador,E12,NA,NA,NA,NA
mother_gesture,302886,304293,1407,Ecuador,E12,NA,NA,NA,NA
silence,304000,305380,1380,Ecuador,E12,NA,NA,NA,NA
silence,306180,306350,170,Ecuador,E12,NA,NA,NA,NA
mother_gesture,307920,310116,2196,Ecuador,E12,NA,NA,NA,NA
silence,310110,311940,1830,Ecuador,E12,NA,NA,NA,NA
silence,314750,320720,5970,Ecuador,E12,NA,NA,NA,NA
silence,322780,323760,980,Ecuador,E12,NA,NA,NA,NA
silence,324340,324360,20,Ecuador,E12,NA,NA,NA,NA
silence,329300,353920,24620,Ecuador,E12,NA,NA,NA,NA
silence,355670,356240,570,Ecuador,E12,NA,NA,NA,NA
father_gesture,356430,358481,2051,Ecuador,E12,NA,NA,NA,NA
silence,357740,358690,950,Ecuador,E12,NA,NA,NA,NA
mother_gesture,357860,359599,1739,Ecuador,E12,NA,NA,NA,NA
silence,359260,359410,150,Ecuador,E12,NA,NA,NA,NA
silence,360100,360470,370,Ecuador,E12,NA,NA,NA,NA
silence,361070,361110,40,Ecuador,E12,NA,NA,NA,NA
silence,362100,362390,290,Ecuador,E12,NA,NA,NA,NA
silence,365900,366820,920,Ecuador,E12,NA,NA,NA,NA
silence,369530,369800,270,Ecuador,E12,NA,NA,NA,NA
silence,375130,375150,20,Ecuador,E12,NA,NA,NA,NA
silence,375800,381100,5300,Ecuador,E12,NA,NA,NA,NA
silence,386590,389230,2640,Ecuador,E12,NA,NA,NA,NA
silence,390920,393280,2360,Ecuador,E12,NA,NA,NA,NA
silence,394440,396210,1770,Ecuador,E12,NA,NA,NA,NA
silence,402920,404050,1130,Ecuador,E12,NA,NA,NA,NA
silence,405490,405970,480,Ecuador,E12,NA,NA,NA,NA
silence,407730,410750,3020,Ecuador,E12,NA,NA,NA,NA
silence,412100,412500,400,Ecuador,E12,NA,NA,NA,NA
silence,414300,415530,1230,Ecuador,E12,NA,NA,NA,NA
silence,416810,417060,250,Ecuador,E12,NA,NA,NA,NA
silence,418830,421790,2960,Ecuador,E12,NA,NA,NA,NA
silence,423340,423910,570,Ecuador,E12,NA,NA,NA,NA
silence,425540,428460,2920,Ecuador,E12,NA,NA,NA,NA
silence,429090,433680,4590,Ecuador,E12,NA,NA,NA,NA
father_gesture,434042,436803,2761,Ecuador,E12,NA,NA,NA,NA
silence,435920,436160,240,Ecuador,E12,NA,NA,NA,NA
silence,437130,438680,1550,Ecuador,E12,NA,NA,NA,NA
silence,439620,439800,180,Ecuador,E12,NA,NA,NA,NA
silence,440500,447040,6540,Ecuador,E12,NA,NA,NA,NA
silence,448500,448830,330,Ecuador,E12,NA,NA,NA,NA
silence,452000,454050,2050,Ecuador,E12,NA,NA,NA,NA
silence,455130,456150,1020,Ecuador,E12,NA,NA,NA,NA
silence,456780,462700,5920,Ecuador,E12,NA,NA,NA,NA
silence,463260,471670,8410,Ecuador,E12,NA,NA,NA,NA
silence,472220,472940,720,Ecuador,E12,NA,NA,NA,NA
silence,474350,492170,17820,Ecuador,E12,NA,NA,NA,NA
silence,493420,496960,3540,Ecuador,E12,NA,NA,NA,NA
silence,497970,533240,35270,Ecuador,E12,NA,NA,NA,NA
father_gesture,532891,534154,1263,Ecuador,E12,NA,NA,NA,NA
silence,534060,536330,2270,Ecuador,E12,NA,NA,NA,NA
father_gesture,536130,538302,2172,Ecuador,E12,NA,NA,NA,NA
silence,537530,537920,390,Ecuador,E12,NA,NA,NA,NA
silence,538750,541850,3100,Ecuador,E12,NA,NA,NA,NA
father_gesture,544420,545881,1461,Ecuador,E12,NA,NA,NA,NA
silence,545230,545810,580,Ecuador,E12,NA,NA,NA,NA
silence,548560,548640,80,Ecuador,E12,NA,NA,NA,NA
silence,553940,554180,240,Ecuador,E12,NA,NA,NA,NA
silence,555110,555320,210,Ecuador,E12,NA,NA,NA,NA
silence,556220,556250,30,Ecuador,E12,NA,NA,NA,NA
silence,557530,557820,290,Ecuador,E12,NA,NA,NA,NA
silence,561008,561110,102,Ecuador,E12,NA,NA,NA,NA
silence,561690,562760,1070,Ecuador,E12,NA,NA,NA,NA
mother_gesture,564397,567444,3047,Ecuador,E12,NA,NA,NA,NA
silence,565310,566540,1230,Ecuador,E12,NA,NA,NA,NA
father_gesture,566490,568156,1666,Ecuador,E12,NA,NA,NA,NA
silence,567430,567450,20,Ecuador,E12,NA,NA,NA,NA
silence,568100,572470,4370,Ecuador,E12,NA,NA,NA,NA
silence,573040,575350,2310,Ecuador,E12,NA,NA,NA,NA
silence,577750,581090,3340,Ecuador,E12,NA,NA,NA,NA
silence,582670,592150,9480,Ecuador,E12,NA,NA,NA,NA
silence,593020,593050,30,Ecuador,E12,NA,NA,NA,NA
silence,593500,593550,50,Ecuador,E12,NA,NA,NA,NA
silence,595760,596400,640,Ecuador,E12,NA,NA,NA,NA
mother,3520,4480,960,Ecuador,E13,f,1,1,a
father,5230,6030,800,Ecuador,E13,m,2,1,a
child,7030,10460,3430,Ecuador,E13,b,3,1,a
mother,10680,11900,1220,Ecuador,E13,c,3,2,i
child,12400,13520,1120,Ecuador,E13,m,3,3,a
father,13980,14810,830,Ecuador,E13,c,3,4,i
child,33800,34510,710,Ecuador,E13,b,4,1,a
father,35410,37160,1750,Ecuador,E13,c,4,2,q
mother,36330,37160,830,Ecuador,E13,c,4,3,i
father,44010,46510,2500,Ecuador,E13,m,5,1,q
father,49790,51100,1310,Ecuador,E13,m,5,2,q
mother,58850,62320,3470,Ecuador,E13,f,5,3,a
father,63220,63850,630,Ecuador,E13,m,5,4,a
child,65720,66720,1000,Ecuador,E13,b,6,1,q
father,66880,67700,820,Ecuador,E13,c,6,2,a
mother,67960,69310,1350,Ecuador,E13,c,6,3,a
father,69770,70750,980,Ecuador,E13,c,6,4,a
father,81960,86800,4840,Ecuador,E13,m,7,1,a
child,85560,88150,2590,Ecuador,E13,b,8,1,a
mother,88430,89340,910,Ecuador,E13,c,8,2,i
mother,91410,92570,1160,Ecuador,E13,c,8,3,a
father,98080,100390,2310,Ecuador,E13,m,9,1,a
mother,100420,101040,620,Ecuador,E13,f,9,2,a
father,101320,149020,47700,Ecuador,E13,m,9,3,a
father,155040,157130,2090,Ecuador,E13,m,9,4,a
mother,162240,163930,1690,Ecuador,E13,f,9,5,a
father,163870,168012,4142,Ecuador,E13,m,9,6,a
father,174600,178975,4375,Ecuador,E13,m,9,7,a
mother,184160,187370,3210,Ecuador,E13,c,10,1,q
father,198200,203190,4990,Ecuador,E13,c,11,1,a
child,208940,210200,1260,Ecuador,E13,b,11,2,a
mother,210370,211030,660,Ecuador,E13,c,11,3,a
child,210840,212740,1900,Ecuador,E13,m,11,4,a
mother,212790,213750,960,Ecuador,E13,c,11,5,q
child,213750,214230,480,Ecuador,E13,m,11,6,a
mother,214370,215210,840,Ecuador,E13,o,12,1,q
father,215880,219550,3670,Ecuador,E13,o,12,2,a
child,231900,237470,5570,Ecuador,E13,b,13,1,a
child,242970,244580,1610,Ecuador,E13,b,13,2,a
child,250750,252630,1880,Ecuador,E13,m,13,3,a
child,259830,261490,1660,Ecuador,E13,b,13,4,q
father,261620,262340,720,Ecuador,E13,c,13,5,a
father,236780,239810,3030,Ecuador,E13,m,14,1,a
mother,240020,243510,3490,Ecuador,E13,f,14,2,a
mother,293880,296210,2330,Ecuador,E13,f,15,1,a
father,304570,307510,2940,Ecuador,E13,m,16,1,a
father,310300,313240,2940,Ecuador,E13,m,16,2,a
father,314070,329950,15880,Ecuador,E13,m,16,3,a
child,313250,314000,750,Ecuador,E13,b,17,1,a
child,327740,328190,450,Ecuador,E13,b,18,1,q
father,332490,335340,2850,Ecuador,E13,NA,19,1,q
father,341320,346930,5610,Ecuador,E13,m,19,2,a
mother,349270,351080,1810,Ecuador,E13,f,19,3,a
child,350080,352430,2350,Ecuador,E13,b,20,1,a
mother,353270,353870,600,Ecuador,E13,c,20,2,q
child,354050,354530,480,Ecuador,E13,m,20,3,a
mother,355140,356300,1160,Ecuador,E13,c,20,4,q
child,358860,360240,1380,Ecuador,E13,f,20,5,a
father,362390,365410,3020,Ecuador,E13,c,20,6,a
father,367840,368700,860,Ecuador,E13,c,20,7,q
child,370520,372570,2050,Ecuador,E13,f,20,8,a
father,382260,386140,3880,Ecuador,E13,m,21,1,a
mother,385970,392880,6910,Ecuador,E13,f,21,2,a
mother,401560,402760,1200,Ecuador,E13,c,22,1,q
father,404310,405370,1060,Ecuador,E13,m,23,1,a
mother,431470,432490,1020,Ecuador,E13,f,23,2,a
father,433084,439260,6176,Ecuador,E13,m,23,3,a
father,450530,454500,3970,Ecuador,E13,c,24,1,a
mother,460690,463700,3010,Ecuador,E13,f,25,1,q
mother,465490,467590,2100,Ecuador,E13,c,26,1,q
father,468270,469050,780,Ecuador,E13,m,27,1,a
father,473570,485160,11590,Ecuador,E13,m,27,2,a
mother,485420,486330,910,Ecuador,E13,f,27,3,q
father,486710,487370,660,Ecuador,E13,m,27,4,q
mother,488850,490570,1720,Ecuador,E13,f,27,5,a
father,490980,491700,720,Ecuador,E13,m,27,6,a
mother,493470,496550,3080,Ecuador,E13,f,28,1,a
father,496000,496960,960,Ecuador,E13,m,28,2,q
mother,498480,500610,2130,Ecuador,E13,f,28,3,a
child,500060,504140,4080,Ecuador,E13,m,29,1,a
mother,502150,503140,990,Ecuador,E13,c,29,2,a
father,502700,503370,670,Ecuador,E13,c,29,3,a
mother,507200,507870,670,Ecuador,E13,c,29,4,i
child,507850,509680,1830,Ecuador,E13,b,29,5,a
child,510800,511440,640,Ecuador,E13,b,29,6,a
father,509730,511130,1400,Ecuador,E13,m,30,1,i
father,512690,524730,12040,Ecuador,E13,m,30,2,a
mother,525010,526030,1020,Ecuador,E13,f,30,3,q
father,525700,527660,1960,Ecuador,E13,m,30,4,a
mother,527710,528609,899,Ecuador,E13,f,30,5,a
father,528750,532010,3260,Ecuador,E13,m,30,6,a
mother,532250,533320,1070,Ecuador,E13,f,30,7,a
father,533520,539180,5660,Ecuador,E13,m,30,8,a
mother,539200,540560,1360,Ecuador,E13,f,30,9,q
father,540270,541500,1230,Ecuador,E13,m,30,10,a
father,545860,552320,6460,Ecuador,E13,m,30,11,a
mother,554330,555150,820,Ecuador,E13,f,30,12,q
father,554850,556970,2120,Ecuador,E13,m,30,13,a
mother,558580,559430,850,Ecuador,E13,f,30,14,q
father,563520,569690,6170,Ecuador,E13,m,30,15,a
mother,569720,570440,720,Ecuador,E13,f,30,16,a
father,572010,590200,18190,Ecuador,E13,m,30,17,a
child,550540,554390,3850,Ecuador,E13,b,31,1,a
child,555190,557620,2430,Ecuador,E13,b,31,2,a
child,588560,590650,2090,Ecuador,E13,b,32,1,a
mother,594770,595560,790,Ecuador,E13,c,32,2,q
child,596070,596850,780,Ecuador,E13,m,32,3,a
silence,4480,5230,750,Ecuador,E13,NA,NA,NA,NA
silence,6030,7030,1000,Ecuador,E13,NA,NA,NA,NA
silence,10460,10680,220,Ecuador,E13,NA,NA,NA,NA
silence,11900,12400,500,Ecuador,E13,NA,NA,NA,NA
silence,13520,13980,460,Ecuador,E13,NA,NA,NA,NA
silence,14810,33800,18990,Ecuador,E13,NA,NA,NA,NA
silence,34510,35410,900,Ecuador,E13,NA,NA,NA,NA
silence,37160,44010,6850,Ecuador,E13,NA,NA,NA,NA
silence,46510,49790,3280,Ecuador,E13,NA,NA,NA,NA
silence,51100,58850,7750,Ecuador,E13,NA,NA,NA,NA
silence,62320,63220,900,Ecuador,E13,NA,NA,NA,NA
silence,63850,65720,1870,Ecuador,E13,NA,NA,NA,NA
silence,66720,66880,160,Ecuador,E13,NA,NA,NA,NA
silence,67700,67960,260,Ecuador,E13,NA,NA,NA,NA
silence,69310,69770,460,Ecuador,E13,NA,NA,NA,NA
silence,70750,81960,11210,Ecuador,E13,NA,NA,NA,NA
silence,88150,88430,280,Ecuador,E13,NA,NA,NA,NA
mother_gesture,88568,90039,1471,Ecuador,E13,NA,NA,NA,NA
silence,89340,91410,2070,Ecuador,E13,NA,NA,NA,NA
silence,92570,98080,5510,Ecuador,E13,NA,NA,NA,NA
silence,100390,100420,30,Ecuador,E13,NA,NA,NA,NA
silence,101040,101320,280,Ecuador,E13,NA,NA,NA,NA
father_gesture,113290,114525,1235,Ecuador,E13,NA,NA,NA,NA
father_gesture,114570,115800,1230,Ecuador,E13,NA,NA,NA,NA
father_gesture,128019,130630,2611,Ecuador,E13,NA,NA,NA,NA
father_gesture,131310,133599,2289,Ecuador,E13,NA,NA,NA,NA
father_gesture,142740,145809,3069,Ecuador,E13,NA,NA,NA,NA
silence,149020,155040,6020,Ecuador,E13,NA,NA,NA,NA
silence,157130,162240,5110,Ecuador,E13,NA,NA,NA,NA
silence,168012,174600,6588,Ecuador,E13,NA,NA,NA,NA
silence,178975,184160,5185,Ecuador,E13,NA,NA,NA,NA
silence,187370,198200,10830,Ecuador,E13,NA,NA,NA,NA
silence,203190,208940,5750,Ecuador,E13,NA,NA,NA,NA
silence,210200,210370,170,Ecuador,E13,NA,NA,NA,NA
silence,212740,212790,50,Ecuador,E13,NA,NA,NA,NA
silence,214230,214370,140,Ecuador,E13,NA,NA,NA,NA
father_gesture,214950,216309,1359,Ecuador,E13,NA,NA,NA,NA
silence,215210,215880,670,Ecuador,E13,NA,NA,NA,NA
silence,219550,231900,12350,Ecuador,E13,NA,NA,NA,NA
silence,239810,240020,210,Ecuador,E13,NA,NA,NA,NA
mother_gesture,240690,242767,2077,Ecuador,E13,NA,NA,NA,NA
silence,244580,250750,6170,Ecuador,E13,NA,NA,NA,NA
silence,252630,259830,7200,Ecuador,E13,NA,NA,NA,NA
silence,261490,261620,130,Ecuador,E13,NA,NA,NA,NA
silence,262340,293880,31540,Ecuador,E13,NA,NA,NA,NA
silence,296210,304570,8360,Ecuador,E13,NA,NA,NA,NA
silence,307510,310300,2790,Ecuador,E13,NA,NA,NA,NA
silence,313240,313250,10,Ecuador,E13,NA,NA,NA,NA
silence,314000,314070,70,Ecuador,E13,NA,NA,NA,NA
silence,329950,332490,2540,Ecuador,E13,NA,NA,NA,NA
silence,335340,341320,5980,Ecuador,E13,NA,NA,NA,NA
silence,346930,349270,2340,Ecuador,E13,NA,NA,NA,NA
silence,352430,353270,840,Ecuador,E13,NA,NA,NA,NA
silence,353870,354050,180,Ecuador,E13,NA,NA,NA,NA
silence,354530,355140,610,Ecuador,E13,NA,NA,NA,NA
silence,356300,358860,2560,Ecuador,E13,NA,NA,NA,NA
silence,360240,362390,2150,Ecuador,E13,NA,NA,NA,NA
silence,365410,367840,2430,Ecuador,E13,NA,NA,NA,NA
silence,368700,370520,1820,Ecuador,E13,NA,NA,NA,NA
silence,372570,382260,9690,Ecuador,E13,NA,NA,NA,NA
silence,392880,401560,8680,Ecuador,E13,NA,NA,NA,NA
silence,402760,404310,1550,Ecuador,E13,NA,NA,NA,NA
silence,405370,431470,26100,Ecuador,E13,NA,NA,NA,NA
silence,432490,433084,594,Ecuador,E13,NA,NA,NA,NA
father_gesture,434890,436832,1942,Ecuador,E13,NA,NA,NA,NA
father_gesture,437260,440120,2860,Ecuador,E13,NA,NA,NA,NA
silence,439260,450530,11270,Ecuador,E13,NA,NA,NA,NA
silence,454500,460690,6190,Ecuador,E13,NA,NA,NA,NA
silence,463700,465490,1790,Ecuador,E13,NA,NA,NA,NA
silence,467590,468270,680,Ecuador,E13,NA,NA,NA,NA
silence,469050,473570,4520,Ecuador,E13,NA,NA,NA,NA
father_gesture,477880,479770,1890,Ecuador,E13,NA,NA,NA,NA
father_gesture,479830,481210,1380,Ecuador,E13,NA,NA,NA,NA
silence,485160,485420,260,Ecuador,E13,NA,NA,NA,NA
silence,486330,486710,380,Ecuador,E13,NA,NA,NA,NA
silence,487370,488850,1480,Ecuador,E13,NA,NA,NA,NA
silence,490570,490980,410,Ecuador,E13,NA,NA,NA,NA
silence,491700,493470,1770,Ecuador,E13,NA,NA,NA,NA
silence,496960,498480,1520,Ecuador,E13,NA,NA,NA,NA
silence,504140,507200,3060,Ecuador,E13,NA,NA,NA,NA
silence,509680,509730,50,Ecuador,E13,NA,NA,NA,NA
silence,511440,512690,1250,Ecuador,E13,NA,NA,NA,NA
father_gesture,516902,518492,1590,Ecuador,E13,NA,NA,NA,NA
silence,524730,525010,280,Ecuador,E13,NA,NA,NA,NA
silence,527660,527710,50,Ecuador,E13,NA,NA,NA,NA
silence,528609,528750,141,Ecuador,E13,NA,NA,NA,NA
silence,532010,532250,240,Ecuador,E13,NA,NA,NA,NA
silence,533320,533520,200,Ecuador,E13,NA,NA,NA,NA
silence,539180,539200,20,Ecuador,E13,NA,NA,NA,NA
silence,541500,545860,4360,Ecuador,E13,NA,NA,NA,NA
silence,557620,558580,960,Ecuador,E13,NA,NA,NA,NA
silence,559430,563520,4090,Ecuador,E13,NA,NA,NA,NA
silence,569690,569720,30,Ecuador,E13,NA,NA,NA,NA
silence,570440,572010,1570,Ecuador,E13,NA,NA,NA,NA
silence,590650,594770,4120,Ecuador,E13,NA,NA,NA,NA
silence,595560,596070,510,Ecuador,E13,NA,NA,NA,NA
silence,596850,598490,1640,Ecuador,E13,NA,NA,NA,NA
child,600,1590,990,Germany,G01,f,1,1,a
father,970,4080,3110,Germany,G01,c,1,2,a
child,4920,5980,1060,Germany,G01,f,1,3,a
father,5700,7810,2110,Germany,G01,c,1,4,a
child,7940,8420,480,Germany,G01,f,1,5,a
father,10290,10770,480,Germany,G01,c,1,6,a
father,13070,16100,3030,Germany,G01,c,1,7,a
child,16700,17640,940,Germany,G01,f,1,8,a
father,17620,20700,3080,Germany,G01,c,1,9,a
father,24340,25160,820,Germany,G01,c,1,10,a
child,25170,25740,570,Germany,G01,f,1,11,a
father,26140,30200,4060,Germany,G01,c,1,12,q
child,30150,30620,470,Germany,G01,f,1,13,a
father,31640,33300,1660,Germany,G01,c,1,14,a
child,32880,34450,1570,Germany,G01,f,1,15,a
father,34520,34950,430,Germany,G01,c,1,16,q
child,35210,36370,1160,Germany,G01,f,1,17,a
father,36440,37890,1450,Germany,G01,c,1,18,a
child,40900,43620,2720,Germany,G01,f,1,19,a
father,42960,43430,470,Germany,G01,c,1,20,q
child,48890,49650,760,Germany,G01,f,1,21,a
father,50740,52390,1650,Germany,G01,c,1,22,a
child,53340,53960,620,Germany,G01,f,1,23,a
mother,54360,56410,2050,Germany,G01,f,1,24,a
father,56980,58600,1620,Germany,G01,m,1,25,a
father,63140,63910,770,Germany,G01,m,1,26,a
child,62460,63930,1470,Germany,G01,f,2,1,a
child,64990,67170,2180,Germany,G01,f,2,2,a
father,66970,67560,590,Germany,G01,c,2,3,a
father,67860,69870,2010,Germany,G01,m,3,1,q
mother,69880,76650,6770,Germany,G01,f,3,2,a
father,76270,79600,3330,Germany,G01,o,4,1,a
child,80440,82070,1630,Germany,G01,b,4,2,a
father,82320,82930,610,Germany,G01,c,4,3,q
mother,82470,84750,2280,Germany,G01,f,4,4,a
child,90040,92390,2350,Germany,G01,o,4,5,q
mother,93290,94840,1550,Germany,G01,c,4,6,a
child,96660,98720,2060,Germany,G01,m,4,7,a
child,103240,110440,7200,Germany,G01,m,4,8,a
mother,108010,111900,3890,Germany,G01,c,4,9,a
child,111268,114520,3252,Germany,G01,m,4,10,a
father,88800,89680,880,Germany,G01,c,5,1,q
father,115320,119160,3840,Germany,G01,o,6,1,a
child,117530,121130,3600,Germany,G01,b,7,1,a
mother,122280,127700,5420,Germany,G01,c,7,2,i
mother,131380,138290,6910,Germany,G01,c,7,3,a
child,133850,134870,1020,Germany,G01,m,7,4,a
child,138280,138980,700,Germany,G01,m,7,5,a
child,146320,148140,1820,Germany,G01,m,7,6,a
mother,148130,150350,2220,Germany,G01,c,7,7,a
child,151530,154520,2990,Germany,G01,m,7,8,a
mother,154360,158470,4110,Germany,G01,c,7,9,a
father,158510,159840,1330,Germany,G01,c,7,10,a
child,158620,159580,960,Germany,G01,m,7,11,a
mother,159970,161070,1100,Germany,G01,c,7,12,a
child,161380,165220,3840,Germany,G01,b,7,13,a
father,162830,166200,3370,Germany,G01,c,7,14,q
mother,171980,173050,1070,Germany,G01,c,7,15,a
child,173290,174980,1690,Germany,G01,m,7,16,a
mother,142850,144100,1250,Germany,G01,o,8,1,a
child,167680,172880,5200,Germany,G01,b,8,2,a
child,179440,181010,1570,Germany,G01,m,9,1,a
mother,182260,185060,2800,Germany,G01,c,9,2,a
child,186040,187140,1100,Germany,G01,m,9,3,a
mother,186470,187060,590,Germany,G01,c,9,4,a
child,187770,190500,2730,Germany,G01,m,9,5,a
mother,190030,191630,1600,Germany,G01,c,9,6,a
child,193110,195440,2330,Germany,G01,o,10,1,a
child,196340,197510,1170,Germany,G01,b,10,2,a
mother,199270,201010,1740,Germany,G01,o,11,1,q
child,202090,203790,1700,Germany,G01,b,12,1,a
father,207490,209000,1510,Germany,G01,m,12,2,a
mother,208880,209600,720,Germany,G01,f,12,3,a
child,209620,211140,1520,Germany,G01,b,12,4,a
mother,210830,212590,1760,Germany,G01,c,12,5,a
child,213830,215320,1490,Germany,G01,m,12,6,a
father,214980,216230,1250,Germany,G01,c,12,7,a
mother,215170,218750,3580,Germany,G01,c,12,8,a
child,218250,219640,1390,Germany,G01,b,12,9,a
mother,219740,221730,1990,Germany,G01,c,12,10,a
child,224800,226730,1930,Germany,G01,m,12,11,a
mother,227040,228310,1270,Germany,G01,c,12,12,a
child,228780,231710,2930,Germany,G01,m,12,13,a
child,232340,238130,5790,Germany,G01,b,13,1,a
child,257890,258750,860,Germany,G01,f,13,2,i
child,275070,275940,870,Germany,G01,f,13,3,i
mother,284690,288030,3340,Germany,G01,o,14,1,a
child,286100,287570,1470,Germany,G01,f,15,1,a
father,287430,288910,1480,Germany,G01,c,15,2,q
mother,290110,291490,1380,Germany,G01,b,15,3,a
child,291810,292830,1020,Germany,G01,m,15,4,q
mother,292790,293270,480,Germany,G01,c,15,5,a
child,296050,297440,1390,Germany,G01,m,15,6,a
child,300000,301370,1370,Germany,G01,m,15,7,q
mother,301070,301680,610,Germany,G01,c,15,8,a
child,302620,306070,3450,Germany,G01,f,15,9,a
father,305170,307280,2110,Germany,G01,c,15,10,a
child,307470,310100,2630,Germany,G01,f,15,11,a
father,310520,311150,630,Germany,G01,c,15,12,q
child,311640,311970,330,Germany,G01,f,15,13,a
father,311850,312460,610,Germany,G01,c,15,14,a
child,313410,320820,7410,Germany,G01,f,15,15,a
father,321110,334940,13830,Germany,G01,c,15,16,a
mother,335650,341980,6330,Germany,G01,c,15,17,a
child,339100,339870,770,Germany,G01,f,15,18,a
child,345290,350580,5290,Germany,G01,b,15,19,a
father,350990,352100,1110,Germany,G01,c,15,20,q
child,355240,361970,6730,Germany,G01,f,15,21,a
father,362320,363780,1460,Germany,G01,c,15,22,a
child,375700,381210,5510,Germany,G01,b,16,1,a
mother,381860,382900,1040,Germany,G01,c,16,2,a
child,384630,387320,2690,Germany,G01,m,16,3,a
mother,388070,389050,980,Germany,G01,c,16,4,q
child,389610,391540,1930,Germany,G01,m,16,5,a
mother,391300,392160,860,Germany,G01,c,16,6,a
child,393130,394240,1110,Germany,G01,m,16,7,a
mother,394570,395540,970,Germany,G01,c,16,8,q
child,395870,396540,670,Germany,G01,m,16,9,a
mother,396670,397850,1180,Germany,G01,c,16,10,a
child,398040,400590,2550,Germany,G01,m,16,11,a
mother,400610,401680,1070,Germany,G01,c,16,12,a
child,401940,404050,2110,Germany,G01,m,16,13,a
mother,404100,404750,650,Germany,G01,c,16,14,q
child,404940,406910,1970,Germany,G01,m,16,15,a
mother,406950,410160,3210,Germany,G01,c,16,16,q
child,410310,412390,2080,Germany,G01,m,16,17,a
mother,411770,413450,1680,Germany,G01,c,16,18,a
child,413450,414240,790,Germany,G01,m,16,19,a
father,413500,414730,1230,Germany,G01,m,17,1,a
mother,415250,416760,1510,Germany,G01,f,17,2,a
father,415410,418230,2820,Germany,G01,m,17,3,a
child,419930,422120,2190,Germany,G01,m,18,1,a
mother,422390,423430,1040,Germany,G01,c,18,2,q
child,424740,425880,1140,Germany,G01,m,18,3,a
father,424870,430260,5390,Germany,G01,c,18,4,q
child,429760,430890,1130,Germany,G01,f,18,5,a
father,430680,431730,1050,Germany,G01,c,18,6,q
child,431970,432530,560,Germany,G01,f,18,7,a
mother,432100,433280,1180,Germany,G01,c,18,8,q
father,433300,438230,4930,Germany,G01,c,18,9,q
child,438280,439450,1170,Germany,G01,f,18,10,a
father,438740,440490,1750,Germany,G01,c,18,11,q
mother,439780,442310,2530,Germany,G01,c,18,12,q
child,441610,442400,790,Germany,G01,m,18,13,a
mother,443040,443700,660,Germany,G01,c,18,14,q
child,443960,445710,1750,Germany,G01,m,18,15,a
mother,445080,446160,1080,Germany,G01,c,18,16,q
father,446150,446630,480,Germany,G01,b,18,17,a
mother,447610,449310,1700,Germany,G01,c,18,18,q
child,449360,450070,710,Germany,G01,m,18,19,a
mother,450670,452110,1440,Germany,G01,c,18,20,q
child,452030,458100,6070,Germany,G01,b,18,21,a
father,459470,463590,4120,Germany,G01,c,19,1,q
child,463660,466350,2690,Germany,G01,f,19,2,a
father,466760,469640,2880,Germany,G01,c,19,3,a
mother,467610,468470,860,Germany,G01,c,19,4,q
child,467710,468260,550,Germany,G01,f,19,5,a
child,473490,478730,5240,Germany,G01,m,19,6,a
mother,479210,480400,1190,Germany,G01,c,19,7,q
child,480340,480980,640,Germany,G01,m,19,8,a
mother,480850,481630,780,Germany,G01,c,19,9,a
child,481650,483720,2070,Germany,G01,m,19,10,a
mother,484020,484590,570,Germany,G01,c,19,11,q
child,484690,485490,800,Germany,G01,m,19,12,i
mother,485960,486920,960,Germany,G01,c,19,13,q
child,487120,488150,1030,Germany,G01,m,19,14,a
mother,487930,489020,1090,Germany,G01,c,19,15,a
child,489450,490290,840,Germany,G01,m,19,16,i
mother,490740,491340,600,Germany,G01,c,19,17,a
child,491310,493150,1840,Germany,G01,m,19,18,a
mother,492020,492670,650,Germany,G01,c,19,19,a
mother,471130,473150,2020,Germany,G01,c,20,1,q
child,494260,499320,5060,Germany,G01,f,20,2,a
father,495620,500090,4470,Germany,G01,c,20,3,a
child,500350,501910,1560,Germany,G01,f,20,4,a
father,501750,502670,920,Germany,G01,c,20,5,a
child,502800,505830,3030,Germany,G01,f,20,6,i
father,506590,508160,1570,Germany,G01,c,20,7,a
child,507960,509330,1370,Germany,G01,f,20,8,a
father,511850,512520,670,Germany,G01,c,20,9,a
mother,513030,514770,1740,Germany,G01,f,21,1,q
father,514160,514600,440,Germany,G01,m,21,2,a
father,516450,517600,1150,Germany,G01,c,22,1,q
child,519410,521160,1750,Germany,G01,f,22,2,a
father,521110,524110,3000,Germany,G01,m,22,3,q
father,526420,528850,2430,Germany,G01,c,22,4,a
child,530330,532650,2320,Germany,G01,f,22,5,a
father,532280,533360,1080,Germany,G01,c,22,6,q
child,533360,533710,350,Germany,G01,f,22,7,a
father,533710,534080,370,Germany,G01,c,22,8,a
child,534300,535540,1240,Germany,G01,f,22,9,a
father,535350,543130,7780,Germany,G01,c,22,10,a
child,537540,537950,410,Germany,G01,f,22,11,a
child,545080,545940,860,Germany,G01,f,22,12,q
father,546180,547420,1240,Germany,G01,c,22,13,a
child,548000,548940,940,Germany,G01,f,22,14,q
father,548830,550750,1920,Germany,G01,c,22,15,a
child,553360,554350,990,Germany,G01,f,22,16,a
father,554040,555050,1010,Germany,G01,c,22,17,a
child,555170,556530,1360,Germany,G01,f,22,18,a
mother,519570,520480,910,Germany,G01,b,23,1,a
mother,524190,525570,1380,Germany,G01,b,23,2,a
child,558620,564900,6280,Germany,G01,f,23,3,a
father,565110,567600,2490,Germany,G01,c,23,4,a
child,568240,570340,2100,Germany,G01,f,23,5,a
father,569550,571270,1720,Germany,G01,c,23,6,q
child,571230,572080,850,Germany,G01,f,23,7,a
child,576110,578830,2720,Germany,G01,f,23,8,a
child,581860,584670,2810,Germany,G01,f,23,9,i
father,585280,588360,3080,Germany,G01,c,23,10,a
child,588600,589730,1130,Germany,G01,f,23,11,a
father,589170,590180,1010,Germany,G01,c,23,12,i
child,594090,597040,2950,Germany,G01,f,23,13,a
father,598040,599510,1470,Germany,G01,c,23,14,a
silence,4080,4920,840,Germany,G01,NA,NA,NA,NA
silence,7810,7940,130,Germany,G01,NA,NA,NA,NA
silence,8420,10290,1870,Germany,G01,NA,NA,NA,NA
silence,10770,13070,2300,Germany,G01,NA,NA,NA,NA
silence,16100,16700,600,Germany,G01,NA,NA,NA,NA
silence,20700,24340,3640,Germany,G01,NA,NA,NA,NA
silence,25160,25170,10,Germany,G01,NA,NA,NA,NA
silence,25740,26140,400,Germany,G01,NA,NA,NA,NA
silence,30620,31640,1020,Germany,G01,NA,NA,NA,NA
silence,34450,34520,70,Germany,G01,NA,NA,NA,NA
silence,34950,35210,260,Germany,G01,NA,NA,NA,NA
silence,36370,36440,70,Germany,G01,NA,NA,NA,NA
silence,37890,40900,3010,Germany,G01,NA,NA,NA,NA
silence,43620,48890,5270,Germany,G01,NA,NA,NA,NA
silence,49650,50740,1090,Germany,G01,NA,NA,NA,NA
silence,52390,53340,950,Germany,G01,NA,NA,NA,NA
silence,53960,54360,400,Germany,G01,NA,NA,NA,NA
mother_gesture,54673,55847,1174,Germany,G01,NA,NA,NA,NA
silence,56410,56980,570,Germany,G01,NA,NA,NA,NA
silence,58600,62460,3860,Germany,G01,NA,NA,NA,NA
silence,63930,64990,1060,Germany,G01,NA,NA,NA,NA
silence,67560,67860,300,Germany,G01,NA,NA,NA,NA
silence,69870,69880,10,Germany,G01,NA,NA,NA,NA
silence,79600,80440,840,Germany,G01,NA,NA,NA,NA
child_gesture,81045,82122,1077,Germany,G01,NA,NA,NA,NA
silence,82070,82320,250,Germany,G01,NA,NA,NA,NA
silence,84750,88800,4050,Germany,G01,NA,NA,NA,NA
silence,89680,90040,360,Germany,G01,NA,NA,NA,NA
silence,92390,93290,900,Germany,G01,NA,NA,NA,NA
silence,94840,96660,1820,Germany,G01,NA,NA,NA,NA
silence,98720,103240,4520,Germany,G01,NA,NA,NA,NA
silence,114520,115320,800,Germany,G01,NA,NA,NA,NA
silence,121130,122280,1150,Germany,G01,NA,NA,NA,NA
silence,127700,131380,3680,Germany,G01,NA,NA,NA,NA
silence,138980,142850,3870,Germany,G01,NA,NA,NA,NA
silence,144100,146320,2220,Germany,G01,NA,NA,NA,NA
silence,150350,151530,1180,Germany,G01,NA,NA,NA,NA
silence,158470,158510,40,Germany,G01,NA,NA,NA,NA
silence,159840,159970,130,Germany,G01,NA,NA,NA,NA
silence,161070,161380,310,Germany,G01,NA,NA,NA,NA
silence,166200,167680,1480,Germany,G01,NA,NA,NA,NA
silence,173050,173290,240,Germany,G01,NA,NA,NA,NA
silence,174980,179440,4460,Germany,G01,NA,NA,NA,NA
silence,181010,182260,1250,Germany,G01,NA,NA,NA,NA
silence,185060,186040,980,Germany,G01,NA,NA,NA,NA
silence,187140,187770,630,Germany,G01,NA,NA,NA,NA
silence,191630,193110,1480,Germany,G01,NA,NA,NA,NA
silence,195440,196340,900,Germany,G01,NA,NA,NA,NA
silence,197510,199270,1760,Germany,G01,NA,NA,NA,NA
silence,201010,202090,1080,Germany,G01,NA,NA,NA,NA
silence,203790,207490,3700,Germany,G01,NA,NA,NA,NA
silence,209600,209620,20,Germany,G01,NA,NA,NA,NA
silence,212590,213830,1240,Germany,G01,NA,NA,NA,NA
silence,219640,219740,100,Germany,G01,NA,NA,NA,NA
silence,221730,224800,3070,Germany,G01,NA,NA,NA,NA
silence,226730,227040,310,Germany,G01,NA,NA,NA,NA
silence,228310,228780,470,Germany,G01,NA,NA,NA,NA
silence,231710,232340,630,Germany,G01,NA,NA,NA,NA
silence,238130,257890,19760,Germany,G01,NA,NA,NA,NA
silence,258750,275070,16320,Germany,G01,NA,NA,NA,NA
child_gesture,259169,259861,692,Germany,G01,NA,NA,NA,NA
silence,275940,284690,8750,Germany,G01,NA,NA,NA,NA
child_gesture,285158,287627,2469,Germany,G01,NA,NA,NA,NA
silence,288910,290110,1200,Germany,G01,NA,NA,NA,NA
silence,291490,291810,320,Germany,G01,NA,NA,NA,NA
silence,293270,296050,2780,Germany,G01,NA,NA,NA,NA
silence,297440,300000,2560,Germany,G01,NA,NA,NA,NA
silence,301680,302620,940,Germany,G01,NA,NA,NA,NA
silence,307280,307470,190,Germany,G01,NA,NA,NA,NA
silence,310100,310520,420,Germany,G01,NA,NA,NA,NA
silence,311150,311640,490,Germany,G01,NA,NA,NA,NA
silence,312460,313410,950,Germany,G01,NA,NA,NA,NA
silence,320820,321110,290,Germany,G01,NA,NA,NA,NA
silence,334940,335650,710,Germany,G01,NA,NA,NA,NA
silence,341980,345290,3310,Germany,G01,NA,NA,NA,NA
child_gesture,346230,348520,2290,Germany,G01,NA,NA,NA,NA
child_gesture,349088,350927,1839,Germany,G01,NA,NA,NA,NA
silence,350580,350990,410,Germany,G01,NA,NA,NA,NA
silence,352100,355240,3140,Germany,G01,NA,NA,NA,NA
child_gesture,355678,359370,3692,Germany,G01,NA,NA,NA,NA
silence,361970,362320,350,Germany,G01,NA,NA,NA,NA
silence,363780,375700,11920,Germany,G01,NA,NA,NA,NA
silence,381210,381860,650,Germany,G01,NA,NA,NA,NA
silence,382900,384630,1730,Germany,G01,NA,NA,NA,NA
silence,387320,388070,750,Germany,G01,NA,NA,NA,NA
silence,389050,389610,560,Germany,G01,NA,NA,NA,NA
silence,392160,393130,970,Germany,G01,NA,NA,NA,NA
silence,394240,394570,330,Germany,G01,NA,NA,NA,NA
silence,395540,395870,330,Germany,G01,NA,NA,NA,NA
silence,396540,396670,130,Germany,G01,NA,NA,NA,NA
silence,397850,398040,190,Germany,G01,NA,NA,NA,NA
silence,400590,400610,20,Germany,G01,NA,NA,NA,NA
silence,401680,401940,260,Germany,G01,NA,NA,NA,NA
silence,404050,404100,50,Germany,G01,NA,NA,NA,NA
silence,404750,404940,190,Germany,G01,NA,NA,NA,NA
silence,406910,406950,40,Germany,G01,NA,NA,NA,NA
silence,410160,410310,150,Germany,G01,NA,NA,NA,NA
silence,414730,415250,520,Germany,G01,NA,NA,NA,NA
silence,418230,419930,1700,Germany,G01,NA,NA,NA,NA
silence,422120,422390,270,Germany,G01,NA,NA,NA,NA
silence,423430,424740,1310,Germany,G01,NA,NA,NA,NA
silence,431730,431970,240,Germany,G01,NA,NA,NA,NA
silence,433280,433300,20,Germany,G01,NA,NA,NA,NA
silence,438230,438280,50,Germany,G01,NA,NA,NA,NA
silence,442400,443040,640,Germany,G01,NA,NA,NA,NA
silence,443700,443960,260,Germany,G01,NA,NA,NA,NA
silence,446630,447610,980,Germany,G01,NA,NA,NA,NA
silence,449310,449360,50,Germany,G01,NA,NA,NA,NA
silence,450070,450670,600,Germany,G01,NA,NA,NA,NA
silence,458100,459470,1370,Germany,G01,NA,NA,NA,NA
silence,463590,463660,70,Germany,G01,NA,NA,NA,NA
child_gesture,464510,466940,2430,Germany,G01,NA,NA,NA,NA
silence,466350,466760,410,Germany,G01,NA,NA,NA,NA
silence,469640,471130,1490,Germany,G01,NA,NA,NA,NA
silence,473150,473490,340,Germany,G01,NA,NA,NA,NA
silence,478730,479210,480,Germany,G01,NA,NA,NA,NA
silence,481630,481650,20,Germany,G01,NA,NA,NA,NA
silence,483720,484020,300,Germany,G01,NA,NA,NA,NA
silence,484590,484690,100,Germany,G01,NA,NA,NA,NA
silence,485490,485960,470,Germany,G01,NA,NA,NA,NA
silence,486920,487120,200,Germany,G01,NA,NA,NA,NA
silence,489020,489450,430,Germany,G01,NA,NA,NA,NA
silence,490290,490740,450,Germany,G01,NA,NA,NA,NA
silence,493150,494260,1110,Germany,G01,NA,NA,NA,NA
silence,500090,500350,260,Germany,G01,NA,NA,NA,NA
silence,502670,502800,130,Germany,G01,NA,NA,NA,NA
silence,505830,506590,760,Germany,G01,NA,NA,NA,NA
silence,509330,511850,2520,Germany,G01,NA,NA,NA,NA
silence,512520,513030,510,Germany,G01,NA,NA,NA,NA
silence,514770,516450,1680,Germany,G01,NA,NA,NA,NA
silence,517600,519410,1810,Germany,G01,NA,NA,NA,NA
silence,524110,524190,80,Germany,G01,NA,NA,NA,NA
silence,525570,526420,850,Germany,G01,NA,NA,NA,NA
silence,528850,530330,1480,Germany,G01,NA,NA,NA,NA
silence,534080,534300,220,Germany,G01,NA,NA,NA,NA
silence,543130,545080,1950,Germany,G01,NA,NA,NA,NA
silence,545940,546180,240,Germany,G01,NA,NA,NA,NA
silence,547420,548000,580,Germany,G01,NA,NA,NA,NA
silence,550750,553360,2610,Germany,G01,NA,NA,NA,NA
silence,555050,555170,120,Germany,G01,NA,NA,NA,NA
silence,556530,558620,2090,Germany,G01,NA,NA,NA,NA
silence,564900,565110,210,Germany,G01,NA,NA,NA,NA
silence,567600,568240,640,Germany,G01,NA,NA,NA,NA
silence,572080,576110,4030,Germany,G01,NA,NA,NA,NA
silence,578830,581860,3030,Germany,G01,NA,NA,NA,NA
silence,584670,585280,610,Germany,G01,NA,NA,NA,NA
silence,588360,588600,240,Germany,G01,NA,NA,NA,NA
silence,590180,594090,3910,Germany,G01,NA,NA,NA,NA
silence,597040,598040,1000,Germany,G01,NA,NA,NA,NA
child,1750,2870,1120,Germany,G02,b,1,1,a
child,4710,6040,1330,Germany,G02,b,1,2,q
mother,6410,9840,3430,Germany,G02,c,1,3,q
father,6500,7150,650,Germany,G02,c,1,4,a
child,7690,8250,560,Germany,G02,b,1,5,a
father,7950,8780,830,Germany,G02,c,1,6,a
child,9860,10600,740,Germany,G02,b,1,7,q
father,11560,12630,1070,Germany,G02,c,1,8,i
mother,12880,14380,1500,Germany,G02,c,1,9,a
child,14700,15820,1120,Germany,G02,m,1,10,q
mother,16340,17060,720,Germany,G02,c,1,11,a
father,16570,17260,690,Germany,G02,c,1,12,a
child,17600,18920,1320,Germany,G02,m,1,13,q
mother,19150,19700,550,Germany,G02,c,1,14,a
mother,2930,5120,2190,Germany,G02,c,2,1,i
father,18980,20280,1300,Germany,G02,m,3,1,q
mother,21160,23760,2600,Germany,G02,f,3,2,a
father,23940,24830,890,Germany,G02,m,3,3,i
mother,25300,28660,3360,Germany,G02,f,3,4,a
father,36080,37090,1010,Germany,G02,m,4,1,q
mother,38680,39310,630,Germany,G02,f,4,2,a
child,38840,40370,1530,Germany,G02,m,4,3,q
mother,42010,45790,3780,Germany,G02,b,4,4,a
child,44530,46750,2220,Germany,G02,m,4,5,q
mother,46100,49440,3340,Germany,G02,c,4,6,a
child,51060,51690,630,Germany,G02,m,4,7,q
mother,51760,52420,660,Germany,G02,c,4,8,a
mother,53470,54690,1220,Germany,G02,c,5,1,q
child,56010,59220,3210,Germany,G02,m,5,2,a
mother,59370,60920,1550,Germany,G02,c,6,1,q
child,61260,61730,470,Germany,G02,m,6,2,q
mother,63150,63920,770,Germany,G02,c,6,3,q
father,63360,64780,1420,Germany,G02,c,6,4,i
child,74370,84220,9850,Germany,G02,o,7,1,a
father,81790,83860,2070,Germany,G02,c,8,1,q
mother,84200,85360,1160,Germany,G02,c,8,2,q
child,86210,86930,720,Germany,G02,m,8,3,a
mother,87760,88520,760,Germany,G02,c,8,4,q
child,90790,93930,3140,Germany,G02,o,9,1,NA
child,100660,101910,1250,Germany,G02,o,9,2,a
father,99700,100620,920,Germany,G02,f,10,1,i
father,101870,108410,6540,Germany,G02,c,10,2,a
child,106150,107000,850,Germany,G02,f,10,3,a
child,109150,113870,4720,Germany,G02,f,10,4,a
father,112030,115530,3500,Germany,G02,c,10,5,i
child,117300,121970,4670,Germany,G02,f,10,6,a
father,128080,128900,820,Germany,G02,c,10,7,q
mother,131750,132350,600,Germany,G02,c,10,8,a
mother,116550,118230,1680,Germany,G02,f,11,1,a
father,118280,120200,1920,Germany,G02,m,11,2,a
mother,118680,119340,660,Germany,G02,f,11,3,a
child,137240,140140,2900,Germany,G02,b,12,1,a
mother,140670,142080,1410,Germany,G02,c,12,2,q
child,142750,143620,870,Germany,G02,m,12,3,a
mother,144650,146450,1800,Germany,G02,c,12,4,q
child,146930,147844,914,Germany,G02,m,12,5,a
mother,149310,150760,1450,Germany,G02,c,12,6,q
child,150710,151650,940,Germany,G02,m,12,7,a
mother,151690,152940,1250,Germany,G02,c,12,8,q
child,155870,156620,750,Germany,G02,m,12,9,a
mother,156630,159092,2462,Germany,G02,c,12,10,a
mother,159113,161652,2539,Germany,G02,c,13,1,i
child,162490,163170,680,Germany,G02,f,13,2,a
mother,164224,165705,1481,Germany,G02,c,13,3,q
child,166140,169830,3690,Germany,G02,f,13,4,a
father,170030,171330,1300,Germany,G02,c,13,5,q
child,172330,179090,6760,Germany,G02,f,13,6,a
father,178690,180670,1980,Germany,G02,c,13,7,q
child,180730,181370,640,Germany,G02,f,13,8,a
father,181690,183090,1400,Germany,G02,c,13,9,q
child,183290,185530,2240,Germany,G02,f,13,10,a
father,186460,187890,1430,Germany,G02,c,13,11,q
child,189910,191040,1130,Germany,G02,f,13,12,a
child,193560,205480,11920,Germany,G02,f,13,13,a
father,193680,194740,1060,Germany,G02,c,13,14,q
father,205170,206490,1320,Germany,G02,c,13,15,q
child,206290,210010,3720,Germany,G02,f,13,16,a
father,209940,212663,2723,Germany,G02,c,13,17,q
child,211520,215370,3850,Germany,G02,f,13,18,a
father,215220,215880,660,Germany,G02,c,13,19,a
mother,217464,218128,664,Germany,G02,c,13,20,q
father,217730,219510,1780,Germany,G02,c,13,21,q
child,219750,222760,3010,Germany,G02,f,13,22,a
father,223010,224110,1100,Germany,G02,c,13,23,q
child,229630,230460,830,Germany,G02,b,13,24,a
father,230730,231560,830,Germany,G02,c,13,25,q
child,231750,234720,2970,Germany,G02,f,13,26,a
father,235780,236840,1060,Germany,G02,c,13,27,q
child,236960,237720,760,Germany,G02,f,13,28,a
father,238000,238540,540,Germany,G02,c,13,29,a
mother,191455,193863,2408,Germany,G02,c,14,1,q
father,240180,243500,3320,Germany,G02,c,14,2,q
child,242530,243330,800,Germany,G02,f,14,3,a
mother,244094,246282,2188,Germany,G02,c,14,4,q
child,246860,247550,690,Germany,G02,m,14,5,a
mother,247575,248397,822,Germany,G02,c,14,6,q
father,248120,248970,850,Germany,G02,c,14,7,a
child,248600,249370,770,Germany,G02,b,14,8,a
child,252530,256070,3540,Germany,G02,m,14,9,a
mother,256734,263109,6375,Germany,G02,c,14,10,q
child,258690,259250,560,Germany,G02,m,14,11,a
child,263290,264160,870,Germany,G02,m,14,12,a
mother,264753,266628,1875,Germany,G02,c,14,13,q
child,266760,268350,1590,Germany,G02,m,14,14,a
mother,268748,271200,2452,Germany,G02,c,14,15,q
child,273230,275260,2030,Germany,G02,b,14,16,a
mother,276916,277431,515,Germany,G02,c,14,17,q
child,276970,278650,1680,Germany,G02,m,15,1,a
mother,279046,280709,1663,Germany,G02,c,15,2,a
child,280970,283510,2540,Germany,G02,m,15,3,a
child,293940,295300,1360,Germany,G02,b,16,1,a
father,296000,300329,4329,Germany,G02,c,17,1,q
child,301130,306610,5480,Germany,G02,f,17,2,a
mother,306834,307575,741,Germany,G02,c,17,3,a
father,307260,309320,2060,Germany,G02,c,17,4,q
mother,309921,312181,2260,Germany,G02,c,17,5,q
father,311240,312130,890,Germany,G02,b,17,6,a
child,313020,313490,470,Germany,G02,b,17,7,a
father,315460,316160,700,Germany,G02,b,17,8,a
child,316300,318710,2410,Germany,G02,b,17,9,a
father,318610,319590,980,Germany,G02,c,17,10,q
child,319690,320300,610,Germany,G02,f,17,11,a
father,320200,321680,1480,Germany,G02,c,17,12,a
child,321990,328630,6640,Germany,G02,b,17,13,a
father,324500,329300,4800,Germany,G02,c,17,14,q
mother,330012,332325,2313,Germany,G02,f,17,15,a
child,330610,335130,4520,Germany,G02,b,18,1,a
mother,336152,339589,3437,Germany,G02,f,19,1,a
father,338890,341480,2590,Germany,G02,m,19,2,q
mother,341344,344475,3131,Germany,G02,f,19,3,q
father,344710,346970,2260,Germany,G02,m,19,4,a
mother,349486,351175,1689,Germany,G02,f,19,5,a
child,348430,350600,2170,Germany,G02,b,20,1,a
father,351090,351710,620,Germany,G02,c,20,2,a
child,351320,354010,2690,Germany,G02,b,20,3,a
father,353600,364310,10710,Germany,G02,c,20,4,a
child,364530,366960,2430,Germany,G02,f,20,5,a
father,368010,369310,1300,Germany,G02,c,20,6,q
child,369490,371310,1820,Germany,G02,f,20,7,a
father,371520,374750,3230,Germany,G02,c,20,8,a
mother,374617,377323,2706,Germany,G02,c,20,9,a
child,377300,379190,1890,Germany,G02,b,20,10,q
father,377460,378010,550,Germany,G02,c,20,11,a
mother,379628,383017,3389,Germany,G02,c,20,12,a
father,382680,385050,2370,Germany,G02,c,21,1,a
child,388040,389110,1070,Germany,G02,f,21,2,q
father,389400,389990,590,Germany,G02,c,21,3,q
child,389650,392360,2710,Germany,G02,f,21,4,a
mother,393007,395375,2368,Germany,G02,c,22,1,i
child,395950,398590,2640,Germany,G02,m,22,2,a
mother,398533,401496,2963,Germany,G02,c,22,3,a
child,403580,404380,800,Germany,G02,m,22,4,a
mother,404870,408175,3305,Germany,G02,c,22,5,q
child,409380,411140,1760,Germany,G02,m,22,6,a
father,409410,420160,10750,Germany,G02,c,23,1,q
father,424110,432020,7910,Germany,G02,c,23,2,q
child,432110,432890,780,Germany,G02,f,23,3,a
mother,432896,434881,1985,Germany,G02,c,23,4,q
child,435910,436450,540,Germany,G02,m,23,5,a
mother,436670,438307,1637,Germany,G02,c,23,6,a
child,437240,439670,2430,Germany,G02,m,23,7,a
mother,439686,441696,2010,Germany,G02,c,23,8,a
child,442030,444260,2230,Germany,G02,m,23,9,a
mother,444333,444938,605,Germany,G02,c,23,10,a
father,444660,445790,1130,Germany,G02,c,23,11,i
child,446460,447400,940,Germany,G02,b,23,12,a
mother,447717,452038,4321,Germany,G02,c,23,13,a
child,448720,450690,1970,Germany,G02,m,23,14,a
father,451910,455880,3970,Germany,G02,c,23,15,q
father,461050,463660,2610,Germany,G02,c,23,16,q
child,463840,470450,6610,Germany,G02,f,23,17,a
father,470510,472950,2440,Germany,G02,c,23,18,a
mother,471094,471634,540,Germany,G02,c,23,19,a
child,478380,480890,2510,Germany,G02,b,23,20,a
father,481550,492280,10730,Germany,G02,c,23,21,i
father,496570,498440,1870,Germany,G02,c,23,22,a
child,504830,507730,2900,Germany,G02,m,24,1,q
mother,507757,509959,2202,Germany,G02,c,24,2,i
father,509520,512070,2550,Germany,G02,c,25,1,q
child,512110,513210,1100,Germany,G02,f,25,2,a
father,513190,514120,930,Germany,G02,c,25,3,a
mother,513375,516274,2899,Germany,G02,c,25,4,a
mother,517768,522285,4517,Germany,G02,f,25,5,a
father,523120,524030,910,Germany,G02,m,25,6,a
child,515070,520840,5770,Germany,G02,b,26,1,a
father,515790,517260,1470,Germany,G02,c,27,1,i
father,540710,541880,1170,Germany,G02,c,28,1,q
father,542120,543140,1020,Germany,G02,c,29,1,q
child,545330,545840,510,Germany,G02,f,29,2,a
mother,550600,551971,1371,Germany,G02,f,30,1,q
father,552950,554730,1780,Germany,G02,m,30,2,a
mother,556577,558150,1573,Germany,G02,f,30,3,a
father,559690,560940,1250,Germany,G02,m,30,4,a
child,558200,561210,3010,Germany,G02,f,31,1,a
mother,562263,563285,1022,Germany,G02,c,31,2,q
child,563270,564630,1360,Germany,G02,m,31,3,a
father,563400,564110,710,Germany,G02,m,31,4,a
mother,565330,566184,854,Germany,G02,c,31,5,a
child,566270,569580,3310,Germany,G02,b,31,6,a
mother,569735,575667,5932,Germany,G02,c,31,7,q
child,572680,573240,560,Germany,G02,m,31,8,a
child,575790,576700,910,Germany,G02,m,31,9,a
father,586950,595940,8990,Germany,G02,c,31,10,a
mother,595600,596555,955,Germany,G02,c,31,11,a
father,597780,599870,2090,Germany,G02,c,31,12,i
silence,2870,2930,60,Germany,G02,NA,NA,NA,NA
mother_gesture,4159,5208,1049,Germany,G02,NA,NA,NA,NA
silence,6040,6410,370,Germany,G02,NA,NA,NA,NA
silence,9840,9860,20,Germany,G02,NA,NA,NA,NA
silence,10600,11560,960,Germany,G02,NA,NA,NA,NA
silence,12630,12880,250,Germany,G02,NA,NA,NA,NA
silence,14380,14700,320,Germany,G02,NA,NA,NA,NA
silence,15820,16340,520,Germany,G02,NA,NA,NA,NA
silence,17260,17600,340,Germany,G02,NA,NA,NA,NA
silence,18920,18980,60,Germany,G02,NA,NA,NA,NA
silence,20280,21160,880,Germany,G02,NA,NA,NA,NA
silence,23760,23940,180,Germany,G02,NA,NA,NA,NA
silence,24830,25300,470,Germany,G02,NA,NA,NA,NA
silence,28660,36080,7420,Germany,G02,NA,NA,NA,NA
silence,37090,38680,1590,Germany,G02,NA,NA,NA,NA
silence,40370,42010,1640,Germany,G02,NA,NA,NA,NA
mother_gesture,42450,42987,537,Germany,G02,NA,NA,NA,NA
mother_gesture,47448,48979,1531,Germany,G02,NA,NA,NA,NA
silence,49440,51060,1620,Germany,G02,NA,NA,NA,NA
silence,51690,51760,70,Germany,G02,NA,NA,NA,NA
silence,52420,53470,1050,Germany,G02,NA,NA,NA,NA
silence,54690,56010,1320,Germany,G02,NA,NA,NA,NA
silence,59220,59370,150,Germany,G02,NA,NA,NA,NA
silence,60920,61260,340,Germany,G02,NA,NA,NA,NA
silence,61730,63150,1420,Germany,G02,NA,NA,NA,NA
silence,64780,74370,9590,Germany,G02,NA,NA,NA,NA
silence,85360,86210,850,Germany,G02,NA,NA,NA,NA
silence,86930,87760,830,Germany,G02,NA,NA,NA,NA
silence,88520,90790,2270,Germany,G02,NA,NA,NA,NA
silence,93930,99700,5770,Germany,G02,NA,NA,NA,NA
silence,100620,100660,40,Germany,G02,NA,NA,NA,NA
silence,108410,109150,740,Germany,G02,NA,NA,NA,NA
silence,115530,116550,1020,Germany,G02,NA,NA,NA,NA
silence,121970,128080,6110,Germany,G02,NA,NA,NA,NA
silence,128900,131750,2850,Germany,G02,NA,NA,NA,NA
silence,132350,137240,4890,Germany,G02,NA,NA,NA,NA
silence,140140,140670,530,Germany,G02,NA,NA,NA,NA
silence,142080,142750,670,Germany,G02,NA,NA,NA,NA
silence,143620,144650,1030,Germany,G02,NA,NA,NA,NA
silence,146450,146930,480,Germany,G02,NA,NA,NA,NA
silence,147844,149310,1466,Germany,G02,NA,NA,NA,NA
silence,151650,151690,40,Germany,G02,NA,NA,NA,NA
silence,152940,155870,2930,Germany,G02,NA,NA,NA,NA
child_gesture,155915,156840,925,Germany,G02,NA,NA,NA,NA
silence,156620,156630,10,Germany,G02,NA,NA,NA,NA
silence,159092,159113,21,Germany,G02,NA,NA,NA,NA
silence,161652,162490,838,Germany,G02,NA,NA,NA,NA
silence,163170,164224,1054,Germany,G02,NA,NA,NA,NA
silence,165705,166140,435,Germany,G02,NA,NA,NA,NA
silence,169830,170030,200,Germany,G02,NA,NA,NA,NA
silence,171330,172330,1000,Germany,G02,NA,NA,NA,NA
silence,180670,180730,60,Germany,G02,NA,NA,NA,NA
silence,181370,181690,320,Germany,G02,NA,NA,NA,NA
silence,183090,183290,200,Germany,G02,NA,NA,NA,NA
silence,185530,186460,930,Germany,G02,NA,NA,NA,NA
silence,187890,189910,2020,Germany,G02,NA,NA,NA,NA
silence,191040,191455,415,Germany,G02,NA,NA,NA,NA
silence,215880,217464,1584,Germany,G02,NA,NA,NA,NA
silence,219510,219750,240,Germany,G02,NA,NA,NA,NA
silence,222760,223010,250,Germany,G02,NA,NA,NA,NA
silence,224110,229630,5520,Germany,G02,NA,NA,NA,NA
silence,230460,230730,270,Germany,G02,NA,NA,NA,NA
silence,231560,231750,190,Germany,G02,NA,NA,NA,NA
silence,234720,235780,1060,Germany,G02,NA,NA,NA,NA
silence,236840,236960,120,Germany,G02,NA,NA,NA,NA
silence,237720,238000,280,Germany,G02,NA,NA,NA,NA
silence,238540,240180,1640,Germany,G02,NA,NA,NA,NA
silence,243500,244094,594,Germany,G02,NA,NA,NA,NA
silence,246282,246860,578,Germany,G02,NA,NA,NA,NA
silence,247550,247575,25,Germany,G02,NA,NA,NA,NA
silence,249370,252530,3160,Germany,G02,NA,NA,NA,NA
silence,256070,256734,664,Germany,G02,NA,NA,NA,NA
silence,263109,263290,181,Germany,G02,NA,NA,NA,NA
silence,264160,264753,593,Germany,G02,NA,NA,NA,NA
silence,266628,266760,132,Germany,G02,NA,NA,NA,NA
silence,268350,268748,398,Germany,G02,NA,NA,NA,NA
silence,271200,273230,2030,Germany,G02,NA,NA,NA,NA
silence,275260,276916,1656,Germany,G02,NA,NA,NA,NA
silence,278650,279046,396,Germany,G02,NA,NA,NA,NA
silence,280709,280970,261,Germany,G02,NA,NA,NA,NA
silence,283510,293940,10430,Germany,G02,NA,NA,NA,NA
silence,295300,296000,700,Germany,G02,NA,NA,NA,NA
silence,300329,301130,801,Germany,G02,NA,NA,NA,NA
silence,306610,306834,224,Germany,G02,NA,NA,NA,NA
silence,309320,309921,601,Germany,G02,NA,NA,NA,NA
silence,312181,313020,839,Germany,G02,NA,NA,NA,NA
silence,313490,315460,1970,Germany,G02,NA,NA,NA,NA
silence,316160,316300,140,Germany,G02,NA,NA,NA,NA
silence,319590,319690,100,Germany,G02,NA,NA,NA,NA
silence,321680,321990,310,Germany,G02,NA,NA,NA,NA
silence,329300,330012,712,Germany,G02,NA,NA,NA,NA
silence,335130,336152,1022,Germany,G02,NA,NA,NA,NA
silence,344475,344710,235,Germany,G02,NA,NA,NA,NA
silence,346970,348430,1460,Germany,G02,NA,NA,NA,NA
silence,364310,364530,220,Germany,G02,NA,NA,NA,NA
silence,366960,368010,1050,Germany,G02,NA,NA,NA,NA
silence,369310,369490,180,Germany,G02,NA,NA,NA,NA
silence,371310,371520,210,Germany,G02,NA,NA,NA,NA
mother_gesture,375022,375872,850,Germany,G02,NA,NA,NA,NA
silence,379190,379628,438,Germany,G02,NA,NA,NA,NA
silence,385050,388040,2990,Germany,G02,NA,NA,NA,NA
silence,389110,389400,290,Germany,G02,NA,NA,NA,NA
silence,392360,393007,647,Germany,G02,NA,NA,NA,NA
silence,395375,395950,575,Germany,G02,NA,NA,NA,NA
mother_gesture,399625,400884,1259,Germany,G02,NA,NA,NA,NA
silence,401496,403580,2084,Germany,G02,NA,NA,NA,NA
silence,404380,404870,490,Germany,G02,NA,NA,NA,NA
mother_gesture,407093,408286,1193,Germany,G02,NA,NA,NA,NA
silence,408175,409380,1205,Germany,G02,NA,NA,NA,NA
silence,420160,424110,3950,Germany,G02,NA,NA,NA,NA
silence,432020,432110,90,Germany,G02,NA,NA,NA,NA
silence,432890,432896,6,Germany,G02,NA,NA,NA,NA
silence,434881,435910,1029,Germany,G02,NA,NA,NA,NA
silence,436450,436670,220,Germany,G02,NA,NA,NA,NA
child_gesture,437658,439304,1646,Germany,G02,NA,NA,NA,NA
silence,439670,439686,16,Germany,G02,NA,NA,NA,NA
silence,441696,442030,334,Germany,G02,NA,NA,NA,NA
child_gesture,442451,444122,1671,Germany,G02,NA,NA,NA,NA
silence,444260,444333,73,Germany,G02,NA,NA,NA,NA
silence,445790,446460,670,Germany,G02,NA,NA,NA,NA
silence,447400,447717,317,Germany,G02,NA,NA,NA,NA
silence,455880,461050,5170,Germany,G02,NA,NA,NA,NA
silence,463660,463840,180,Germany,G02,NA,NA,NA,NA
child_gesture,465504,467668,2164,Germany,G02,NA,NA,NA,NA
child_gesture,468933,470446,1513,Germany,G02,NA,NA,NA,NA
silence,470450,470510,60,Germany,G02,NA,NA,NA,NA
silence,472950,478380,5430,Germany,G02,NA,NA,NA,NA
silence,480890,481550,660,Germany,G02,NA,NA,NA,NA
father_gesture,490483,491633,1150,Germany,G02,NA,NA,NA,NA
silence,492280,496570,4290,Germany,G02,NA,NA,NA,NA
silence,498440,504830,6390,Germany,G02,NA,NA,NA,NA
silence,507730,507757,27,Germany,G02,NA,NA,NA,NA
silence,512070,512110,40,Germany,G02,NA,NA,NA,NA
silence,522285,523120,835,Germany,G02,NA,NA,NA,NA
silence,524030,540710,16680,Germany,G02,NA,NA,NA,NA
silence,541880,542120,240,Germany,G02,NA,NA,NA,NA
silence,543140,545330,2190,Germany,G02,NA,NA,NA,NA
silence,545840,550600,4760,Germany,G02,NA,NA,NA,NA
silence,551971,552950,979,Germany,G02,NA,NA,NA,NA
silence,554730,556577,1847,Germany,G02,NA,NA,NA,NA
silence,558150,558200,50,Germany,G02,NA,NA,NA,NA
silence,561210,562263,1053,Germany,G02,NA,NA,NA,NA
silence,564630,565330,700,Germany,G02,NA,NA,NA,NA
silence,566184,566270,86,Germany,G02,NA,NA,NA,NA
silence,569580,569735,155,Germany,G02,NA,NA,NA,NA
mother_gesture,570173,574166,3993,Germany,G02,NA,NA,NA,NA
silence,575667,575790,123,Germany,G02,NA,NA,NA,NA
silence,576700,586950,10250,Germany,G02,NA,NA,NA,NA
silence,596555,597780,1225,Germany,G02,NA,NA,NA,NA
father,1871,2371,500,Germany,G03,c,1,1,a
mother,2581,3544,963,Germany,G03,b,1,2,a
father,3211,3801,590,Germany,G03,o,1,3,a
mother,5511,12591,7080,Germany,G03,b,1,4,a
mother,14631,15151,520,Germany,G03,b,2,1,a
child,18725,20498,1773,Germany,G03,f,3,1,a
father,20621,21271,650,Germany,G03,c,3,2,q
mother,21441,23841,2400,Germany,G03,c,3,3,a
father,23971,26521,2550,Germany,G03,c,3,4,a
mother,27081,30581,3500,Germany,G03,b,3,5,a
father,30641,31221,580,Germany,G03,c,3,6,q
mother,31031,31731,700,Germany,G03,b,3,7,a
father,31601,32481,880,Germany,G03,c,3,8,q
child,33014,36372,3358,Germany,G03,b,3,9,a
father,36521,38181,1660,Germany,G03,c,4,1,q
child,39283,40841,1558,Germany,G03,f,4,2,q
father,40711,42121,1410,Germany,G03,c,4,3,a
mother,40761,41381,620,Germany,G03,f,4,4,a
mother,41951,42531,580,Germany,G03,f,4,5,a
mother,44081,47211,3130,Germany,G03,c,5,1,q
mother,49891,50491,600,Germany,G03,c,5,2,i
child,52756,54146,1390,Germany,G03,m,5,3,a
mother,54771,55721,950,Germany,G03,c,5,4,q
mother,57901,59171,1270,Germany,G03,c,6,1,a
father,59451,61141,1690,Germany,G03,c,7,1,q
mother,60931,62661,1730,Germany,G03,b,7,2,q
father,63361,64411,1050,Germany,G03,c,7,3,q
mother,64721,67871,3150,Germany,G03,b,7,4,a
child,64941,68777,3836,Germany,G03,f,7,5,a
father,68911,69641,730,Germany,G03,c,7,6,q
child,69709,70162,453,Germany,G03,f,7,7,a
father,70171,74401,4230,Germany,G03,c,7,8,a
mother,74481,74861,380,Germany,G03,f,7,9,q
father,74981,75441,460,Germany,G03,m,7,10,a
mother,75771,76171,400,Germany,G03,f,7,11,a
father,79911,82901,2990,Germany,G03,c,7,12,a
mother,83761,84381,620,Germany,G03,f,7,13,a
father,84251,85331,1080,Germany,G03,c,7,14,a
mother,85211,86601,1390,Germany,G03,f,7,15,a
child,87488,87925,437,Germany,G03,b,8,1,a
mother,89321,89821,500,Germany,G03,c,8,2,q
child,90677,91162,485,Germany,G03,m,8,3,a
father,94281,96611,2330,Germany,G03,c,9,1,q
child,96693,97251,558,Germany,G03,f,9,2,a
father,98221,100851,2630,Germany,G03,c,9,3,q
child,103546,106141,2595,Germany,G03,f,9,4,a
father,104701,106941,2240,Germany,G03,c,9,5,q
child,107035,109932,2897,Germany,G03,f,9,6,a
mother,110421,111071,650,Germany,G03,c,9,7,a
father,110771,111421,650,Germany,G03,c,9,8,q
mother,111301,115131,3830,Germany,G03,b,9,9,q
father,114561,115501,940,Germany,G03,m,9,10,q
mother,115571,116731,1160,Germany,G03,f,9,11,q
father,117331,118171,840,Germany,G03,m,9,12,a
mother,117901,122881,4980,Germany,G03,c,9,13,a
father,122591,125671,3080,Germany,G03,c,9,14,a
child,124925,128283,3358,Germany,G03,b,9,15,a
father,129121,130770,1649,Germany,G03,c,9,16,a
mother,131311,132391,1080,Germany,G03,c,9,17,q
child,133246,133893,647,Germany,G03,m,9,18,a
mother,134261,135491,1230,Germany,G03,c,9,19,q
child,135535,136175,640,Germany,G03,m,9,20,a
mother,136191,136501,310,Germany,G03,c,9,21,q
mother,136941,138521,1580,Germany,G03,c,9,22,q
child,141651,143709,2058,Germany,G03,m,9,23,a
mother,144021,147991,3970,Germany,G03,c,10,1,a
mother,150361,152361,2000,Germany,G03,c,10,2,q
child,152593,153298,705,Germany,G03,m,10,3,a
mother,153841,156761,2920,Germany,G03,c,11,1,a
father,156461,158211,1750,Germany,G03,m,12,1,q
mother,159045,162411,3366,Germany,G03,f,12,2,a
father,161231,162921,1690,Germany,G03,m,12,3,q
child,164956,166835,1879,Germany,G03,b,12,4,q
mother,166131,171831,5700,Germany,G03,f,12,5,a
father,168781,170491,1710,Germany,G03,m,12,6,a
father,171831,172381,550,Germany,G03,m,12,7,a
mother,174871,178441,3570,Germany,G03,f,12,8,a
father,177621,178551,930,Germany,G03,m,12,9,q
mother,178571,182151,3580,Germany,G03,f,12,10,a
father,182371,183081,710,Germany,G03,m,12,11,a
child,186446,189225,2779,Germany,G03,b,13,1,q
mother,189241,192401,3160,Germany,G03,c,13,2,q
child,191246,191625,379,Germany,G03,m,13,3,a
child,192425,193235,810,Germany,G03,m,13,4,a
mother,193251,194101,850,Germany,G03,c,13,5,a
child,196404,198988,2584,Germany,G03,m,13,6,a
mother,205991,208331,2340,Germany,G03,c,13,7,a
mother,213331,214421,1090,Germany,G03,c,13,8,q
child,215162,215972,810,Germany,G03,m,13,9,a
mother,218991,221401,2410,Germany,G03,c,13,10,a
father,243561,245261,1700,Germany,G03,c,14,1,a
child,245541,246783,1242,Germany,G03,f,14,2,a
father,246491,247511,1020,Germany,G03,c,14,3,a
father,249001,249851,850,Germany,G03,c,14,4,q
child,250035,250504,469,Germany,G03,f,14,5,a
father,250631,251081,450,Germany,G03,c,14,6,q
child,251593,253562,1969,Germany,G03,b,14,7,a
mother,248401,250511,2110,Germany,G03,c,15,1,a
father,253591,254581,990,Germany,G03,c,16,1,q
child,255262,255919,657,Germany,G03,f,16,2,a
mother,255461,258371,2910,Germany,G03,c,16,3,q
father,257561,258541,980,Germany,G03,b,16,4,a
child,260541,265972,5431,Germany,G03,f,16,5,a
mother,268911,269801,890,Germany,G03,b,16,6,a
child,270877,275541,4664,Germany,G03,b,16,7,a
child,277472,281677,4205,Germany,G03,b,16,8,a
child,283219,285430,2211,Germany,G03,b,16,9,a
mother,285381,286381,1000,Germany,G03,c,16,10,q
father,275711,276771,1060,Germany,G03,m,17,1,a
mother,277251,278391,1140,Germany,G03,f,17,2,a
child,304662,313325,8663,Germany,G03,m,18,1,q
mother,314841,320091,5250,Germany,G03,c,18,2,a
child,320951,321735,784,Germany,G03,m,18,3,q
father,321891,322871,980,Germany,G03,c,18,4,a
mother,323191,323911,720,Germany,G03,b,18,5,a
child,323956,325783,1827,Germany,G03,f,18,6,q
mother,326451,327591,1140,Germany,G03,c,18,7,a
father,327371,328061,690,Germany,G03,c,18,8,a
mother,328371,330041,1670,Germany,G03,c,18,9,q
child,335746,337977,2231,Germany,G03,b,18,10,q
mother,337881,342511,4630,Germany,G03,c,18,11,a
child,343614,346872,3258,Germany,G03,b,18,12,q
mother,346821,347491,670,Germany,G03,c,18,13,a
child,347783,348688,905,Germany,G03,b,18,14,q
father,351411,352411,1000,Germany,G03,c,18,15,a
child,354809,356493,1684,Germany,G03,f,18,16,q
father,357001,358081,1080,Germany,G03,c,18,17,a
mother,357361,358911,1550,Germany,G03,c,18,18,a
child,360625,363188,2563,Germany,G03,b,18,19,q
father,363441,364401,960,Germany,G03,c,18,20,a
mother,330521,333808,3287,Germany,G03,c,19,1,a
mother,364891,365611,720,Germany,G03,c,20,1,i
child,376751,383862,7111,Germany,G03,m,20,2,a
mother,394991,397261,2270,Germany,G03,f,20,3,q
father,399161,399781,620,Germany,G03,m,20,4,a
father,402971,408971,6000,Germany,G03,m,20,5,a
father,412731,414081,1350,Germany,G03,m,21,1,a
mother,415571,416511,940,Germany,G03,f,21,2,q
father,417081,417621,540,Germany,G03,m,21,3,q
mother,417461,418431,970,Germany,G03,f,21,4,q
father,420161,420571,410,Germany,G03,m,21,5,q
mother,420591,421121,530,Germany,G03,f,21,6,a
father,421861,427291,5430,Germany,G03,m,21,7,a
child,436156,443930,7774,Germany,G03,f,22,1,q
father,443911,444641,730,Germany,G03,c,22,2,a
child,446335,449204,2869,Germany,G03,f,22,3,a
father,448731,449191,460,Germany,G03,c,22,4,q
mother,450641,452311,1670,Germany,G03,c,22,5,a
child,453767,456946,3179,Germany,G03,b,22,6,a
child,461009,461998,989,Germany,G03,f,23,1,a
child,464056,466493,2437,Germany,G03,b,23,2,a
child,469009,471051,2042,Germany,G03,m,23,3,q
mother,470901,472331,1430,Germany,G03,c,23,4,a
child,472393,475525,3132,Germany,G03,b,23,5,a
mother,475071,475741,670,Germany,G03,c,23,6,a
mother,466751,468721,1970,Germany,G03,c,24,1,q
mother,476121,476981,860,Germany,G03,c,25,1,i
child,478041,479214,1173,Germany,G03,m,25,2,a
mother,478901,480201,1300,Germany,G03,c,25,3,a
father,480021,481141,1120,Germany,G03,c,26,1,q
child,482477,483188,711,Germany,G03,f,26,2,a
father,483101,483951,850,Germany,G03,c,26,3,q
father,487901,488761,860,Germany,G03,c,26,4,q
mother,490061,491501,1440,Germany,G03,b,26,5,a
mother,492721,495221,2500,Germany,G03,f,26,6,a
father,495801,496381,580,Germany,G03,m,26,7,a
mother,496811,503771,6960,Germany,G03,b,26,8,a
child,511693,513977,2284,Germany,G03,b,26,9,a
mother,513701,515781,2080,Germany,G03,m,26,10,a
child,516288,518951,2663,Germany,G03,m,26,11,q
mother,519361,521751,2390,Germany,G03,c,26,12,a
child,522056,529256,7200,Germany,G03,m,26,13,q
mother,529241,529701,460,Germany,G03,c,26,14,a
child,530114,531309,1195,Germany,G03,m,26,15,q
mother,532131,536221,4090,Germany,G03,c,26,16,a
child,541367,543993,2626,Germany,G03,m,26,17,q
mother,545521,547621,2100,Germany,G03,c,26,18,a
mother,550281,552581,2300,Germany,G03,c,26,19,a
mother,553051,557581,4530,Germany,G03,c,27,1,q
child,557519,558246,727,Germany,G03,m,27,2,a
mother,558761,559871,1110,Germany,G03,c,27,3,q
child,560688,561283,595,Germany,G03,m,27,4,a
mother,561241,562311,1070,Germany,G03,c,27,5,a
child,561688,562388,700,Germany,G03,m,27,6,a
mother,562411,563131,720,Germany,G03,c,27,7,q
child,563141,563909,768,Germany,G03,m,27,8,a
mother,563401,564531,1130,Germany,G03,c,27,9,a
child,565514,566798,1284,Germany,G03,m,27,10,a
mother,565841,567001,1160,Germany,G03,c,27,11,q
child,567519,568219,700,Germany,G03,m,27,12,a
mother,568731,569851,1120,Germany,G03,c,27,13,q
child,570877,575130,4253,Germany,G03,m,27,14,a
mother,574661,575991,1330,Germany,G03,c,27,15,a
mother,576961,581591,4630,Germany,G03,c,28,1,q
child,580435,581272,837,Germany,G03,m,28,2,a
child,581641,582441,800,Germany,G03,m,28,3,a
mother,582771,583911,1140,Germany,G03,c,28,4,a
child,583630,586167,2537,Germany,G03,m,28,5,a
mother,585641,586891,1250,Germany,G03,c,28,6,i
mother,588421,589261,840,Germany,G03,c,28,7,a
mother,594071,595721,1650,Germany,G03,c,28,8,a
child,599030,599546,516,Germany,G03,m,28,9,q
child,239188,241835,2647,Germany,G03,o,30,1,a
child_gesture,413,1425,1012,Germany,G03,NA,NA,NA,NA
silence,1856,1871,15,Germany,G03,NA,NA,NA,NA
silence,2371,2581,210,Germany,G03,NA,NA,NA,NA
silence,3801,5511,1710,Germany,G03,NA,NA,NA,NA
silence,12591,14631,2040,Germany,G03,NA,NA,NA,NA
silence,15151,18725,3574,Germany,G03,NA,NA,NA,NA
child_gesture,18725,19609,884,Germany,G03,NA,NA,NA,NA
silence,20498,20621,123,Germany,G03,NA,NA,NA,NA
silence,21271,21441,170,Germany,G03,NA,NA,NA,NA
silence,23841,23971,130,Germany,G03,NA,NA,NA,NA
silence,26521,27081,560,Germany,G03,NA,NA,NA,NA
silence,30581,30641,60,Germany,G03,NA,NA,NA,NA
silence,32481,33014,533,Germany,G03,NA,NA,NA,NA
child_gesture,33737,34741,1004,Germany,G03,NA,NA,NA,NA
silence,36372,36521,149,Germany,G03,NA,NA,NA,NA
silence,38181,39283,1102,Germany,G03,NA,NA,NA,NA
silence,42531,44081,1550,Germany,G03,NA,NA,NA,NA
silence,47211,49891,2680,Germany,G03,NA,NA,NA,NA
silence,50491,52756,2265,Germany,G03,NA,NA,NA,NA
silence,54146,54771,625,Germany,G03,NA,NA,NA,NA
silence,55721,57901,2180,Germany,G03,NA,NA,NA,NA
silence,59171,59451,280,Germany,G03,NA,NA,NA,NA
silence,62661,63361,700,Germany,G03,NA,NA,NA,NA
silence,64411,64721,310,Germany,G03,NA,NA,NA,NA
silence,68777,68911,134,Germany,G03,NA,NA,NA,NA
silence,69641,69709,68,Germany,G03,NA,NA,NA,NA
silence,70162,70171,9,Germany,G03,NA,NA,NA,NA
silence,74401,74481,80,Germany,G03,NA,NA,NA,NA
silence,74861,74981,120,Germany,G03,NA,NA,NA,NA
silence,75441,75771,330,Germany,G03,NA,NA,NA,NA
silence,76171,79911,3740,Germany,G03,NA,NA,NA,NA
silence,82901,83761,860,Germany,G03,NA,NA,NA,NA
child_gesture,86006,86784,778,Germany,G03,NA,NA,NA,NA
silence,86601,87488,887,Germany,G03,NA,NA,NA,NA
silence,87925,89321,1396,Germany,G03,NA,NA,NA,NA
silence,89821,90677,856,Germany,G03,NA,NA,NA,NA
silence,91162,94281,3119,Germany,G03,NA,NA,NA,NA
silence,96611,96693,82,Germany,G03,NA,NA,NA,NA
silence,97251,98221,970,Germany,G03,NA,NA,NA,NA
silence,100851,103546,2695,Germany,G03,NA,NA,NA,NA
silence,106941,107035,94,Germany,G03,NA,NA,NA,NA
silence,109932,110421,489,Germany,G03,NA,NA,NA,NA
silence,115501,115571,70,Germany,G03,NA,NA,NA,NA
silence,116731,117331,600,Germany,G03,NA,NA,NA,NA
silence,128283,129121,838,Germany,G03,NA,NA,NA,NA
silence,130770,131311,541,Germany,G03,NA,NA,NA,NA
silence,132391,133246,855,Germany,G03,NA,NA,NA,NA
silence,133893,134261,368,Germany,G03,NA,NA,NA,NA
silence,135491,135535,44,Germany,G03,NA,NA,NA,NA
silence,136175,136191,16,Germany,G03,NA,NA,NA,NA
silence,136501,136941,440,Germany,G03,NA,NA,NA,NA
silence,138521,141651,3130,Germany,G03,NA,NA,NA,NA
silence,143709,144021,312,Germany,G03,NA,NA,NA,NA
silence,147991,150361,2370,Germany,G03,NA,NA,NA,NA
silence,152361,152593,232,Germany,G03,NA,NA,NA,NA
silence,153298,153841,543,Germany,G03,NA,NA,NA,NA
mother_gesture,156010,156426,416,Germany,G03,NA,NA,NA,NA
silence,158211,159045,834,Germany,G03,NA,NA,NA,NA
silence,162921,164956,2035,Germany,G03,NA,NA,NA,NA
silence,172381,174871,2490,Germany,G03,NA,NA,NA,NA
silence,178551,178571,20,Germany,G03,NA,NA,NA,NA
mother_gesture,179072,179283,211,Germany,G03,NA,NA,NA,NA
silence,182151,182371,220,Germany,G03,NA,NA,NA,NA
silence,183081,186446,3365,Germany,G03,NA,NA,NA,NA
silence,189225,189241,16,Germany,G03,NA,NA,NA,NA
mother_gesture,189964,190269,305,Germany,G03,NA,NA,NA,NA
silence,192401,192425,24,Germany,G03,NA,NA,NA,NA
silence,193235,193251,16,Germany,G03,NA,NA,NA,NA
silence,194101,196404,2303,Germany,G03,NA,NA,NA,NA
silence,198988,205991,7003,Germany,G03,NA,NA,NA,NA
silence,208331,213331,5000,Germany,G03,NA,NA,NA,NA
silence,214421,215162,741,Germany,G03,NA,NA,NA,NA
silence,215972,218991,3019,Germany,G03,NA,NA,NA,NA
silence,221401,239188,17787,Germany,G03,NA,NA,NA,NA
silence,241835,243561,1726,Germany,G03,NA,NA,NA,NA
silence,245261,245541,280,Germany,G03,NA,NA,NA,NA
silence,247511,248401,890,Germany,G03,NA,NA,NA,NA
silence,250511,250631,120,Germany,G03,NA,NA,NA,NA
silence,251081,251593,512,Germany,G03,NA,NA,NA,NA
silence,253562,253591,29,Germany,G03,NA,NA,NA,NA
silence,254581,255262,681,Germany,G03,NA,NA,NA,NA
silence,258541,260541,2000,Germany,G03,NA,NA,NA,NA
silence,265972,268911,2939,Germany,G03,NA,NA,NA,NA
silence,269801,270877,1076,Germany,G03,NA,NA,NA,NA
silence,275541,275711,170,Germany,G03,NA,NA,NA,NA
silence,276771,277251,480,Germany,G03,NA,NA,NA,NA
silence,281677,283219,1542,Germany,G03,NA,NA,NA,NA
silence,286381,304662,18281,Germany,G03,NA,NA,NA,NA
silence,313325,314841,1516,Germany,G03,NA,NA,NA,NA
silence,320091,320951,860,Germany,G03,NA,NA,NA,NA
silence,321735,321891,156,Germany,G03,NA,NA,NA,NA
silence,322871,323191,320,Germany,G03,NA,NA,NA,NA
silence,323911,323956,45,Germany,G03,NA,NA,NA,NA
silence,325783,326451,668,Germany,G03,NA,NA,NA,NA
mother_gesture,326460,327355,895,Germany,G03,NA,NA,NA,NA
silence,328061,328371,310,Germany,G03,NA,NA,NA,NA
silence,330041,330521,480,Germany,G03,NA,NA,NA,NA
silence,333808,335746,1938,Germany,G03,NA,NA,NA,NA
child_gesture,336500,337269,769,Germany,G03,NA,NA,NA,NA
mother_gesture,339218,340039,821,Germany,G03,NA,NA,NA,NA
child_gesture,341173,342141,968,Germany,G03,NA,NA,NA,NA
silence,342511,343614,1103,Germany,G03,NA,NA,NA,NA
silence,347491,347783,292,Germany,G03,NA,NA,NA,NA
silence,348688,351411,2723,Germany,G03,NA,NA,NA,NA
silence,352411,354809,2398,Germany,G03,NA,NA,NA,NA
child_gesture,355149,355662,513,Germany,G03,NA,NA,NA,NA
silence,356493,357001,508,Germany,G03,NA,NA,NA,NA
silence,358911,360625,1714,Germany,G03,NA,NA,NA,NA
child_gesture,361739,362022,283,Germany,G03,NA,NA,NA,NA
silence,363188,363441,253,Germany,G03,NA,NA,NA,NA
silence,364401,364891,490,Germany,G03,NA,NA,NA,NA
silence,365611,376751,11140,Germany,G03,NA,NA,NA,NA
silence,383862,394991,11129,Germany,G03,NA,NA,NA,NA
silence,397261,399161,1900,Germany,G03,NA,NA,NA,NA
silence,399781,402971,3190,Germany,G03,NA,NA,NA,NA
silence,408971,412731,3760,Germany,G03,NA,NA,NA,NA
silence,414081,415571,1490,Germany,G03,NA,NA,NA,NA
silence,416511,417081,570,Germany,G03,NA,NA,NA,NA
silence,418431,420161,1730,Germany,G03,NA,NA,NA,NA
silence,420571,420591,20,Germany,G03,NA,NA,NA,NA
silence,421121,421861,740,Germany,G03,NA,NA,NA,NA
silence,427291,436156,8865,Germany,G03,NA,NA,NA,NA
child_gesture,442812,443590,778,Germany,G03,NA,NA,NA,NA
father_gesture,443627,444155,528,Germany,G03,NA,NA,NA,NA
silence,444641,446335,1694,Germany,G03,NA,NA,NA,NA
silence,449204,450641,1437,Germany,G03,NA,NA,NA,NA
silence,452311,453767,1456,Germany,G03,NA,NA,NA,NA
silence,456946,461009,4063,Germany,G03,NA,NA,NA,NA
child_gesture,460141,461500,1359,Germany,G03,NA,NA,NA,NA
silence,461998,464056,2058,Germany,G03,NA,NA,NA,NA
silence,466493,466751,258,Germany,G03,NA,NA,NA,NA
silence,468721,469009,288,Germany,G03,NA,NA,NA,NA
child_gesture,469670,470710,1040,Germany,G03,NA,NA,NA,NA
silence,472331,472393,62,Germany,G03,NA,NA,NA,NA
silence,475741,476121,380,Germany,G03,NA,NA,NA,NA
silence,476981,478041,1060,Germany,G03,NA,NA,NA,NA
silence,481141,482477,1336,Germany,G03,NA,NA,NA,NA
silence,483951,487901,3950,Germany,G03,NA,NA,NA,NA
silence,488761,490061,1300,Germany,G03,NA,NA,NA,NA
silence,491501,492721,1220,Germany,G03,NA,NA,NA,NA
silence,495221,495801,580,Germany,G03,NA,NA,NA,NA
silence,496381,496811,430,Germany,G03,NA,NA,NA,NA
silence,503771,511693,7922,Germany,G03,NA,NA,NA,NA
silence,515781,516288,507,Germany,G03,NA,NA,NA,NA
silence,518951,519361,410,Germany,G03,NA,NA,NA,NA
silence,521751,522056,305,Germany,G03,NA,NA,NA,NA
silence,529701,530114,413,Germany,G03,NA,NA,NA,NA
silence,531309,532131,822,Germany,G03,NA,NA,NA,NA
silence,536221,541367,5146,Germany,G03,NA,NA,NA,NA
silence,543993,545521,1528,Germany,G03,NA,NA,NA,NA
silence,547621,550281,2660,Germany,G03,NA,NA,NA,NA
silence,552581,553051,470,Germany,G03,NA,NA,NA,NA
silence,558246,558761,515,Germany,G03,NA,NA,NA,NA
silence,559871,560688,817,Germany,G03,NA,NA,NA,NA
silence,562388,562411,23,Germany,G03,NA,NA,NA,NA
silence,563131,563141,10,Germany,G03,NA,NA,NA,NA
silence,564531,565514,983,Germany,G03,NA,NA,NA,NA
silence,567001,567519,518,Germany,G03,NA,NA,NA,NA
silence,568219,568731,512,Germany,G03,NA,NA,NA,NA
silence,569851,570877,1026,Germany,G03,NA,NA,NA,NA
silence,575991,576961,970,Germany,G03,NA,NA,NA,NA
mother_gesture,577443,578310,867,Germany,G03,NA,NA,NA,NA
silence,581591,581641,50,Germany,G03,NA,NA,NA,NA
silence,582441,582771,330,Germany,G03,NA,NA,NA,NA
silence,586891,588421,1530,Germany,G03,NA,NA,NA,NA
silence,589261,594071,4810,Germany,G03,NA,NA,NA,NA
silence,595721,599030,3309,Germany,G03,NA,NA,NA,NA
mother,180,900,720,Germany,G04,b,1,1,a
child,830,3130,2300,Germany,G04,m,2,1,a
mother,1800,2500,700,Germany,G04,c,3,1,q
child,3240,4080,840,Germany,G04,m,3,2,a
mother,4050,5430,1380,Germany,G04,c,3,3,a
mother,15010,15990,980,Germany,G04,c,3,4,a
child,7620,11360,3740,Germany,G04,b,4,1,a
mother,17690,18980,1290,Germany,G04,f,5,1,q
mother,20380,20900,520,Germany,G04,f,5,2,a
father,22550,25260,2710,Germany,G04,m,6,1,a
mother,25260,26790,1530,Germany,G04,f,6,2,q
father,26920,31720,4800,Germany,G04,m,6,3,a
mother,31740,35500,3760,Germany,G04,f,6,4,q
father,35730,37630,1900,Germany,G04,m,6,5,a
mother,37770,40930,3160,Germany,G04,f,6,6,q
father,41270,42050,780,Germany,G04,m,6,7,a
mother,42860,43750,890,Germany,G04,c,7,1,q
child,44089,44537,448,Germany,G04,m,7,2,a
child,51570,58260,6690,Germany,G04,m,8,1,a
mother,58150,63170,5020,Germany,G04,c,8,2,a
mother,63220,65990,2770,Germany,G04,c,9,1,q
child,67190,70393,3203,Germany,G04,b,9,2,a
mother,70550,71410,860,Germany,G04,c,9,3,q
child,72170,74270,2100,Germany,G04,m,9,4,a
mother,73800,76110,2310,Germany,G04,c,9,5,q
child,76300,80960,4660,Germany,G04,m,9,6,a
mother,82360,83140,780,Germany,G04,c,9,7,a
mother,88570,90050,1480,Germany,G04,c,10,1,q
child,90480,92920,2440,Germany,G04,m,10,2,a
mother,92940,93940,1000,Germany,G04,c,10,3,a
mother,101420,103730,2310,Germany,G04,c,10,4,q
child,104930,105930,1000,Germany,G04,m,10,5,a
mother,105950,106810,860,Germany,G04,c,10,6,q
child,107650,108310,660,Germany,G04,m,10,7,a
mother,111640,112360,720,Germany,G04,f,11,1,q
father,112360,113290,930,Germany,G04,m,11,2,a
mother,126680,128780,2100,Germany,G04,c,12,1,q
child,128960,131960,3000,Germany,G04,m,12,2,a
mother,131150,131760,610,Germany,G04,c,12,3,q
mother,133670,140300,6630,Germany,G04,c,12,4,q
child,141570,143620,2050,Germany,G04,b,12,5,q
mother,144390,153420,9030,Germany,G04,c,12,6,a
mother,163680,164520,840,Germany,G04,c,13,1,a
mother,183900,185440,1540,Germany,G04,f,14,1,q
father,185450,187110,1660,Germany,G04,m,14,2,a
mother,203170,205410,2240,Germany,G04,c,15,1,q
child,206190,208460,2270,Germany,G04,m,15,2,a
mother,208680,214240,5560,Germany,G04,c,15,3,a
child,214240,216900,2660,Germany,G04,m,15,4,a
mother,216990,218110,1120,Germany,G04,c,15,5,q
child,219010,219790,780,Germany,G04,m,15,6,a
father,219400,220700,1300,Germany,G04,m,15,7,q
mother,221110,226930,5820,Germany,G04,f,15,8,a
father,228040,228640,600,Germany,G04,m,15,9,a
mother,228350,230840,2490,Germany,G04,c,15,10,a
child,231500,232560,1060,Germany,G04,m,15,11,q
mother,232400,233300,900,Germany,G04,c,15,12,a
child,237600,242660,5060,Germany,G04,b,16,1,a
mother,242500,246340,3840,Germany,G04,c,16,2,q
child,246640,249550,2910,Germany,G04,m,16,3,a
mother,249220,251360,2140,Germany,G04,c,16,4,q
child,251630,252460,830,Germany,G04,m,16,5,a
mother,252620,253230,610,Germany,G04,c,16,6,a
child,257040,260350,3310,Germany,G04,m,17,1,a
mother,260870,262930,2060,Germany,G04,c,17,2,i
father,266110,267300,1190,Germany,G04,m,18,1,i
child,270950,273880,2930,Germany,G04,f,18,2,a
mother,278090,279670,1580,Germany,G04,f,18,3,q
father,281260,283250,1990,Germany,G04,m,18,4,a
mother,285910,286990,1080,Germany,G04,c,19,1,a
child,287530,294170,6640,Germany,G04,m,19,2,a
mother,293760,295554,1794,Germany,G04,c,19,3,q
child,296030,296740,710,Germany,G04,m,19,4,a
mother,296850,297560,710,Germany,G04,c,19,5,a
child,300570,302920,2350,Germany,G04,m,19,6,a
child,305420,306650,1230,Germany,G04,m,19,7,a
child,309350,313120,3770,Germany,G04,m,19,8,q
mother,312660,313430,770,Germany,G04,m,19,9,a
mother,316110,317200,1090,Germany,G04,c,19,10,q
child,317980,318950,970,Germany,G04,m,19,11,a
mother,322270,323350,1080,Germany,G04,c,19,12,a
child,325870,327060,1190,Germany,G04,m,19,13,a
mother,327140,328030,890,Germany,G04,c,19,14,q
child,328230,328950,720,Germany,G04,m,19,15,a
mother,330460,331850,1390,Germany,G04,c,19,16,q
child,332210,336704,4494,Germany,G04,m,19,17,a
mother,336740,337520,780,Germany,G04,c,19,18,q
child,337400,342620,5220,Germany,G04,m,19,19,a
child,345520,347740,2220,Germany,G04,m,19,20,a
mother,348140,349130,990,Germany,G04,c,19,21,q
child,349370,350130,760,Germany,G04,m,19,22,a
child,352400,353540,1140,Germany,G04,m,19,23,a
mother,354720,356760,2040,Germany,G04,c,19,24,q
child,357330,358130,800,Germany,G04,m,19,25,a
mother,357870,358980,1110,Germany,G04,c,19,26,q
child,359000,360440,1440,Germany,G04,m,19,27,a
mother,360460,361290,830,Germany,G04,c,19,28,q
child,361440,362220,780,Germany,G04,m,19,29,a
mother,362010,362490,480,Germany,G04,c,19,30,a
child,367630,369300,1670,Germany,G04,m,19,31,a
mother,369130,371050,1920,Germany,G04,c,19,32,a
child,372070,373880,1810,Germany,G04,m,19,33,a
mother,373970,375550,1580,Germany,G04,c,19,34,a
child,389430,390660,1230,Germany,G04,m,19,35,a
mother,390740,392160,1420,Germany,G04,c,19,36,a
mother,393840,395320,1480,Germany,G04,c,19,37,a
mother,396480,398160,1680,Germany,G04,c,19,38,a
mother,400100,401610,1510,Germany,G04,c,19,39,q
child,403150,404148,998,Germany,G04,m,19,40,a
child,406880,410590,3710,Germany,G04,m,19,41,a
child,413170,414750,1580,Germany,G04,m,19,42,a
mother,420680,421600,920,Germany,G04,c,20,1,a
father,422550,425020,2470,Germany,G04,c,20,2,q
child,427090,430900,3810,Germany,G04,m,21,1,a
mother,437780,438910,1130,Germany,G04,c,22,1,a
child,440600,443370,2770,Germany,G04,b,22,2,a
child,456810,459890,3080,Germany,G04,b,22,3,a
father,459160,460320,1160,Germany,G04,c,22,4,a
father,469920,470950,1030,Germany,G04,c,23,1,a
mother,484140,486470,2330,Germany,G04,f,23,2,a
father,486480,487120,640,Germany,G04,m,23,3,a
father,493570,494450,880,Germany,G04,m,23,4,a
father,507050,508561,1511,Germany,G04,m,24,1,q
mother,509920,511080,1160,Germany,G04,f,24,2,a
father,511660,512470,810,Germany,G04,m,24,3,a
mother,511690,512950,1260,Germany,G04,f,24,4,a
mother,514300,514920,620,Germany,G04,f,24,5,a
child,515880,518210,2330,Germany,G04,m,24,6,q
mother,518870,519730,860,Germany,G04,c,24,7,a
father,520140,521450,1310,Germany,G04,c,24,8,a
mother,520340,521460,1120,Germany,G04,c,24,9,q
child,521550,522570,1020,Germany,G04,m,24,10,a
mother,522900,523610,710,Germany,G04,c,24,11,q
child,523570,524630,1060,Germany,G04,m,24,12,a
mother,524430,525840,1410,Germany,G04,c,24,13,q
mother,531210,532400,1190,Germany,G04,c,25,1,i
child,539170,540960,1790,Germany,G04,m,26,1,a
mother,541940,543420,1480,Germany,G04,c,26,2,q
child,544360,553470,9110,Germany,G04,m,26,3,a
mother,553460,554090,630,Germany,G04,c,26,4,q
child,554400,555090,690,Germany,G04,m,26,5,q
mother,554970,555520,550,Germany,G04,c,26,6,a
mother,556340,559470,3130,Germany,G04,c,26,7,a
child,559987,561880,1893,Germany,G04,m,26,8,a
mother,561840,564760,2920,Germany,G04,c,26,9,q
child,565641,569109,3468,Germany,G04,m,26,10,a
mother,569030,573880,4850,Germany,G04,c,26,11,q
child,574672,583186,8514,Germany,G04,m,26,12,a
child,584411,585692,1281,Germany,G04,m,26,13,a
child,587790,589001,1211,Germany,G04,m,26,14,a
mother,588430,597180,8750,Germany,G04,c,26,15,a
child,592171,592570,399,Germany,G04,m,26,16,a
child,593835,594311,476,Germany,G04,m,26,17,a
child,597016,599490,2474,Germany,G04,b,26,18,a
mother,599180,601140,1960,Germany,G04,c,26,19,a
silence,3130,3240,110,Germany,G04,NA,NA,NA,NA
silence,5430,7620,2190,Germany,G04,NA,NA,NA,NA
silence,11360,15010,3650,Germany,G04,NA,NA,NA,NA
silence,15990,17690,1700,Germany,G04,NA,NA,NA,NA
silence,18980,20380,1400,Germany,G04,NA,NA,NA,NA
silence,20900,22550,1650,Germany,G04,NA,NA,NA,NA
silence,26790,26920,130,Germany,G04,NA,NA,NA,NA
silence,31720,31740,20,Germany,G04,NA,NA,NA,NA
silence,35500,35730,230,Germany,G04,NA,NA,NA,NA
silence,37630,37770,140,Germany,G04,NA,NA,NA,NA
silence,40930,41270,340,Germany,G04,NA,NA,NA,NA
silence,42050,42860,810,Germany,G04,NA,NA,NA,NA
silence,43750,44089,339,Germany,G04,NA,NA,NA,NA
silence,44537,51570,7033,Germany,G04,NA,NA,NA,NA
silence,63170,63220,50,Germany,G04,NA,NA,NA,NA
silence,65990,67190,1200,Germany,G04,NA,NA,NA,NA
silence,70393,70550,157,Germany,G04,NA,NA,NA,NA
silence,71410,72170,760,Germany,G04,NA,NA,NA,NA
silence,76110,76300,190,Germany,G04,NA,NA,NA,NA
silence,80960,82360,1400,Germany,G04,NA,NA,NA,NA
silence,83140,88570,5430,Germany,G04,NA,NA,NA,NA
silence,90050,90480,430,Germany,G04,NA,NA,NA,NA
silence,92920,92940,20,Germany,G04,NA,NA,NA,NA
silence,93940,101420,7480,Germany,G04,NA,NA,NA,NA
silence,103730,104930,1200,Germany,G04,NA,NA,NA,NA
silence,105930,105950,20,Germany,G04,NA,NA,NA,NA
silence,106810,107650,840,Germany,G04,NA,NA,NA,NA
silence,108310,111640,3330,Germany,G04,NA,NA,NA,NA
silence,113290,126680,13390,Germany,G04,NA,NA,NA,NA
silence,128780,128960,180,Germany,G04,NA,NA,NA,NA
silence,131960,133670,1710,Germany,G04,NA,NA,NA,NA
silence,140300,141570,1270,Germany,G04,NA,NA,NA,NA
silence,143620,144390,770,Germany,G04,NA,NA,NA,NA
silence,153420,163680,10260,Germany,G04,NA,NA,NA,NA
silence,164520,183900,19380,Germany,G04,NA,NA,NA,NA
silence,185440,185450,10,Germany,G04,NA,NA,NA,NA
silence,187110,203170,16060,Germany,G04,NA,NA,NA,NA
silence,205410,206190,780,Germany,G04,NA,NA,NA,NA
silence,208460,208680,220,Germany,G04,NA,NA,NA,NA
silence,216900,216990,90,Germany,G04,NA,NA,NA,NA
silence,218110,219010,900,Germany,G04,NA,NA,NA,NA
silence,220700,221110,410,Germany,G04,NA,NA,NA,NA
silence,226930,228040,1110,Germany,G04,NA,NA,NA,NA
silence,230840,231500,660,Germany,G04,NA,NA,NA,NA
silence,233300,237600,4300,Germany,G04,NA,NA,NA,NA
child_gesture,237612,242432,4820,Germany,G04,NA,NA,NA,NA
silence,246340,246640,300,Germany,G04,NA,NA,NA,NA
silence,251360,251630,270,Germany,G04,NA,NA,NA,NA
silence,252460,252620,160,Germany,G04,NA,NA,NA,NA
silence,253230,257040,3810,Germany,G04,NA,NA,NA,NA
silence,260350,260870,520,Germany,G04,NA,NA,NA,NA
silence,262930,266110,3180,Germany,G04,NA,NA,NA,NA
silence,267300,270950,3650,Germany,G04,NA,NA,NA,NA
child_gesture,272526,273453,927,Germany,G04,NA,NA,NA,NA
silence,273880,278090,4210,Germany,G04,NA,NA,NA,NA
silence,279670,281260,1590,Germany,G04,NA,NA,NA,NA
silence,283250,285910,2660,Germany,G04,NA,NA,NA,NA
silence,286990,287530,540,Germany,G04,NA,NA,NA,NA
child_gesture,290780,291314,534,Germany,G04,NA,NA,NA,NA
silence,295554,296030,476,Germany,G04,NA,NA,NA,NA
silence,296740,296850,110,Germany,G04,NA,NA,NA,NA
silence,297560,300570,3010,Germany,G04,NA,NA,NA,NA
silence,302920,305420,2500,Germany,G04,NA,NA,NA,NA
silence,306650,309350,2700,Germany,G04,NA,NA,NA,NA
child_gesture,311449,312918,1469,Germany,G04,NA,NA,NA,NA
silence,313430,316110,2680,Germany,G04,NA,NA,NA,NA
silence,317200,317980,780,Germany,G04,NA,NA,NA,NA
silence,318950,322270,3320,Germany,G04,NA,NA,NA,NA
silence,323350,325870,2520,Germany,G04,NA,NA,NA,NA
silence,327060,327140,80,Germany,G04,NA,NA,NA,NA
silence,328030,328230,200,Germany,G04,NA,NA,NA,NA
silence,328950,330460,1510,Germany,G04,NA,NA,NA,NA
silence,331850,332210,360,Germany,G04,NA,NA,NA,NA
child_gesture,332416,333615,1199,Germany,G04,NA,NA,NA,NA
silence,336704,336740,36,Germany,G04,NA,NA,NA,NA
silence,342620,345520,2900,Germany,G04,NA,NA,NA,NA
silence,347740,348140,400,Germany,G04,NA,NA,NA,NA
silence,349130,349370,240,Germany,G04,NA,NA,NA,NA
silence,350130,352400,2270,Germany,G04,NA,NA,NA,NA
silence,353540,354720,1180,Germany,G04,NA,NA,NA,NA
silence,356760,357330,570,Germany,G04,NA,NA,NA,NA
silence,358980,359000,20,Germany,G04,NA,NA,NA,NA
silence,360440,360460,20,Germany,G04,NA,NA,NA,NA
silence,361290,361440,150,Germany,G04,NA,NA,NA,NA
silence,362490,367630,5140,Germany,G04,NA,NA,NA,NA
silence,371050,372070,1020,Germany,G04,NA,NA,NA,NA
silence,373880,373970,90,Germany,G04,NA,NA,NA,NA
silence,375550,389430,13880,Germany,G04,NA,NA,NA,NA
silence,390660,390740,80,Germany,G04,NA,NA,NA,NA
silence,392160,393840,1680,Germany,G04,NA,NA,NA,NA
silence,395320,396480,1160,Germany,G04,NA,NA,NA,NA
silence,398160,400100,1940,Germany,G04,NA,NA,NA,NA
silence,401610,403150,1540,Germany,G04,NA,NA,NA,NA
silence,404148,406880,2732,Germany,G04,NA,NA,NA,NA
silence,410590,413170,2580,Germany,G04,NA,NA,NA,NA
silence,414750,420680,5930,Germany,G04,NA,NA,NA,NA
silence,421600,422550,950,Germany,G04,NA,NA,NA,NA
silence,425020,427090,2070,Germany,G04,NA,NA,NA,NA
silence,430900,437780,6880,Germany,G04,NA,NA,NA,NA
silence,438910,440600,1690,Germany,G04,NA,NA,NA,NA
silence,443370,456810,13440,Germany,G04,NA,NA,NA,NA
silence,460320,469920,9600,Germany,G04,NA,NA,NA,NA
silence,470950,484140,13190,Germany,G04,NA,NA,NA,NA
silence,486470,486480,10,Germany,G04,NA,NA,NA,NA
silence,487120,493570,6450,Germany,G04,NA,NA,NA,NA
silence,494450,507050,12600,Germany,G04,NA,NA,NA,NA
father_gesture,507783,508376,593,Germany,G04,NA,NA,NA,NA
silence,508561,509920,1359,Germany,G04,NA,NA,NA,NA
silence,511080,511660,580,Germany,G04,NA,NA,NA,NA
silence,512950,514300,1350,Germany,G04,NA,NA,NA,NA
silence,514920,515880,960,Germany,G04,NA,NA,NA,NA
silence,518210,518870,660,Germany,G04,NA,NA,NA,NA
silence,519730,520140,410,Germany,G04,NA,NA,NA,NA
silence,521460,521550,90,Germany,G04,NA,NA,NA,NA
silence,522570,522900,330,Germany,G04,NA,NA,NA,NA
silence,525840,531210,5370,Germany,G04,NA,NA,NA,NA
mother_gesture,531360,532570,1210,Germany,G04,NA,NA,NA,NA
silence,532400,539170,6770,Germany,G04,NA,NA,NA,NA
silence,540960,541940,980,Germany,G04,NA,NA,NA,NA
silence,543420,544360,940,Germany,G04,NA,NA,NA,NA
silence,554090,554400,310,Germany,G04,NA,NA,NA,NA
silence,555520,556340,820,Germany,G04,NA,NA,NA,NA
silence,559470,559987,517,Germany,G04,NA,NA,NA,NA
silence,564760,565641,881,Germany,G04,NA,NA,NA,NA
silence,573880,574672,792,Germany,G04,NA,NA,NA,NA
silence,583186,584411,1225,Germany,G04,NA,NA,NA,NA
silence,585692,587790,2098,Germany,G04,NA,NA,NA,NA
mother,397,978,581,Germany,G05,f,1,1,a
father,5127,6870,1743,Germany,G05,m,1,2,a
child,5451,8640,3189,Germany,G05,b,2,1,a
child,10302,13289,2987,Germany,G05,b,3,1,a
father,13951,15451,1500,Germany,G05,c,3,2,q
mother,14086,14870,784,Germany,G05,c,3,3,a
mother,15910,17248,1338,Germany,G05,c,3,4,q
child,17316,18154,838,Germany,G05,m,3,5,a
mother,17708,18877,1169,Germany,G05,c,3,6,q
child,18721,21991,3270,Germany,G05,b,4,1,a
father,22167,23721,1554,Germany,G05,c,4,2,q
child,22802,23437,635,Germany,G05,f,4,3,a
mother,24208,25072,864,Germany,G05,c,4,4,a
child,24383,25140,757,Germany,G05,b,4,5,a
father,24613,26924,2311,Germany,G05,c,4,6,q
child,27654,28478,824,Germany,G05,f,4,7,a
father,28410,29221,811,Germany,G05,c,4,8,q
child,29856,34208,4352,Germany,G05,m,4,9,a
mother,30005,32464,2459,Germany,G05,f,5,1,a
father,31856,34437,2581,Germany,G05,m,5,2,a
mother,46370,52586,6216,Germany,G05,c,6,1,a
mother,59356,60978,1622,Germany,G05,c,6,2,a
father,56397,59194,2797,Germany,G05,c,7,1,q
child,59262,59936,674,Germany,G05,f,7,2,a
father,60397,61221,824,Germany,G05,c,7,3,q
mother,61856,62613,757,Germany,G05,b,7,4,a
child,63410,64289,879,Germany,G05,b,7,5,a
father,64816,66654,1838,Germany,G05,c,7,6,q
child,67181,67991,810,Germany,G05,c,7,7,a
father,70329,72708,2379,Germany,G05,c,7,8,q
mother,72802,73897,1095,Germany,G05,b,7,9,a
father,73667,74708,1041,Germany,G05,b,7,10,a
mother,76235,77437,1202,Germany,G05,b,8,1,q
father,77640,78545,905,Germany,G05,m,8,2,a
child,79302,81248,1946,Germany,G05,m,8,3,a
mother,82694,84681,1987,Germany,G05,c,8,4,a
father,82829,83748,919,Germany,G05,c,8,5,a
child,82856,88748,5892,Germany,G05,b,8,6,a
mother,85627,86491,864,Germany,G05,c,8,7,a
father,89762,91086,1324,Germany,G05,c,8,8,a
child,91018,92721,1703,Germany,G05,f,8,9,a
child,93505,95613,2108,Germany,G05,f,8,10,a
father,95316,96086,770,Germany,G05,b,8,11,a
child,96262,97843,1581,Germany,G05,f,8,12,a
father,93100,93856,756,Germany,G05,c,9,1,q
father,96924,98329,1405,Germany,G05,c,9,2,q
child,98694,99410,716,Germany,G05,f,9,3,a
father,100127,101208,1081,Germany,G05,c,9,4,q
child,102072,109113,7041,Germany,G05,f,9,5,a
child,110113,112059,1946,Germany,G05,o,10,1,a
father,110937,112748,1811,Germany,G05,c,11,1,a
father,116086,120032,3946,Germany,G05,c,11,2,q
child,123248,124627,1379,Germany,G05,b,12,1,a
father,124302,125018,716,Germany,G05,c,12,2,a
father,132045,133437,1392,Germany,G05,o,13,1,a
child,136816,140167,3351,Germany,G05,b,14,1,a
child,142018,143397,1379,Germany,G05,b,14,2,a
mother,137991,138937,946,Germany,G05,f,15,1,q
father,139762,140735,973,Germany,G05,m,15,2,a
father,145437,146505,1068,Germany,G05,o,16,1,a
father,149802,151167,1365,Germany,G05,o,16,2,a
father,166154,168518,2364,Germany,G05,m,17,1,a
mother,170748,171424,676,Germany,G05,f,17,2,q
father,172370,192302,19932,Germany,G05,m,17,3,a
mother,192586,193235,649,Germany,G05,f,17,4,a
father,194910,204073,9163,Germany,G05,m,17,5,a
father,207356,208978,1622,Germany,G05,m,17,6,a
mother,211018,211694,676,Germany,G05,f,17,7,a
father,219843,226383,6540,Germany,G05,m,17,8,a
mother,219708,220667,959,Germany,G05,c,18,1,a
child,227748,231424,3676,Germany,G05,b,19,1,a
father,231856,232507,651,Germany,G05,c,19,2,q
mother,231924,232586,662,Germany,G05,c,19,3,q
child,232424,233951,1527,Germany,G05,b,19,4,a
father,234032,236654,2622,Germany,G05,c,19,5,a
child,235951,239262,3311,Germany,G05,b,19,6,a
father,237802,241721,3919,Germany,G05,c,19,7,q
child,241978,244613,2635,Germany,G05,f,19,8,a
father,243802,245073,1271,Germany,G05,c,19,9,q
child,246018,247194,1176,Germany,G05,o,19,10,a
father,246910,248221,1311,Germany,G05,o,19,11,a
child,248532,250708,2176,Germany,G05,o,19,12,a
father,251491,252897,1406,Germany,G05,c,19,13,i
father,255275,256194,919,Germany,G05,c,19,14,q
mother,256559,257586,1027,Germany,G05,c,19,15,a
father,258086,259991,1905,Germany,G05,c,19,16,i
child,259640,260464,824,Germany,G05,f,19,17,a
father,263208,267694,4486,Germany,G05,o,20,1,a
mother,266221,267748,1527,Germany,G05,f,21,1,q
father,268356,269410,1054,Germany,G05,m,21,2,q
mother,268951,269586,635,Germany,G05,f,21,3,a
father,269600,270113,513,Germany,G05,m,21,4,a
mother,270113,270708,595,Germany,G05,f,21,5,q
father,270627,271316,689,Germany,G05,m,21,6,a
child,271937,273154,1217,Germany,G05,f,21,7,i
father,272356,275816,3460,Germany,G05,c,21,8,q
father,281600,282464,864,Germany,G05,c,21,9,q
child,283316,284100,784,Germany,G05,f,21,10,a
father,284045,285937,1892,Germany,G05,b,21,11,q
child,289775,291654,1879,Germany,G05,m,21,12,a
mother,293410,295518,2108,Germany,G05,c,21,13,a
father,296113,297329,1216,Germany,G05,c,21,14,q
child,299113,299910,797,Germany,G05,f,21,15,a
father,300100,300789,689,Germany,G05,c,21,16,a
father,306343,307627,1284,Germany,G05,m,22,1,a
child,306775,311235,4460,Germany,G05,m,23,1,a
mother,312843,313654,811,Germany,G05,c,23,2,q
child,313802,315613,1811,Germany,G05,m,23,3,a
mother,316991,317897,906,Germany,G05,c,23,4,q
child,317843,320924,3081,Germany,G05,m,23,5,a
mother,320924,323437,2513,Germany,G05,c,23,6,a
father,322897,323586,689,Germany,G05,c,23,7,a
mother,323897,325789,1892,Germany,G05,c,23,8,a
child,325829,329721,3892,Germany,G05,b,23,9,a
father,331194,334991,3797,Germany,G05,c,23,10,a
father,341275,346410,5135,Germany,G05,c,23,11,q
mother,346154,346654,500,Germany,G05,c,23,12,a
mother,353343,354586,1243,Germany,G05,f,24,1,q
child,354005,356262,2257,Germany,G05,o,25,1,a
father,358397,360775,2378,Germany,G05,c,25,2,i
father,364613,368194,3581,Germany,G05,c,25,3,q
father,370951,375086,4135,Germany,G05,c,25,4,q
child,376681,378424,1743,Germany,G05,f,25,5,a
father,377978,379883,1905,Germany,G05,c,25,6,q
father,382829,386667,3838,Germany,G05,c,25,7,q
child,388424,389789,1365,Germany,G05,f,25,8,a
father,412045,412897,852,Germany,G05,c,26,1,a
father,413559,418816,5257,Germany,G05,c,26,2,a
mother,419694,420451,757,Germany,G05,b,26,3,a
child,420005,428518,8513,Germany,G05,b,26,4,a
father,427843,429897,2054,Germany,G05,b,27,1,a
father,435789,437410,1621,Germany,G05,c,28,1,q
child,437735,438816,1081,Germany,G05,f,28,2,a
mother,442613,445613,3000,Germany,G05,c,29,1,q
child,446248,447329,1081,Germany,G05,m,29,2,a
mother,447573,449235,1662,Germany,G05,c,29,3,q
child,450235,451843,1608,Germany,G05,m,29,4,a
mother,451924,453613,1689,Germany,G05,c,29,5,a
father,452073,453005,932,Germany,G05,c,29,6,q
father,454910,457802,2892,Germany,G05,c,29,7,q
father,463329,469573,6244,Germany,G05,c,29,8,q
child,472370,474762,2392,Germany,G05,f,29,9,a
father,474194,475059,865,Germany,G05,m,29,10,q
mother,475167,475937,770,Germany,G05,f,29,11,q
father,476073,477978,1905,Germany,G05,b,29,12,q
father,479113,482022,2909,Germany,G05,c,29,13,a
father,491248,492951,1703,Germany,G05,m,29,14,q
mother,493829,495573,1744,Germany,G05,f,29,15,a
father,495329,496140,811,Germany,G05,m,29,16,q
mother,496343,496964,621,Germany,G05,f,29,17,a
mother,478194,478870,676,Germany,G05,f,30,1,a
mother,489910,492640,2730,Germany,G05,f,31,1,a
mother,499127,500640,1513,Germany,G05,f,32,1,a
father,500802,501694,892,Germany,G05,m,32,2,a
mother,501140,509464,8324,Germany,G05,f,32,3,a
father,509113,510005,892,Germany,G05,f,32,4,a
father,511762,512370,608,Germany,G05,m,32,5,a
mother,509789,510600,811,Germany,G05,f,33,1,a
mother,512316,515586,3270,Germany,G05,f,33,2,a
father,515721,516613,892,Germany,G05,m,33,3,a
mother,517505,518181,676,Germany,G05,f,33,4,a
father,523140,526343,3203,Germany,G05,m,34,1,a
mother,526694,529370,2676,Germany,G05,f,34,2,q
father,529369,530586,1217,Germany,G05,m,34,3,a
mother,530910,533383,2473,Germany,G05,f,34,4,q
father,532762,542248,9486,Germany,G05,m,34,5,a
father,547208,548627,1419,Germany,G05,m,35,1,q
father,555005,559721,4716,Germany,G05,c,36,1,q
child,561573,562383,810,Germany,G05,f,36,2,a
father,562343,563032,689,Germany,G05,c,36,3,q
child,564302,565586,1284,Germany,G05,b,36,4,a
mother,565681,567464,1783,Germany,G05,c,36,5,q
child,567383,568856,1473,Germany,G05,m,36,6,a
mother,568897,571005,2108,Germany,G05,c,36,7,q
child,571005,573086,2081,Germany,G05,m,36,8,a
mother,571748,573505,1757,Germany,G05,c,36,9,a
father,573154,574127,973,Germany,G05,c,36,10,q
mother,574127,574735,608,Germany,G05,b,36,11,a
father,575018,576235,1217,Germany,G05,c,36,12,a
mother,579910,582302,2392,Germany,G05,c,37,1,i
father,590545,593870,3325,Germany,G05,m,38,1,a
mother,596167,598478,2311,Germany,G05,c,39,1,q
silence,978,5127,4149,Germany,G05,NA,NA,NA,NA
silence,8640,10302,1662,Germany,G05,NA,NA,NA,NA
silence,13289,13951,662,Germany,G05,NA,NA,NA,NA
father_gesture,15064,15726,662,Germany,G05,NA,NA,NA,NA
silence,15451,15910,459,Germany,G05,NA,NA,NA,NA
silence,17248,17316,68,Germany,G05,NA,NA,NA,NA
silence,21991,22167,176,Germany,G05,NA,NA,NA,NA
silence,23721,24208,487,Germany,G05,NA,NA,NA,NA
silence,26924,27654,730,Germany,G05,NA,NA,NA,NA
silence,29221,29856,635,Germany,G05,NA,NA,NA,NA
silence,34437,46370,11933,Germany,G05,NA,NA,NA,NA
mother_gesture,49929,51422,1493,Germany,G05,NA,NA,NA,NA
silence,52586,56397,3811,Germany,G05,NA,NA,NA,NA
silence,59194,59262,68,Germany,G05,NA,NA,NA,NA
silence,61221,61856,635,Germany,G05,NA,NA,NA,NA
silence,62613,63410,797,Germany,G05,NA,NA,NA,NA
silence,64289,64816,527,Germany,G05,NA,NA,NA,NA
silence,66654,67181,527,Germany,G05,NA,NA,NA,NA
silence,67991,70329,2338,Germany,G05,NA,NA,NA,NA
silence,72708,72802,94,Germany,G05,NA,NA,NA,NA
silence,74708,76235,1527,Germany,G05,NA,NA,NA,NA
silence,77437,77640,203,Germany,G05,NA,NA,NA,NA
silence,78545,79302,757,Germany,G05,NA,NA,NA,NA
silence,81248,82694,1446,Germany,G05,NA,NA,NA,NA
silence,88748,89762,1014,Germany,G05,NA,NA,NA,NA
silence,92721,93100,379,Germany,G05,NA,NA,NA,NA
child_gesture,94034,95011,977,Germany,G05,NA,NA,NA,NA
silence,96086,96262,176,Germany,G05,NA,NA,NA,NA
child_gesture,96766,97516,750,Germany,G05,NA,NA,NA,NA
silence,98329,98694,365,Germany,G05,NA,NA,NA,NA
silence,99410,100127,717,Germany,G05,NA,NA,NA,NA
silence,101208,102072,864,Germany,G05,NA,NA,NA,NA
child_gesture,106609,108277,1668,Germany,G05,NA,NA,NA,NA
silence,109113,110113,1000,Germany,G05,NA,NA,NA,NA
silence,112748,116086,3338,Germany,G05,NA,NA,NA,NA
silence,120032,123248,3216,Germany,G05,NA,NA,NA,NA
silence,125018,132045,7027,Germany,G05,NA,NA,NA,NA
silence,133437,136816,3379,Germany,G05,NA,NA,NA,NA
silence,140735,142018,1283,Germany,G05,NA,NA,NA,NA
silence,143397,145437,2040,Germany,G05,NA,NA,NA,NA
silence,146505,149802,3297,Germany,G05,NA,NA,NA,NA
silence,151167,166154,14987,Germany,G05,NA,NA,NA,NA
silence,168518,170748,2230,Germany,G05,NA,NA,NA,NA
silence,171424,172370,946,Germany,G05,NA,NA,NA,NA
silence,192302,192586,284,Germany,G05,NA,NA,NA,NA
silence,193235,194910,1675,Germany,G05,NA,NA,NA,NA
silence,204073,207356,3283,Germany,G05,NA,NA,NA,NA
silence,208978,211018,2040,Germany,G05,NA,NA,NA,NA
silence,211694,219708,8014,Germany,G05,NA,NA,NA,NA
silence,226383,227748,1365,Germany,G05,NA,NA,NA,NA
child_gesture,228872,230794,1922,Germany,G05,NA,NA,NA,NA
silence,231424,231856,432,Germany,G05,NA,NA,NA,NA
silence,233951,234032,81,Germany,G05,NA,NA,NA,NA
mother_gesture,234297,234817,520,Germany,G05,NA,NA,NA,NA
child_gesture,235234,235854,620,Germany,G05,NA,NA,NA,NA
child_gesture,236599,237657,1058,Germany,G05,NA,NA,NA,NA
silence,241721,241978,257,Germany,G05,NA,NA,NA,NA
child_gesture,242562,243821,1259,Germany,G05,NA,NA,NA,NA
silence,245073,246018,945,Germany,G05,NA,NA,NA,NA
silence,248221,248532,311,Germany,G05,NA,NA,NA,NA
silence,250708,251491,783,Germany,G05,NA,NA,NA,NA
silence,252897,255275,2378,Germany,G05,NA,NA,NA,NA
silence,256194,256559,365,Germany,G05,NA,NA,NA,NA
silence,257586,258086,500,Germany,G05,NA,NA,NA,NA
silence,260464,263208,2744,Germany,G05,NA,NA,NA,NA
silence,267748,268356,608,Germany,G05,NA,NA,NA,NA
silence,269586,269600,14,Germany,G05,NA,NA,NA,NA
silence,271316,271937,621,Germany,G05,NA,NA,NA,NA
child_gesture,272211,274622,2411,Germany,G05,NA,NA,NA,NA
silence,275816,281600,5784,Germany,G05,NA,NA,NA,NA
silence,282464,283316,852,Germany,G05,NA,NA,NA,NA
silence,285937,289775,3838,Germany,G05,NA,NA,NA,NA
child_gesture,290455,291215,760,Germany,G05,NA,NA,NA,NA
silence,291654,293410,1756,Germany,G05,NA,NA,NA,NA
silence,295518,296113,595,Germany,G05,NA,NA,NA,NA
silence,297329,299113,1784,Germany,G05,NA,NA,NA,NA
silence,299910,300100,190,Germany,G05,NA,NA,NA,NA
silence,300789,306343,5554,Germany,G05,NA,NA,NA,NA
silence,311235,312843,1608,Germany,G05,NA,NA,NA,NA
silence,313654,313802,148,Germany,G05,NA,NA,NA,NA
silence,315613,316991,1378,Germany,G05,NA,NA,NA,NA
silence,323586,323897,311,Germany,G05,NA,NA,NA,NA
mother_gesture,324554,325496,942,Germany,G05,NA,NA,NA,NA
silence,325789,325829,40,Germany,G05,NA,NA,NA,NA
silence,329721,331194,1473,Germany,G05,NA,NA,NA,NA
silence,334991,341275,6284,Germany,G05,NA,NA,NA,NA
child_gesture,340172,341664,1492,Germany,G05,NA,NA,NA,NA
silence,346654,353343,6689,Germany,G05,NA,NA,NA,NA
silence,356262,358397,2135,Germany,G05,NA,NA,NA,NA
silence,360775,364613,3838,Germany,G05,NA,NA,NA,NA
silence,368194,370951,2757,Germany,G05,NA,NA,NA,NA
father_gesture,371594,373406,1812,Germany,G05,NA,NA,NA,NA
silence,375086,376681,1595,Germany,G05,NA,NA,NA,NA
silence,379883,382829,2946,Germany,G05,NA,NA,NA,NA
silence,386667,388424,1757,Germany,G05,NA,NA,NA,NA
silence,389789,412045,22256,Germany,G05,NA,NA,NA,NA
silence,412897,413559,662,Germany,G05,NA,NA,NA,NA
silence,418816,419694,878,Germany,G05,NA,NA,NA,NA
silence,429897,435789,5892,Germany,G05,NA,NA,NA,NA
silence,437410,437735,325,Germany,G05,NA,NA,NA,NA
silence,438816,442613,3797,Germany,G05,NA,NA,NA,NA
silence,445613,446248,635,Germany,G05,NA,NA,NA,NA
silence,447329,447573,244,Germany,G05,NA,NA,NA,NA
silence,449235,450235,1000,Germany,G05,NA,NA,NA,NA
silence,451843,451924,81,Germany,G05,NA,NA,NA,NA
silence,453613,454910,1297,Germany,G05,NA,NA,NA,NA
silence,457802,463329,5527,Germany,G05,NA,NA,NA,NA
silence,469573,472370,2797,Germany,G05,NA,NA,NA,NA
silence,475059,475167,108,Germany,G05,NA,NA,NA,NA
silence,475937,476073,136,Germany,G05,NA,NA,NA,NA
silence,477978,478194,216,Germany,G05,NA,NA,NA,NA
silence,478870,479113,243,Germany,G05,NA,NA,NA,NA
silence,482022,489910,7888,Germany,G05,NA,NA,NA,NA
silence,492951,493829,878,Germany,G05,NA,NA,NA,NA
silence,496140,496343,203,Germany,G05,NA,NA,NA,NA
silence,496964,499127,2163,Germany,G05,NA,NA,NA,NA
silence,500640,500802,162,Germany,G05,NA,NA,NA,NA
silence,510600,511762,1162,Germany,G05,NA,NA,NA,NA
silence,515586,515721,135,Germany,G05,NA,NA,NA,NA
silence,516613,517505,892,Germany,G05,NA,NA,NA,NA
silence,518181,523140,4959,Germany,G05,NA,NA,NA,NA
silence,526343,526694,351,Germany,G05,NA,NA,NA,NA
silence,530586,530910,324,Germany,G05,NA,NA,NA,NA
silence,542248,547208,4960,Germany,G05,NA,NA,NA,NA
silence,548627,555005,6378,Germany,G05,NA,NA,NA,NA
silence,559721,561573,1852,Germany,G05,NA,NA,NA,NA
silence,563032,564302,1270,Germany,G05,NA,NA,NA,NA
child_gesture,565055,565766,711,Germany,G05,NA,NA,NA,NA
silence,565586,565681,95,Germany,G05,NA,NA,NA,NA
silence,568856,568897,41,Germany,G05,NA,NA,NA,NA
silence,574735,575018,283,Germany,G05,NA,NA,NA,NA
silence,576235,579910,3675,Germany,G05,NA,NA,NA,NA
silence,582302,590545,8243,Germany,G05,NA,NA,NA,NA
silence,593870,596167,2297,Germany,G05,NA,NA,NA,NA
silence,598478,599802,1324,Germany,G05,NA,NA,NA,NA
mother,840,5680,4840,Germany,G06,f,1,1,a
father,6760,7960,1200,Germany,G06,m,1,2,a
mother,7970,8470,500,Germany,G06,f,1,3,a
mother,10220,15410,5190,Germany,G06,o,2,1,a
mother,18760,29270,10510,Germany,G06,o,2,2,a
child,30060,31430,1370,Germany,G06,m,2,3,a
father,32700,33290,590,Germany,G06,c,2,4,q
child,33450,36830,3380,Germany,G06,f,2,5,a
father,35620,36610,990,Germany,G06,c,2,6,q
mother,38120,39730,1610,Germany,G06,c,2,7,q
child,40510,41420,910,Germany,G06,m,2,8,a
mother,41700,42340,640,Germany,G06,c,2,9,q
mother,32640,34740,2100,Germany,G06,b,3,1,q
father,43320,48890,5570,Germany,G06,c,3,2,q
child,49340,50440,1100,Germany,G06,f,3,3,a
father,51330,56120,4790,Germany,G06,c,3,4,q
child,63950,66760,2810,Germany,G06,f,3,5,a
father,67460,68500,1040,Germany,G06,c,3,6,q
child,68810,69300,490,Germany,G06,f,3,7,a
father,58570,63230,4660,Germany,G06,m,4,1,a
father,69100,71880,2780,Germany,G06,m,5,1,a
mother,72710,73820,1110,Germany,G06,f,5,2,q
father,74200,75170,970,Germany,G06,m,5,3,q
mother,75860,77200,1340,Germany,G06,f,5,4,q
father,77390,90000,12610,Germany,G06,m,5,5,a
mother,86920,87380,460,Germany,G06,f,5,6,a
father,92180,93220,1040,Germany,G06,m,5,7,a
child,94150,95160,1010,Germany,G06,b,6,1,a
mother,95850,98430,2580,Germany,G06,o,7,1,a
father,100900,105710,4810,Germany,G06,o,7,2,a
mother,108600,118110,9510,Germany,G06,o,7,3,a
mother,125140,133610,8470,Germany,G06,o,7,4,q
mother,137410,138930,1520,Germany,G06,o,7,5,q
father,149150,151000,1850,Germany,G06,m,8,1,q
mother,153400,154320,920,Germany,G06,f,8,2,a
mother,158820,164530,5710,Germany,G06,o,9,1,a
mother,169340,172000,2660,Germany,G06,o,10,1,a
mother,178060,179900,1840,Germany,G06,c,11,1,q
child,179890,184030,4140,Germany,G06,m,11,2,a
father,184010,185320,1310,Germany,G06,b,11,3,a
child,185027,186540,1513,Germany,G06,b,11,4,a
mother,185860,188320,2460,Germany,G06,c,11,5,q
child,189130,199510,10380,Germany,G06,m,11,6,a
mother,198410,200780,2370,Germany,G06,c,11,7,q
father,201140,202820,1680,Germany,G06,m,11,8,a
child,202150,203970,1820,Germany,G06,m,11,9,a
father,203280,205790,2510,Germany,G06,m,11,10,a
mother,203380,207250,3870,Germany,G06,f,11,11,q
father,207230,210390,3160,Germany,G06,m,11,12,a
mother,211520,212980,1460,Germany,G06,f,11,13,q
father,213310,214930,1620,Germany,G06,m,11,14,a
father,223880,227520,3640,Germany,G06,m,11,15,a
mother,225850,226430,580,Germany,G06,f,11,16,a
mother,230030,231430,1400,Germany,G06,c,11,17,q
child,232390,233110,720,Germany,G06,m,11,18,a
mother,233330,234290,960,Germany,G06,c,11,19,q
child,235000,236610,1610,Germany,G06,m,11,20,a
mother,236560,237870,1310,Germany,G06,c,11,21,q
child,239790,242650,2860,Germany,G06,b,11,22,a
mother,243920,245100,1180,Germany,G06,c,11,23,q
child,246160,247550,1390,Germany,G06,m,11,24,a
mother,247410,248710,1300,Germany,G06,c,11,25,q
child,253370,256300,2930,Germany,G06,b,11,26,a
mother,214270,219140,4870,Germany,G06,o,12,1,q
mother,251680,257210,5530,Germany,G06,o,13,1,a
mother,263310,266510,3200,Germany,G06,o,13,2,i
father,265880,268710,2830,Germany,G06,m,14,1,a
mother,269560,271190,1630,Germany,G06,f,14,2,q
father,270140,271250,1110,Germany,G06,m,14,3,a
mother,272390,273110,720,Germany,G06,f,14,4,q
father,273080,275330,2250,Germany,G06,m,14,5,a
mother,275260,276100,840,Germany,G06,f,14,6,q
father,276820,277510,690,Germany,G06,m,14,7,a
mother,278760,283420,4660,Germany,G06,c,14,8,q
father,279610,280140,530,Germany,G06,m,14,9,a
child,283640,289169,5529,Germany,G06,m,14,10,a
mother,290960,293020,2060,Germany,G06,c,14,11,a
child,294610,296810,2200,Germany,G06,m,14,12,a
child,268870,269830,960,Germany,G06,b,15,1,a
mother,297160,299330,2170,Germany,G06,f,16,1,q
father,299020,299570,550,Germany,G06,m,16,2,a
father,314970,318200,3230,Germany,G06,c,17,1,q
mother,318270,320310,2040,Germany,G06,f,17,2,a
mother,316110,316720,610,Germany,G06,o,18,1,a
mother,325840,327920,2080,Germany,G06,c,18,2,q
mother,335820,336490,670,Germany,G06,c,18,3,q
mother,340100,341710,1610,Germany,G06,c,18,4,q
child,342520,343860,1340,Germany,G06,m,18,5,a
mother,345210,349570,4360,Germany,G06,c,18,6,q
child,350670,353850,3180,Germany,G06,m,18,7,a
mother,354640,355530,890,Germany,G06,c,18,8,q
child,355530,356410,880,Germany,G06,m,18,9,a
mother,358770,360570,1800,Germany,G06,c,18,10,q
child,361090,364000,2910,Germany,G06,m,18,11,a
father,363630,365950,2320,Germany,G06,m,18,12,a
mother,365990,366850,860,Germany,G06,f,18,13,q
father,366970,368110,1140,Germany,G06,m,18,14,a
mother,368040,368550,510,Germany,G06,f,18,15,a
father,371420,376200,4780,Germany,G06,m,18,16,a
mother,376130,377698,1568,Germany,G06,f,18,17,q
father,377710,384430,6720,Germany,G06,c,18,18,q
child,385140,387430,2290,Germany,G06,f,18,19,a
father,387790,388370,580,Germany,G06,c,18,20,a
mother,370900,373450,2550,Germany,G06,o,19,1,a
father,396510,397350,840,Germany,G06,o,20,1,a
father,407490,408320,830,Germany,G06,m,21,1,q
mother,408840,409400,560,Germany,G06,f,21,2,a
mother,411660,413900,2240,Germany,G06,f,21,3,q
father,413840,414450,610,Germany,G06,m,21,4,q
mother,414460,417270,2810,Germany,G06,f,21,5,a
mother,422940,425410,2470,Germany,G06,o,22,1,q
child,423150,427590,4440,Germany,G06,m,22,2,a
mother,427110,428610,1500,Germany,G06,c,22,3,q
child,428690,429720,1030,Germany,G06,m,22,4,a
mother,431460,437860,6400,Germany,G06,o,23,1,q
mother,442970,452250,9280,Germany,G06,f,24,1,a
father,454090,463650,9560,Germany,G06,m,24,2,a
mother,465600,467600,2000,Germany,G06,f,24,3,a
father,465770,468580,2810,Germany,G06,m,24,4,a
father,472190,473040,850,Germany,G06,m,24,5,a
child,455960,457680,1720,Germany,G06,o,25,1,a
child,463660,468500,4840,Germany,G06,o,25,2,a
mother,472360,474040,1680,Germany,G06,o,26,1,a
father,474000,475960,1960,Germany,G06,m,27,1,q
mother,476370,476890,520,Germany,G06,m,27,2,a
father,479200,480530,1330,Germany,G06,m,27,3,a
mother,479930,481910,1980,Germany,G06,c,28,1,a
mother,484280,488980,4700,Germany,G06,o,29,1,a
mother,497800,499960,2160,Germany,G06,o,29,2,a
mother,500330,502090,1760,Germany,G06,f,30,1,q
father,503330,513050,9720,Germany,G06,m,30,2,a
mother,513480,516350,2870,Germany,G06,f,30,3,a
father,517900,524180,6280,Germany,G06,m,31,1,a
mother,524440,526710,2270,Germany,G06,f,31,2,a
father,525090,527100,2010,Germany,G06,m,31,3,a
child,524140,527460,3320,Germany,G06,b,32,1,a
child,530200,532150,1950,Germany,G06,b,33,1,a
father,532350,532910,560,Germany,G06,c,33,2,q
child,534500,535990,1490,Germany,G06,f,33,3,a
father,535750,536910,1160,Germany,G06,c,33,4,q
child,536730,537580,850,Germany,G06,f,33,5,a
father,540470,541010,540,Germany,G06,c,33,6,q
mother,541030,541640,610,Germany,G06,c,33,7,a
father,543980,547620,3640,Germany,G06,m,33,8,a
mother,549980,553660,3680,Germany,G06,o,34,1,a
mother,559790,560310,520,Germany,G06,b,35,1,a
father,560310,569130,8820,Germany,G06,m,36,1,a
mother,569100,572370,3270,Germany,G06,f,36,2,q
father,572560,573050,490,Germany,G06,m,36,3,q
mother,573070,573830,760,Germany,G06,f,36,4,q
father,573710,574130,420,Germany,G06,m,36,5,a
mother,574220,578010,3790,Germany,G06,f,36,6,a
father,578720,582810,4090,Germany,G06,m,36,7,a
mother,586350,597480,11130,Germany,G06,f,36,8,a
silence,5680,6760,1080,Germany,G06,NA,NA,NA,NA
silence,7960,7970,10,Germany,G06,NA,NA,NA,NA
silence,8470,10220,1750,Germany,G06,NA,NA,NA,NA
silence,15410,18760,3350,Germany,G06,NA,NA,NA,NA
silence,29270,30060,790,Germany,G06,NA,NA,NA,NA
silence,31430,32640,1210,Germany,G06,NA,NA,NA,NA
silence,36830,38120,1290,Germany,G06,NA,NA,NA,NA
silence,39730,40510,780,Germany,G06,NA,NA,NA,NA
silence,41420,41700,280,Germany,G06,NA,NA,NA,NA
silence,42340,43320,980,Germany,G06,NA,NA,NA,NA
father_gesture,43889,45810,1921,Germany,G06,NA,NA,NA,NA
silence,48890,49340,450,Germany,G06,NA,NA,NA,NA
silence,50440,51330,890,Germany,G06,NA,NA,NA,NA
silence,56120,58570,2450,Germany,G06,NA,NA,NA,NA
silence,63230,63950,720,Germany,G06,NA,NA,NA,NA
silence,66760,67460,700,Germany,G06,NA,NA,NA,NA
silence,68500,68810,310,Germany,G06,NA,NA,NA,NA
silence,71880,72710,830,Germany,G06,NA,NA,NA,NA
silence,73820,74200,380,Germany,G06,NA,NA,NA,NA
silence,75170,75860,690,Germany,G06,NA,NA,NA,NA
silence,77200,77390,190,Germany,G06,NA,NA,NA,NA
silence,90000,92180,2180,Germany,G06,NA,NA,NA,NA
silence,93220,94150,930,Germany,G06,NA,NA,NA,NA
silence,95160,95850,690,Germany,G06,NA,NA,NA,NA
silence,98430,100900,2470,Germany,G06,NA,NA,NA,NA
silence,105710,108600,2890,Germany,G06,NA,NA,NA,NA
silence,118110,125140,7030,Germany,G06,NA,NA,NA,NA
silence,133610,137410,3800,Germany,G06,NA,NA,NA,NA
silence,138930,149150,10220,Germany,G06,NA,NA,NA,NA
silence,151000,153400,2400,Germany,G06,NA,NA,NA,NA
silence,154320,158820,4500,Germany,G06,NA,NA,NA,NA
silence,164530,169340,4810,Germany,G06,NA,NA,NA,NA
silence,172000,178060,6060,Germany,G06,NA,NA,NA,NA
silence,188320,189130,810,Germany,G06,NA,NA,NA,NA
silence,200780,201140,360,Germany,G06,NA,NA,NA,NA
silence,210390,211520,1130,Germany,G06,NA,NA,NA,NA
silence,212980,213310,330,Germany,G06,NA,NA,NA,NA
silence,219140,223880,4740,Germany,G06,NA,NA,NA,NA
silence,227520,230030,2510,Germany,G06,NA,NA,NA,NA
silence,231430,232390,960,Germany,G06,NA,NA,NA,NA
silence,233110,233330,220,Germany,G06,NA,NA,NA,NA
silence,234290,235000,710,Germany,G06,NA,NA,NA,NA
silence,237870,239790,1920,Germany,G06,NA,NA,NA,NA
child_gesture,239498,241402,1904,Germany,G06,NA,NA,NA,NA
silence,242650,243920,1270,Germany,G06,NA,NA,NA,NA
silence,245100,246160,1060,Germany,G06,NA,NA,NA,NA
silence,248710,251680,2970,Germany,G06,NA,NA,NA,NA
silence,257210,263310,6100,Germany,G06,NA,NA,NA,NA
silence,268710,268870,160,Germany,G06,NA,NA,NA,NA
silence,271250,272390,1140,Germany,G06,NA,NA,NA,NA
silence,276100,276820,720,Germany,G06,NA,NA,NA,NA
silence,277510,278760,1250,Germany,G06,NA,NA,NA,NA
silence,283420,283640,220,Germany,G06,NA,NA,NA,NA
silence,289169,290960,1791,Germany,G06,NA,NA,NA,NA
silence,293020,294610,1590,Germany,G06,NA,NA,NA,NA
silence,296810,297160,350,Germany,G06,NA,NA,NA,NA
silence,299570,314970,15400,Germany,G06,NA,NA,NA,NA
silence,318200,318270,70,Germany,G06,NA,NA,NA,NA
silence,320310,325840,5530,Germany,G06,NA,NA,NA,NA
silence,327920,335820,7900,Germany,G06,NA,NA,NA,NA
silence,336490,340100,3610,Germany,G06,NA,NA,NA,NA
silence,341710,342520,810,Germany,G06,NA,NA,NA,NA
silence,343860,345210,1350,Germany,G06,NA,NA,NA,NA
silence,349570,350670,1100,Germany,G06,NA,NA,NA,NA
silence,353850,354640,790,Germany,G06,NA,NA,NA,NA
silence,356410,358770,2360,Germany,G06,NA,NA,NA,NA
silence,360570,361090,520,Germany,G06,NA,NA,NA,NA
silence,365950,365990,40,Germany,G06,NA,NA,NA,NA
silence,366850,366970,120,Germany,G06,NA,NA,NA,NA
silence,368550,370900,2350,Germany,G06,NA,NA,NA,NA
silence,377698,377710,12,Germany,G06,NA,NA,NA,NA
silence,384430,385140,710,Germany,G06,NA,NA,NA,NA
silence,387430,387790,360,Germany,G06,NA,NA,NA,NA
silence,388370,396510,8140,Germany,G06,NA,NA,NA,NA
silence,397350,407490,10140,Germany,G06,NA,NA,NA,NA
silence,408320,408840,520,Germany,G06,NA,NA,NA,NA
silence,409400,411660,2260,Germany,G06,NA,NA,NA,NA
silence,414450,414460,10,Germany,G06,NA,NA,NA,NA
silence,417270,422940,5670,Germany,G06,NA,NA,NA,NA
child_gesture,425670,427127,1457,Germany,G06,NA,NA,NA,NA
child_gesture,427417,428529,1112,Germany,G06,NA,NA,NA,NA
silence,428610,428690,80,Germany,G06,NA,NA,NA,NA
child_gesture,429028,429507,479,Germany,G06,NA,NA,NA,NA
silence,429720,431460,1740,Germany,G06,NA,NA,NA,NA
silence,437860,442970,5110,Germany,G06,NA,NA,NA,NA
silence,452250,454090,1840,Germany,G06,NA,NA,NA,NA
silence,463650,463660,10,Germany,G06,NA,NA,NA,NA
silence,468580,472190,3610,Germany,G06,NA,NA,NA,NA
silence,475960,476370,410,Germany,G06,NA,NA,NA,NA
silence,476890,479200,2310,Germany,G06,NA,NA,NA,NA
silence,481910,484280,2370,Germany,G06,NA,NA,NA,NA
silence,488980,497800,8820,Germany,G06,NA,NA,NA,NA
silence,499960,500330,370,Germany,G06,NA,NA,NA,NA
silence,502090,503330,1240,Germany,G06,NA,NA,NA,NA
silence,513050,513480,430,Germany,G06,NA,NA,NA,NA
silence,516350,517900,1550,Germany,G06,NA,NA,NA,NA
silence,527460,530200,2740,Germany,G06,NA,NA,NA,NA
silence,532150,532350,200,Germany,G06,NA,NA,NA,NA
silence,532910,534500,1590,Germany,G06,NA,NA,NA,NA
silence,537580,540470,2890,Germany,G06,NA,NA,NA,NA
child_gesture,538360,539016,656,Germany,G06,NA,NA,NA,NA
silence,541010,541030,20,Germany,G06,NA,NA,NA,NA
silence,541640,543980,2340,Germany,G06,NA,NA,NA,NA
silence,547620,549980,2360,Germany,G06,NA,NA,NA,NA
silence,553660,559790,6130,Germany,G06,NA,NA,NA,NA
silence,572370,572560,190,Germany,G06,NA,NA,NA,NA
silence,573050,573070,20,Germany,G06,NA,NA,NA,NA
silence,574130,574220,90,Germany,G06,NA,NA,NA,NA
silence,578010,578720,710,Germany,G06,NA,NA,NA,NA
silence,582810,586350,3540,Germany,G06,NA,NA,NA,NA
silence,597480,598200,720,Germany,G06,NA,NA,NA,NA
child,1205,2661,1456,Germany,G07,m,1,1,q
mother,2745,4621,1876,Germany,G07,c,1,2,a
mother,5002,7754,2752,Germany,G07,b,2,1,a
child,7921,9773,1852,Germany,G07,m,2,2,a
father,8610,10210,1600,Germany,G07,c,3,1,a
mother,10843,13046,2203,Germany,G07,b,3,2,a
father,14430,15090,660,Germany,G07,c,3,3,a
mother,15143,17232,2089,Germany,G07,c,4,1,q
mother,21604,23418,1814,Germany,G07,c,4,2,q
mother,25975,26595,620,Germany,G07,c,4,3,q
child,26958,27439,481,Germany,G07,m,4,4,a
mother,27674,29020,1346,Germany,G07,c,4,5,a
mother,30984,36905,5921,Germany,G07,b,4,6,a
father,31040,36830,5790,Germany,G07,b,4,7,a
child,37462,38789,1327,Germany,G07,b,4,8,a
father,38650,39690,1040,Germany,G07,c,4,9,a
mother,38666,40090,1424,Germany,G07,c,4,10,a
father,40020,41640,1620,Germany,G07,c,5,1,a
mother,40117,45497,5380,Germany,G07,c,5,2,a
child,47409,49294,1885,Germany,G07,m,5,3,a
mother,49294,50648,1354,Germany,G07,c,5,4,q
child,52347,53002,655,Germany,G07,b,5,5,a
mother,53205,55851,2646,Germany,G07,c,5,6,a
father,53920,57100,3180,Germany,G07,c,5,7,q
child,58471,61710,3239,Germany,G07,f,5,8,a
mother,61966,64082,2116,Germany,G07,c,5,9,q
child,64155,64691,536,Germany,G07,m,5,10,a
mother,50657,52197,1540,Germany,G07,c,6,1,a
father,64870,65650,780,Germany,G07,m,7,1,a
mother,66046,66586,540,Germany,G07,f,7,2,a
mother,68834,70940,2106,Germany,G07,f,7,3,a
father,78100,79030,930,Germany,G07,c,8,1,q
child,81789,82975,1186,Germany,G07,f,8,2,a
father,82760,83580,820,Germany,G07,c,8,3,q
child,85745,88612,2867,Germany,G07,f,8,4,a
father,87710,89740,2030,Germany,G07,c,8,5,a
mother,84002,85843,1841,Germany,G07,c,9,1,q
mother,88374,92568,4194,Germany,G07,c,9,2,q
child,92586,93258,672,Germany,G07,m,9,3,a
mother,93152,97506,4354,Germany,G07,c,9,4,a
child,99453,101427,1974,Germany,G07,m,9,5,a
mother,101586,103586,2000,Germany,G07,c,10,1,a
child,103073,103621,548,Germany,G07,m,10,2,a
mother,103736,104197,461,Germany,G07,c,10,3,a
child,106568,110020,3452,Germany,G07,b,11,1,a
mother,113657,117117,3460,Germany,G07,b,12,1,a
child,117338,118745,1407,Germany,G07,m,13,1,a
mother,119267,120143,876,Germany,G07,c,13,2,q
child,120285,120728,443,Germany,G07,m,13,3,a
mother,121427,121966,539,Germany,G07,c,13,4,a
child,122232,124745,2513,Germany,G07,b,14,1,a
mother,124851,126444,1593,Germany,G07,c,14,2,q
child,126427,126816,389,Germany,G07,m,14,3,a
mother,127374,129161,1787,Germany,G07,c,14,4,a
child,129489,130896,1407,Germany,G07,m,14,5,a
mother,131851,133205,1354,Germany,G07,c,14,6,q
child,133135,133657,522,Germany,G07,m,14,7,a
mother,135843,136843,1000,Germany,G07,c,14,8,a
child,136913,143993,7080,Germany,G07,b,14,9,a
father,144630,146130,1500,Germany,G07,c,14,10,q
child,146205,146834,629,Germany,G07,f,14,11,a
father,150040,154050,4010,Germany,G07,c,14,12,a
child,157418,160329,2911,Germany,G07,b,15,1,a
child,163152,167055,3903,Germany,G07,b,15,2,a
mother,167258,168781,1523,Germany,G07,c,15,3,q
child,169223,176878,7655,Germany,G07,m,15,4,a
mother,173931,183648,9717,Germany,G07,c,15,5,a
father,176010,177290,1280,Germany,G07,c,15,6,q
child,179338,185949,6611,Germany,G07,m,15,7,a
mother,185940,189170,3230,Germany,G07,c,15,8,a
father,191560,193370,1810,Germany,G07,c,15,9,q
mother,195082,196223,1141,Germany,G07,f,15,10,a
child,205409,208197,2788,Germany,G07,b,16,1,a
child,210728,213002,2274,Germany,G07,b,16,2,a
mother,213046,215551,2505,Germany,G07,c,16,3,a
father,213570,214190,620,Germany,G07,f,16,4,a
child,215506,217931,2425,Germany,G07,b,17,1,q
mother,218099,218931,832,Germany,G07,c,17,2,a
mother,221683,224347,2664,Germany,G07,c,17,3,a
mother,248090,251931,3841,Germany,G07,f,18,1,q
father,252820,253280,460,Germany,G07,m,18,2,a
father,257140,258590,1450,Germany,G07,m,18,3,a
mother,262728,266161,3433,Germany,G07,f,18,4,a
mother,268188,269781,1593,Germany,G07,f,18,5,a
father,270070,270780,710,Germany,G07,m,18,6,a
mother,272073,274382,2309,Germany,G07,f,18,7,a
father,280870,282820,1950,Germany,G07,m,18,8,a
mother,282949,283391,442,Germany,G07,f,18,9,a
child,255993,257621,1628,Germany,G07,m,19,1,a
father,261660,263110,1450,Germany,G07,c,19,2,a
child,263896,266232,2336,Germany,G07,b,19,3,a
father,266320,267600,1280,Germany,G07,c,19,4,q
mother,283453,287329,3876,Germany,G07,c,20,1,q
child,287798,290231,2433,Germany,G07,m,20,2,a
mother,288489,289365,876,Germany,G07,c,20,3,q
child,290231,290541,310,Germany,G07,m,20,4,a
mother,290329,295860,5531,Germany,G07,f,20,5,q
father,295880,297040,1160,Germany,G07,m,20,6,a
father,300400,302340,1940,Germany,G07,c,20,7,q
mother,302002,302825,823,Germany,G07,b,20,8,a
child,307825,308913,1088,Germany,G07,b,20,9,a
mother,308851,309878,1027,Germany,G07,c,20,10,q
child,309789,310259,470,Germany,G07,m,20,11,a
father,310210,311690,1480,Germany,G07,c,20,12,a
child,315533,317002,1469,Germany,G07,f,20,13,a
mother,316931,318020,1089,Germany,G07,f,20,14,a
father,317380,319320,1940,Germany,G07,c,20,15,q
child,319073,319710,637,Germany,G07,f,20,16,a
father,319950,320660,710,Germany,G07,c,20,17,a
mother,320082,324515,4433,Germany,G07,c,20,18,a
mother,296666,298161,1495,Germany,G07,b,21,1,a
mother,325949,334391,8442,Germany,G07,c,22,1,q
father,326510,328990,2480,Germany,G07,c,22,2,a
mother,336188,337595,1407,Germany,G07,c,22,3,a
father,336590,337610,1020,Germany,G07,c,22,4,a
father,339300,343060,3760,Germany,G07,m,23,1,q
mother,346391,349161,2770,Germany,G07,f,23,2,a
father,349030,352900,3870,Germany,G07,c,23,3,q
child,353577,354267,690,Germany,G07,f,23,4,a
father,356030,357270,1240,Germany,G07,c,23,5,a
mother,356834,358108,1274,Germany,G07,f,23,6,a
child,356940,358400,1460,Germany,G07,f,23,7,a
mother,358586,359135,549,Germany,G07,c,23,8,a
father,360810,361880,1070,Germany,G07,c,23,9,a
mother,367701,369674,1973,Germany,G07,f,24,1,a
father,369710,373400,3690,Germany,G07,m,24,2,a
child,371259,374143,2884,Germany,G07,m,25,1,a
mother,374400,375453,1053,Germany,G07,c,25,2,q
child,375356,375887,531,Germany,G07,m,25,3,a
mother,376365,378338,1973,Germany,G07,f,26,1,a
father,377840,380810,2970,Germany,G07,m,26,2,a
mother,380807,382497,1690,Germany,G07,f,26,3,q
father,382490,386390,3900,Germany,G07,m,26,4,a
mother,387312,393082,5770,Germany,G07,b,27,1,a
father,394110,395870,1760,Germany,G07,c,27,2,q
child,396108,398666,2558,Germany,G07,f,27,3,a
mother,397736,399329,1593,Germany,G07,c,27,4,q
father,398960,400460,1500,Germany,G07,c,27,5,a
child,400825,403772,2947,Germany,G07,m,28,1,a
mother,404170,406506,2336,Germany,G07,c,28,2,q
child,406444,406984,540,Germany,G07,m,28,3,a
mother,406940,411090,4150,Germany,G07,c,28,4,a
mother,413250,414506,1256,Germany,G07,c,28,5,q
child,414913,415489,576,Germany,G07,m,28,6,a
mother,415966,416586,620,Germany,G07,c,28,7,a
mother,426259,428807,2548,Germany,G07,f,28,8,a
father,428780,429390,610,Germany,G07,m,28,9,a
mother,430736,431949,1213,Germany,G07,f,28,10,a
father,431940,434840,2900,Germany,G07,m,28,11,a
mother,436356,437020,664,Germany,G07,f,28,12,a
father,437310,439630,2320,Germany,G07,m,28,13,a
child,444905,446391,1486,Germany,G07,f,29,1,a
father,446650,447490,840,Germany,G07,c,29,2,q
child,448028,449745,1717,Germany,G07,f,29,3,a
father,449630,452170,2540,Germany,G07,c,29,4,a
child,452781,454294,1513,Germany,G07,f,29,5,a
father,454310,464030,9720,Germany,G07,c,29,6,a
mother,462851,465497,2646,Germany,G07,f,30,1,a
mother,465887,466612,725,Germany,G07,c,31,1,a
child,467860,468382,522,Germany,G07,m,31,2,a
mother,468648,473037,4389,Germany,G07,c,31,3,q
child,471710,472338,628,Germany,G07,m,31,4,a
child,476250,476834,584,Germany,G07,m,31,5,a
mother,476993,478232,1239,Germany,G07,c,31,6,q
child,479028,479462,434,Germany,G07,m,31,7,a
father,479740,480250,510,Germany,G07,c,31,8,a
mother,479940,481082,1142,Germany,G07,b,31,9,a
child,480223,480807,584,Germany,G07,b,31,10,a
father,482080,482620,540,Germany,G07,m,31,11,a
child,483719,486267,2548,Germany,G07,b,32,1,a
mother,486444,487444,1000,Germany,G07,c,32,2,a
mother,489374,494409,5035,Germany,G07,c,32,3,a
child,498028,499143,1115,Germany,G07,b,33,1,q
mother,499993,501046,1053,Germany,G07,c,33,2,a
father,500570,501150,580,Germany,G07,c,33,3,a
mother,502108,505559,3451,Germany,G07,f,34,1,a
father,505110,508480,3370,Germany,G07,m,34,2,a
child,509170,511099,1929,Germany,G07,b,35,1,a
mother,511391,513020,1629,Germany,G07,c,35,2,a
mother,516763,518763,2000,Germany,G07,c,35,3,a
child,522170,523834,1664,Germany,G07,m,35,4,a
mother,524427,524967,540,Germany,G07,c,35,5,q
father,525690,526780,1090,Germany,G07,c,35,6,q
mother,527064,528276,1212,Germany,G07,c,35,7,q
mother,530418,531860,1442,Germany,G07,c,35,8,q
child,532108,532798,690,Germany,G07,m,35,9,a
mother,533772,537020,3248,Germany,G07,c,35,10,a
child,537276,539967,2691,Germany,G07,m,35,11,a
mother,540967,551905,10938,Germany,G07,c,35,12,a
child,555754,556524,770,Germany,G07,m,35,13,a
mother,555790,560674,4884,Germany,G07,c,35,14,a
mother,564276,565967,1691,Germany,G07,c,35,15,a
child,571630,574082,2452,Germany,G07,m,35,16,a
mother,573683,581259,7576,Germany,G07,c,35,17,q
child,582152,583551,1399,Germany,G07,c,35,18,a
mother,583400,587480,4080,Germany,G07,c,35,19,a
father,584320,585200,880,Germany,G07,c,35,20,a
child,590896,593604,2708,Germany,G07,m,35,21,a
silence,2661,2745,84,Germany,G07,NA,NA,NA,NA
silence,4621,5002,381,Germany,G07,NA,NA,NA,NA
silence,7754,7921,167,Germany,G07,NA,NA,NA,NA
silence,10210,10843,633,Germany,G07,NA,NA,NA,NA
silence,13046,14430,1384,Germany,G07,NA,NA,NA,NA
silence,15090,15143,53,Germany,G07,NA,NA,NA,NA
silence,17232,21604,4372,Germany,G07,NA,NA,NA,NA
silence,23418,25975,2557,Germany,G07,NA,NA,NA,NA
silence,26595,26958,363,Germany,G07,NA,NA,NA,NA
silence,27439,27674,235,Germany,G07,NA,NA,NA,NA
silence,29020,30984,1964,Germany,G07,NA,NA,NA,NA
silence,36905,37462,557,Germany,G07,NA,NA,NA,NA
father_gesture,39869,40889,1020,Germany,G07,NA,NA,NA,NA
mother_gesture,40691,41590,899,Germany,G07,NA,NA,NA,NA
silence,45497,47409,1912,Germany,G07,NA,NA,NA,NA
silence,50648,50657,9,Germany,G07,NA,NA,NA,NA
silence,52197,52347,150,Germany,G07,NA,NA,NA,NA
silence,53002,53205,203,Germany,G07,NA,NA,NA,NA
silence,57100,58471,1371,Germany,G07,NA,NA,NA,NA
silence,61710,61966,256,Germany,G07,NA,NA,NA,NA
silence,64082,64155,73,Germany,G07,NA,NA,NA,NA
silence,64691,64870,179,Germany,G07,NA,NA,NA,NA
silence,65650,66046,396,Germany,G07,NA,NA,NA,NA
silence,66586,68834,2248,Germany,G07,NA,NA,NA,NA
silence,70940,78100,7160,Germany,G07,NA,NA,NA,NA
silence,79030,81789,2759,Germany,G07,NA,NA,NA,NA
silence,83580,84002,422,Germany,G07,NA,NA,NA,NA
silence,92568,92586,18,Germany,G07,NA,NA,NA,NA
silence,97506,99453,1947,Germany,G07,NA,NA,NA,NA
silence,101427,101586,159,Germany,G07,NA,NA,NA,NA
silence,103621,103736,115,Germany,G07,NA,NA,NA,NA
silence,104197,106568,2371,Germany,G07,NA,NA,NA,NA
silence,110020,113657,3637,Germany,G07,NA,NA,NA,NA
silence,117117,117338,221,Germany,G07,NA,NA,NA,NA
child_gesture,117859,119148,1289,Germany,G07,NA,NA,NA,NA
silence,118745,119267,522,Germany,G07,NA,NA,NA,NA
silence,120143,120285,142,Germany,G07,NA,NA,NA,NA
silence,120728,121427,699,Germany,G07,NA,NA,NA,NA
silence,121966,122232,266,Germany,G07,NA,NA,NA,NA
silence,124745,124851,106,Germany,G07,NA,NA,NA,NA
silence,126816,127374,558,Germany,G07,NA,NA,NA,NA
silence,129161,129489,328,Germany,G07,NA,NA,NA,NA
silence,130896,131851,955,Germany,G07,NA,NA,NA,NA
child_gesture,133167,134547,1380,Germany,G07,NA,NA,NA,NA
silence,133657,135843,2186,Germany,G07,NA,NA,NA,NA
silence,136843,136913,70,Germany,G07,NA,NA,NA,NA
silence,143993,144630,637,Germany,G07,NA,NA,NA,NA
silence,146130,146205,75,Germany,G07,NA,NA,NA,NA
silence,146834,150040,3206,Germany,G07,NA,NA,NA,NA
silence,154050,157418,3368,Germany,G07,NA,NA,NA,NA
silence,160329,163152,2823,Germany,G07,NA,NA,NA,NA
silence,167055,167258,203,Germany,G07,NA,NA,NA,NA
silence,168781,169223,442,Germany,G07,NA,NA,NA,NA
silence,189170,191560,2390,Germany,G07,NA,NA,NA,NA
silence,193370,195082,1712,Germany,G07,NA,NA,NA,NA
silence,196223,205409,9186,Germany,G07,NA,NA,NA,NA
silence,208197,210728,2531,Germany,G07,NA,NA,NA,NA
silence,213002,213046,44,Germany,G07,NA,NA,NA,NA
silence,217931,218099,168,Germany,G07,NA,NA,NA,NA
silence,218931,221683,2752,Germany,G07,NA,NA,NA,NA
mother_gesture,222258,223037,779,Germany,G07,NA,NA,NA,NA
silence,224347,248090,23743,Germany,G07,NA,NA,NA,NA
silence,251931,252820,889,Germany,G07,NA,NA,NA,NA
silence,253280,255993,2713,Germany,G07,NA,NA,NA,NA
silence,258590,261660,3070,Germany,G07,NA,NA,NA,NA
child_gesture,264368,265690,1322,Germany,G07,NA,NA,NA,NA
silence,266232,266320,88,Germany,G07,NA,NA,NA,NA
silence,267600,268188,588,Germany,G07,NA,NA,NA,NA
silence,269781,270070,289,Germany,G07,NA,NA,NA,NA
silence,270780,272073,1293,Germany,G07,NA,NA,NA,NA
silence,274382,280870,6488,Germany,G07,NA,NA,NA,NA
silence,282820,282949,129,Germany,G07,NA,NA,NA,NA
silence,283391,283453,62,Germany,G07,NA,NA,NA,NA
silence,287329,287798,469,Germany,G07,NA,NA,NA,NA
silence,295860,295880,20,Germany,G07,NA,NA,NA,NA
silence,298161,300400,2239,Germany,G07,NA,NA,NA,NA
silence,302825,307825,5000,Germany,G07,NA,NA,NA,NA
silence,311690,315533,3843,Germany,G07,NA,NA,NA,NA
silence,319710,319950,240,Germany,G07,NA,NA,NA,NA
silence,324515,325949,1434,Germany,G07,NA,NA,NA,NA
silence,334391,336188,1797,Germany,G07,NA,NA,NA,NA
silence,337610,339300,1690,Germany,G07,NA,NA,NA,NA
silence,343060,346391,3331,Germany,G07,NA,NA,NA,NA
silence,352900,353577,677,Germany,G07,NA,NA,NA,NA
silence,354267,356030,1763,Germany,G07,NA,NA,NA,NA
silence,358400,358586,186,Germany,G07,NA,NA,NA,NA
silence,359135,360810,1675,Germany,G07,NA,NA,NA,NA
silence,361880,367701,5821,Germany,G07,NA,NA,NA,NA
silence,369674,369710,36,Germany,G07,NA,NA,NA,NA
silence,374143,374400,257,Germany,G07,NA,NA,NA,NA
silence,375887,376365,478,Germany,G07,NA,NA,NA,NA
silence,386390,387312,922,Germany,G07,NA,NA,NA,NA
silence,393082,394110,1028,Germany,G07,NA,NA,NA,NA
silence,395870,396108,238,Germany,G07,NA,NA,NA,NA
mother_gesture,397860,398480,620,Germany,G07,NA,NA,NA,NA
silence,400460,400825,365,Germany,G07,NA,NA,NA,NA
silence,403772,404170,398,Germany,G07,NA,NA,NA,NA
silence,411090,413250,2160,Germany,G07,NA,NA,NA,NA
silence,414506,414913,407,Germany,G07,NA,NA,NA,NA
silence,415489,415966,477,Germany,G07,NA,NA,NA,NA
silence,416586,426259,9673,Germany,G07,NA,NA,NA,NA
silence,429390,430736,1346,Germany,G07,NA,NA,NA,NA
mother_gesture,430828,432205,1377,Germany,G07,NA,NA,NA,NA
silence,434840,436356,1516,Germany,G07,NA,NA,NA,NA
silence,437020,437310,290,Germany,G07,NA,NA,NA,NA
silence,439630,444905,5275,Germany,G07,NA,NA,NA,NA
silence,446391,446650,259,Germany,G07,NA,NA,NA,NA
silence,447490,448028,538,Germany,G07,NA,NA,NA,NA
silence,452170,452781,611,Germany,G07,NA,NA,NA,NA
silence,454294,454310,16,Germany,G07,NA,NA,NA,NA
silence,465497,465887,390,Germany,G07,NA,NA,NA,NA
silence,466612,467860,1248,Germany,G07,NA,NA,NA,NA
silence,468382,468648,266,Germany,G07,NA,NA,NA,NA
silence,473037,476250,3213,Germany,G07,NA,NA,NA,NA
silence,476834,476993,159,Germany,G07,NA,NA,NA,NA
silence,478232,479028,796,Germany,G07,NA,NA,NA,NA
silence,479462,479740,278,Germany,G07,NA,NA,NA,NA
silence,481082,482080,998,Germany,G07,NA,NA,NA,NA
silence,482620,483719,1099,Germany,G07,NA,NA,NA,NA
silence,486267,486444,177,Germany,G07,NA,NA,NA,NA
silence,487444,489374,1930,Germany,G07,NA,NA,NA,NA
silence,494409,498028,3619,Germany,G07,NA,NA,NA,NA
silence,499143,499993,850,Germany,G07,NA,NA,NA,NA
silence,501150,502108,958,Germany,G07,NA,NA,NA,NA
mother_gesture,503594,505693,2099,Germany,G07,NA,NA,NA,NA
silence,508480,509170,690,Germany,G07,NA,NA,NA,NA
silence,511099,511391,292,Germany,G07,NA,NA,NA,NA
silence,513020,516763,3743,Germany,G07,NA,NA,NA,NA
silence,518763,522170,3407,Germany,G07,NA,NA,NA,NA
silence,523834,524427,593,Germany,G07,NA,NA,NA,NA
silence,524967,525690,723,Germany,G07,NA,NA,NA,NA
silence,526780,527064,284,Germany,G07,NA,NA,NA,NA
silence,528276,530418,2142,Germany,G07,NA,NA,NA,NA
silence,531860,532108,248,Germany,G07,NA,NA,NA,NA
silence,532798,533772,974,Germany,G07,NA,NA,NA,NA
silence,537020,537276,256,Germany,G07,NA,NA,NA,NA
silence,539967,540967,1000,Germany,G07,NA,NA,NA,NA
silence,551905,555754,3849,Germany,G07,NA,NA,NA,NA
silence,560674,564276,3602,Germany,G07,NA,NA,NA,NA
silence,565967,571630,5663,Germany,G07,NA,NA,NA,NA
silence,581259,582152,893,Germany,G07,NA,NA,NA,NA
silence,587480,590896,3416,Germany,G07,NA,NA,NA,NA
silence,593604,595082,1478,Germany,G07,NA,NA,NA,NA
father,31,3746,3715,Germany,G08,c,1,1,a
mother,8133,9107,974,Germany,G08,f,2,1,a
father,9257,10921,1664,Germany,G08,m,2,2,a
mother,10902,11444,542,Germany,G08,f,2,3,a
father,11453,12466,1013,Germany,G08,m,2,4,a
father,14674,15551,877,Germany,G08,m,2,5,a
mother,19565,22396,2831,Germany,G08,c,3,1,q
child,21996,23117,1121,Germany,G08,m,3,2,a
mother,22928,24370,1442,Germany,G08,c,3,3,q
child,24549,25260,711,Germany,G08,m,3,4,a
mother,26575,28338,1763,Germany,G08,c,3,5,a
mother,30928,33775,2847,Germany,G08,c,3,6,a
mother,37028,39512,2484,Germany,G08,c,3,7,a
child,43928,45765,1837,Germany,G08,m,3,8,a
mother,46012,54017,8005,Germany,G08,c,3,9,a
child,49660,50175,515,Germany,G08,m,3,10,a
mother,55960,56423,463,Germany,G08,o,4,1,a
mother,57660,58902,1242,Germany,G08,b,5,1,a
father,58870,60122,1252,Germany,G08,m,5,2,a
mother,63154,64165,1011,Germany,G08,f,6,1,a
father,64533,65268,735,Germany,G08,m,6,2,a
child,64660,66649,1989,Germany,G08,b,7,1,a
father,66621,67323,702,Germany,G08,c,7,2,q
mother,67075,67860,785,Germany,G08,c,7,3,q
father,67947,68710,763,Germany,G08,c,7,4,a
child,68007,68670,663,Germany,G08,m,7,5,a
mother,68491,69433,942,Germany,G08,c,7,6,a
father,71693,72351,658,Germany,G08,m,8,1,a
father,75307,76218,911,Germany,G08,m,8,2,a
father,79163,85776,6613,Germany,G08,m,8,3,a
mother,87012,87802,790,Germany,G08,f,8,4,a
father,88942,92340,3398,Germany,G08,m,8,5,a
mother,96370,98633,2263,Germany,G08,f,8,6,a
father,98898,99494,596,Germany,G08,m,8,7,q
father,101566,103660,2094,Germany,G08,m,8,8,a
mother,101570,104033,2463,Germany,G08,f,8,9,a
father,104782,106704,1922,Germany,G08,m,8,10,a
child,105454,108370,2916,Germany,G08,m,9,1,a
mother,107475,110012,2537,Germany,G08,c,9,2,a
child,110017,112433,2416,Germany,G08,m,9,3,a
mother,110865,111444,579,Germany,G08,c,9,4,q
father,112599,113870,1271,Germany,G08,c,9,5,a
child,113528,116854,3326,Germany,G08,b,9,6,a
mother,115433,116223,790,Germany,G08,c,9,7,a
father,116820,118876,2056,Germany,G08,c,9,8,a
child,117617,121538,3921,Germany,G08,b,9,9,a
father,121345,124583,3238,Germany,G08,c,9,10,a
child,123402,126449,3047,Germany,G08,b,9,11,a
father,125632,126301,669,Germany,G08,c,9,12,a
father,128953,130406,1453,Germany,G08,c,9,13,q
child,131081,131675,594,Germany,G08,f,9,14,a
father,132356,133284,928,Germany,G08,c,9,15,q
mother,139607,143138,3531,Germany,G08,f,9,16,a
child,149470,152281,2811,Germany,G08,m,9,17,a
child,160449,166307,5858,Germany,G08,b,10,1,q
father,166771,168174,1403,Germany,G08,c,10,2,q
child,168265,168996,731,Germany,G08,f,10,3,a
father,169345,171787,2442,Germany,G08,c,10,4,a
mother,171791,172770,979,Germany,G08,c,10,5,a
child,172786,176065,3279,Germany,G08,f,10,6,a
father,173627,174273,646,Germany,G08,c,10,7,a
father,177119,177881,762,Germany,G08,c,10,8,a
mother,177896,181870,3974,Germany,G08,c,10,9,q
father,179080,182301,3221,Germany,G08,c,10,10,a
child,182538,183417,879,Germany,G08,f,10,11,q
father,183743,188378,4635,Germany,G08,c,10,12,a
mother,196012,198760,2748,Germany,G08,c,10,13,a
child,203554,205075,1521,Germany,G08,m,10,14,a
mother,205691,209375,3684,Germany,G08,c,10,15,a
child,211781,212375,594,Germany,G08,m,10,16,a
mother,222717,231349,8632,Germany,G08,f,11,1,q
father,231478,235964,4486,Germany,G08,m,11,2,a
child,229433,235086,5653,Germany,G08,m,12,1,a
mother,234765,235996,1231,Germany,G08,c,12,2,i
child,237281,239581,2300,Germany,G08,m,12,3,a
mother,238023,239102,1079,Germany,G08,c,12,4,a
child,243233,250017,6784,Germany,G08,m,12,5,a
father,241063,242710,1647,Germany,G08,m,13,1,a
mother,242670,243144,474,Germany,G08,f,13,2,a
father,244428,246329,1901,Germany,G08,m,13,3,a
mother,246786,247365,579,Germany,G08,f,13,4,a
mother,250749,261438,10689,Germany,G08,f,13,5,a
father,261771,262400,629,Germany,G08,m,13,6,a
child,253938,255323,1385,Germany,G08,b,14,1,a
mother,281712,286660,4948,Germany,G08,f,15,1,q
father,289936,291472,1536,Germany,G08,c,16,1,a
child,291307,292281,974,Germany,G08,f,16,2,q
father,292152,300555,8403,Germany,G08,c,16,3,a
child,301017,302054,1037,Germany,G08,b,17,1,a
mother,310575,318175,7600,Germany,G08,c,18,1,a
mother,322007,324081,2074,Germany,G08,c,18,2,q
mother,327923,330281,2358,Germany,G08,c,18,3,q
child,329981,330533,552,Germany,G08,m,18,4,a
mother,330591,331765,1174,Germany,G08,c,18,5,a
child,331849,336112,4263,Germany,G08,m,18,6,a
father,340627,342295,1668,Germany,G08,b,19,1,a
mother,345938,347270,1332,Germany,G08,o,20,1,a
mother,349917,361344,11427,Germany,G08,o,20,2,a
child,368649,375817,7168,Germany,G08,b,21,1,a
father,372243,374405,2162,Germany,G08,c,21,2,a
father,376217,380944,4727,Germany,G08,c,22,1,q
child,382670,387391,4721,Germany,G08,f,22,2,a
father,388328,390575,2247,Germany,G08,c,22,3,a
child,392470,393170,700,Germany,G08,f,22,4,q
father,394081,395557,1476,Germany,G08,c,22,5,a
child,396175,397260,1085,Germany,G08,f,22,6,q
father,398232,399261,1029,Germany,G08,c,22,7,a
mother,399386,411765,12379,Germany,G08,o,24,1,q
child,414502,417117,2615,Germany,G08,f,25,1,a
father,419712,420601,889,Germany,G08,c,25,2,a
child,421512,423291,1779,Germany,G08,f,25,3,a
mother,425881,426375,494,Germany,G08,o,26,1,a
mother,434902,435386,484,Germany,G08,o,26,2,a
child,438986,441065,2079,Germany,G08,b,27,1,a
father,440634,441826,1192,Germany,G08,m,28,1,q
mother,442828,445770,2942,Germany,G08,f,28,2,a
father,454664,455454,790,Germany,G08,m,28,3,q
mother,455102,456496,1394,Germany,G08,f,28,4,a
mother,458407,459091,684,Germany,G08,f,28,5,a
child,454954,457475,2521,Germany,G08,b,29,1,a
child,473449,479178,5729,Germany,G08,b,30,1,a
father,480442,482247,1805,Germany,G08,c,30,2,q
mother,509507,511707,2200,Germany,G08,f,31,1,a
father,511660,513838,2178,Germany,G08,m,31,2,a
mother,513875,515302,1427,Germany,G08,f,31,3,a
father,517786,518428,642,Germany,G08,m,31,4,a
mother,522496,526665,4169,Germany,G08,c,32,1,a
child,526133,527786,1653,Germany,G08,b,33,1,a
child,529038,532138,3100,Germany,G08,b,34,1,a
father,532433,534460,2027,Germany,G08,c,34,2,q
child,547765,550828,3063,Germany,G08,b,34,3,q
father,550054,551781,1727,Germany,G08,c,34,4,a
child,552328,553291,963,Germany,G08,f,34,5,q
mother,552696,553844,1148,Germany,G08,c,34,6,a
father,553675,554170,495,Germany,G08,b,34,7,a
father,566217,573307,7090,Germany,G08,c,35,1,a
child,572933,573907,974,Germany,G08,f,35,2,a
father,574102,579123,5021,Germany,G08,c,35,3,a
child,589465,592591,3126,Germany,G08,f,35,4,a
father,592396,598533,6137,Germany,G08,c,35,5,q
father_gesture,3054,4403,1349,Germany,G08,NA,NA,NA,NA
silence,3746,8133,4387,Germany,G08,NA,NA,NA,NA
silence,9107,9257,150,Germany,G08,NA,NA,NA,NA
silence,11444,11453,9,Germany,G08,NA,NA,NA,NA
silence,12466,14674,2208,Germany,G08,NA,NA,NA,NA
silence,15551,19565,4014,Germany,G08,NA,NA,NA,NA
silence,24370,24549,179,Germany,G08,NA,NA,NA,NA
silence,25260,26575,1315,Germany,G08,NA,NA,NA,NA
silence,28338,30928,2590,Germany,G08,NA,NA,NA,NA
silence,33775,37028,3253,Germany,G08,NA,NA,NA,NA
silence,39512,43928,4416,Germany,G08,NA,NA,NA,NA
silence,45765,46012,247,Germany,G08,NA,NA,NA,NA
silence,54017,55960,1943,Germany,G08,NA,NA,NA,NA
silence,56423,57660,1237,Germany,G08,NA,NA,NA,NA
silence,60122,63154,3032,Germany,G08,NA,NA,NA,NA
silence,64165,64533,368,Germany,G08,NA,NA,NA,NA
silence,67860,67947,87,Germany,G08,NA,NA,NA,NA
silence,69433,71693,2260,Germany,G08,NA,NA,NA,NA
silence,72351,75307,2956,Germany,G08,NA,NA,NA,NA
silence,76218,79163,2945,Germany,G08,NA,NA,NA,NA
silence,85776,87012,1236,Germany,G08,NA,NA,NA,NA
silence,87802,88942,1140,Germany,G08,NA,NA,NA,NA
silence,92340,96370,4030,Germany,G08,NA,NA,NA,NA
silence,98633,98898,265,Germany,G08,NA,NA,NA,NA
silence,99494,101566,2072,Germany,G08,NA,NA,NA,NA
silence,104033,104782,749,Germany,G08,NA,NA,NA,NA
silence,110012,110017,5,Germany,G08,NA,NA,NA,NA
silence,112433,112599,166,Germany,G08,NA,NA,NA,NA
silence,126449,128953,2504,Germany,G08,NA,NA,NA,NA
silence,130406,131081,675,Germany,G08,NA,NA,NA,NA
silence,131675,132356,681,Germany,G08,NA,NA,NA,NA
silence,133284,139607,6323,Germany,G08,NA,NA,NA,NA
silence,143138,149470,6332,Germany,G08,NA,NA,NA,NA
silence,152281,160449,8168,Germany,G08,NA,NA,NA,NA
silence,166307,166771,464,Germany,G08,NA,NA,NA,NA
silence,168174,168265,91,Germany,G08,NA,NA,NA,NA
silence,168996,169345,349,Germany,G08,NA,NA,NA,NA
silence,171787,171791,4,Germany,G08,NA,NA,NA,NA
silence,172770,172786,16,Germany,G08,NA,NA,NA,NA
silence,176065,177119,1054,Germany,G08,NA,NA,NA,NA
silence,177881,177896,15,Germany,G08,NA,NA,NA,NA
silence,182301,182538,237,Germany,G08,NA,NA,NA,NA
silence,183417,183743,326,Germany,G08,NA,NA,NA,NA
silence,188378,196012,7634,Germany,G08,NA,NA,NA,NA
silence,198760,203554,4794,Germany,G08,NA,NA,NA,NA
child_gesture,204068,205456,1388,Germany,G08,NA,NA,NA,NA
silence,205075,205691,616,Germany,G08,NA,NA,NA,NA
mother_gesture,208043,210095,2052,Germany,G08,NA,NA,NA,NA
silence,209375,211781,2406,Germany,G08,NA,NA,NA,NA
silence,212375,222717,10342,Germany,G08,NA,NA,NA,NA
silence,235996,237281,1285,Germany,G08,NA,NA,NA,NA
silence,239581,241063,1482,Germany,G08,NA,NA,NA,NA
silence,243144,243233,89,Germany,G08,NA,NA,NA,NA
child_gesture,246537,249506,2969,Germany,G08,NA,NA,NA,NA
silence,250017,250749,732,Germany,G08,NA,NA,NA,NA
silence,261438,261771,333,Germany,G08,NA,NA,NA,NA
silence,262400,281712,19312,Germany,G08,NA,NA,NA,NA
silence,286660,289936,3276,Germany,G08,NA,NA,NA,NA
silence,300555,301017,462,Germany,G08,NA,NA,NA,NA
silence,302054,310575,8521,Germany,G08,NA,NA,NA,NA
silence,318175,322007,3832,Germany,G08,NA,NA,NA,NA
silence,324081,327923,3842,Germany,G08,NA,NA,NA,NA
silence,330533,330591,58,Germany,G08,NA,NA,NA,NA
silence,331765,331849,84,Germany,G08,NA,NA,NA,NA
silence,336112,340627,4515,Germany,G08,NA,NA,NA,NA
silence,342295,345938,3643,Germany,G08,NA,NA,NA,NA
silence,347270,349917,2647,Germany,G08,NA,NA,NA,NA
silence,361344,368649,7305,Germany,G08,NA,NA,NA,NA
silence,375817,376217,400,Germany,G08,NA,NA,NA,NA
silence,380944,382670,1726,Germany,G08,NA,NA,NA,NA
child_gesture,384039,387555,3516,Germany,G08,NA,NA,NA,NA
silence,387391,388328,937,Germany,G08,NA,NA,NA,NA
silence,390575,392470,1895,Germany,G08,NA,NA,NA,NA
child_gesture,392797,393861,1064,Germany,G08,NA,NA,NA,NA
silence,393170,394081,911,Germany,G08,NA,NA,NA,NA
silence,395557,396175,618,Germany,G08,NA,NA,NA,NA
child_gesture,396792,398479,1687,Germany,G08,NA,NA,NA,NA
silence,397260,398232,972,Germany,G08,NA,NA,NA,NA
silence,399261,399386,125,Germany,G08,NA,NA,NA,NA
silence,411765,414502,2737,Germany,G08,NA,NA,NA,NA
silence,417117,419712,2595,Germany,G08,NA,NA,NA,NA
silence,420601,421512,911,Germany,G08,NA,NA,NA,NA
silence,423291,425881,2590,Germany,G08,NA,NA,NA,NA
silence,426375,434902,8527,Germany,G08,NA,NA,NA,NA
silence,435386,438986,3600,Germany,G08,NA,NA,NA,NA
silence,441826,442828,1002,Germany,G08,NA,NA,NA,NA
silence,445770,454664,8894,Germany,G08,NA,NA,NA,NA
silence,457475,458407,932,Germany,G08,NA,NA,NA,NA
silence,459091,473449,14358,Germany,G08,NA,NA,NA,NA
silence,479178,480442,1264,Germany,G08,NA,NA,NA,NA
silence,482247,509507,27260,Germany,G08,NA,NA,NA,NA
silence,513838,513875,37,Germany,G08,NA,NA,NA,NA
silence,515302,517786,2484,Germany,G08,NA,NA,NA,NA
silence,518428,522496,4068,Germany,G08,NA,NA,NA,NA
silence,527786,529038,1252,Germany,G08,NA,NA,NA,NA
child_gesture,531870,532928,1058,Germany,G08,NA,NA,NA,NA
silence,532138,532433,295,Germany,G08,NA,NA,NA,NA
silence,534460,547765,13305,Germany,G08,NA,NA,NA,NA
silence,551781,552328,547,Germany,G08,NA,NA,NA,NA
silence,554170,566217,12047,Germany,G08,NA,NA,NA,NA
father_gesture,567792,569868,2076,Germany,G08,NA,NA,NA,NA
father_gesture,573181,574506,1325,Germany,G08,NA,NA,NA,NA
silence,573907,574102,195,Germany,G08,NA,NA,NA,NA
silence,579123,589465,10342,Germany,G08,NA,NA,NA,NA
father,2071,5828,3757,Germany,G09,c,1,1,a
father,7452,11386,3934,Germany,G09,m,2,1,q
mother,10254,10823,569,Germany,G09,f,2,2,a
father,12331,13916,1585,Germany,G09,m,2,3,a
child,12731,18685,5954,Germany,G09,m,2,4,a
mother,18463,21463,3000,Germany,G09,c,2,5,a
child,27112,29342,2230,Germany,G09,m,2,6,q
mother,29110,30281,1171,Germany,G09,c,2,7,a
mother,16165,17651,1486,Germany,G09,o,3,1,q
mother,21861,23916,2055,Germany,G09,o,3,2,q
mother,30883,32497,1614,Germany,G09,o,3,3,a
mother,35336,38839,3503,Germany,G09,o,3,4,q
child,44183,46643,2460,Germany,G09,m,3,5,a
mother,46242,48397,2155,Germany,G09,o,3,6,a
child,49590,53032,3442,Germany,G09,m,4,1,q
mother,52679,53684,1005,Germany,G09,c,4,2,q
child,53714,54254,540,Germany,G09,m,4,3,a
mother,54845,55447,602,Germany,G09,c,4,4,a
child,55484,56563,1079,Germany,G09,m,4,5,a
father,55071,58756,3685,Germany,G09,m,5,1,q
mother,57458,60325,2867,Germany,G09,f,5,2,a
father,61436,63613,2177,Germany,G09,m,5,3,a
father,65602,70723,5121,Germany,G09,m,6,1,a
mother,70613,71060,447,Germany,G09,f,6,2,a
mother,72591,74977,2386,Germany,G09,o,7,1,q
father,79911,81695,1784,Germany,G09,m,8,1,q
mother,81298,81939,641,Germany,G09,f,8,2,a
child,85475,87431,1956,Germany,G09,b,8,3,a
mother,87800,88336,536,Germany,G09,c,8,4,a
father,89314,90740,1426,Germany,G09,c,8,5,a
child,92776,96041,3265,Germany,G09,b,8,6,a
mother,94756,96287,1531,Germany,G09,o,9,1,q
mother,98756,100055,1299,Germany,G09,o,9,2,q
child,100386,103714,3328,Germany,G09,m,9,3,a
father,103497,104723,1226,Germany,G09,c,9,4,a
father,108270,109707,1437,Germany,G09,m,10,1,q
mother,110397,110916,519,Germany,G09,f,10,2,a
father,112049,113729,1680,Germany,G09,m,11,1,a
mother,113812,114381,569,Germany,G09,f,11,2,a
child,116165,118289,2124,Germany,G09,m,12,1,a
mother,118254,122071,3817,Germany,G09,c,12,2,a
child,121917,122271,354,Germany,G09,m,12,3,a
mother,123143,124651,1508,Germany,G09,c,12,4,a
mother,127701,128121,420,Germany,G09,c,12,5,a
child,130121,130908,787,Germany,G09,m,12,6,q
mother,130883,133568,2685,Germany,G09,c,12,7,q
child,134785,136431,1646,Germany,G09,m,12,8,a
mother,136088,137828,1740,Germany,G09,c,12,9,a
father,120867,122093,1226,Germany,G09,m,13,1,q
mother,122325,122867,542,Germany,G09,f,13,2,a
father,138718,139259,541,Germany,G09,m,14,1,a
father,144088,147618,3530,Germany,G09,c,15,1,i
child,149731,150431,700,Germany,G09,b,15,2,a
mother,151944,155137,3193,Germany,G09,c,15,3,a
father,152066,155187,3121,Germany,G09,c,15,4,a
child,155138,156475,1337,Germany,G09,b,15,5,a
mother,156414,157226,812,Germany,G09,c,15,6,a
father,156513,157160,647,Germany,G09,c,15,7,a
father,158806,159961,1155,Germany,G09,o,15,8,a
mother,161795,162762,967,Germany,G09,o,16,1,a
father,162077,163419,1342,Germany,G09,m,17,1,a
mother,163458,164287,829,Germany,G09,f,17,2,a
father,168259,174215,5956,Germany,G09,m,18,1,a
mother,174093,176751,2658,Germany,G09,f,18,2,a
father,174983,175640,657,Germany,G09,m,18,3,a
father,176817,181817,5000,Germany,G09,m,18,4,a
child,176793,177448,655,Germany,G09,m,19,1,a
mother,178944,184016,5072,Germany,G09,c,19,2,q
mother,186071,188381,2310,Germany,G09,c,19,3,i
father,182458,183325,867,Germany,G09,m,20,1,q
father,188088,190762,2674,Germany,G09,m,20,2,q
mother,190900,191594,694,Germany,G09,f,20,3,a
mother,191624,192806,1182,Germany,G09,c,21,1,a
father,191762,193828,2066,Germany,G09,m,22,1,q
mother,193928,195038,1110,Germany,G09,f,22,2,a
father,195143,197066,1923,Germany,G09,m,22,3,a
father,199563,200662,1099,Germany,G09,m,22,4,a
father,206038,213651,7613,Germany,G09,m,22,5,a
mother,206640,207182,542,Germany,G09,f,22,6,q
mother,204270,205883,1613,Germany,G09,o,23,1,a
mother,211347,212966,1619,Germany,G09,o,23,2,q
mother,215823,219872,4049,Germany,G09,c,23,3,a
father,217093,221231,4138,Germany,G09,c,23,4,a
child,221811,224006,2195,Germany,G09,b,24,1,q
mother,224038,224812,774,Germany,G09,c,24,2,a
father,224353,225475,1122,Germany,G09,m,25,1,q
mother,225950,227430,1480,Germany,G09,f,25,2,a
mother,230546,235281,4735,Germany,G09,f,26,1,a
father,235585,237778,2193,Germany,G09,m,27,1,q
mother,237944,239176,1232,Germany,G09,f,27,2,a
child,244307,245156,849,Germany,G09,b,27,3,a
father,247508,248712,1204,Germany,G09,c,27,4,a
mother,248209,248784,575,Germany,G09,f,27,5,a
father,253972,255143,1171,Germany,G09,m,28,1,a
father,257519,258712,1193,Germany,G09,m,28,2,a
child,258687,260643,1956,Germany,G09,m,29,1,a
child,264988,266059,1071,Germany,G09,m,29,2,a
mother,266579,267088,509,Germany,G09,c,29,3,q
child,276749,277581,832,Germany,G09,m,29,4,a
mother,277254,280977,3723,Germany,G09,c,29,5,a
child,284351,285280,929,Germany,G09,m,29,6,a
mother,286314,286701,387,Germany,G09,c,29,7,q
child,287307,288227,920,Germany,G09,m,29,8,a
mother,287894,292475,4581,Germany,G09,c,29,9,q
mother,306182,307756,1574,Germany,G09,c,29,10,q
child,307838,308776,938,Germany,G09,m,29,11,a
mother,308629,311143,2514,Germany,G09,c,29,12,a
father,261718,262784,1066,Germany,G09,m,30,1,q
mother,263320,263955,635,Germany,G09,f,30,2,a
mother,268856,270231,1375,Germany,G09,o,31,1,q
mother,272270,272905,635,Germany,G09,o,31,2,a
father,277231,280353,3122,Germany,G09,m,32,1,q
mother,281060,283640,2580,Germany,G09,f,32,2,a
father,283690,284679,989,Germany,G09,m,32,3,a
father,300922,302916,1994,Germany,G09,o,33,1,a
father,309292,311662,2370,Germany,G09,o,34,1,a
mother,313016,314381,1365,Germany,G09,f,34,2,a
father,314662,317165,2503,Germany,G09,m,34,3,a
mother,317237,322778,5541,Germany,G09,f,34,4,a
father,322718,323497,779,Germany,G09,m,34,5,a
mother,325939,326336,397,Germany,G09,o,34,6,a
father,326513,327955,1442,Germany,G09,m,35,1,q
mother,327944,330762,2818,Germany,G09,f,35,2,a
child,333094,333988,894,Germany,G09,m,36,1,a
mother,334613,339066,4453,Germany,G09,c,36,2,q
father,336618,338110,1492,Germany,G09,m,36,3,a
child,342431,347174,4743,Germany,G09,m,36,4,a
mother,346303,348668,2365,Germany,G09,c,36,5,a
child,348094,356271,8177,Germany,G09,m,36,6,a
father,352204,354640,2436,Germany,G09,m,36,7,q
father,362701,365591,2890,Germany,G09,o,37,1,i
mother,378414,382082,3668,Germany,G09,o,37,2,i
mother,386502,390342,3840,Germany,G09,o,37,3,a
child,393342,394395,1053,Germany,G09,b,38,1,a
father,396563,399021,2458,Germany,G09,c,38,2,q
mother,395502,400812,5310,Germany,G09,f,39,1,a
father,401812,403254,1442,Germany,G09,m,39,2,a
mother,402414,403143,729,Germany,G09,f,39,3,q
father,403673,404342,669,Germany,G09,m,39,4,a
child,406085,407448,1363,Germany,G09,f,40,1,a
mother,408922,413126,4204,Germany,G09,c,40,2,q
father,413115,414922,1807,Germany,G09,m,40,3,a
mother,416104,416762,658,Germany,G09,f,40,4,a
father,422254,424718,2464,Germany,G09,m,40,5,a
child,425661,429776,4115,Germany,G09,m,41,1,a
mother,429911,431165,1254,Germany,G09,c,41,2,q
father,430662,432033,1371,Germany,G09,c,41,3,a
mother,433044,433629,585,Germany,G09,c,41,4,q
child,433785,435068,1283,Germany,G09,m,41,5,a
mother,435071,436441,1370,Germany,G09,c,41,6,q
child,436200,437298,1098,Germany,G09,m,41,7,a
mother,442999,445347,2348,Germany,G09,c,41,8,q
child,445501,449563,4062,Germany,G09,m,41,9,a
mother,448662,450712,2050,Germany,G09,c,41,10,a
father,439375,449894,10519,Germany,G09,o,42,1,a
father,450458,452972,2514,Germany,G09,m,43,1,a
child,456581,457705,1124,Germany,G09,m,44,1,q
child,459121,460563,1442,Germany,G09,m,44,2,a
mother,462038,464723,2685,Germany,G09,c,44,3,a
child,465510,467616,2106,Germany,G09,m,44,4,q
mother,467712,471154,3442,Germany,G09,c,44,5,a
father,456696,458309,1613,Germany,G09,m,45,1,q
mother,458370,461082,2712,Germany,G09,f,45,2,a
father,466861,468878,2017,Germany,G09,m,46,1,q
mother,475099,476856,1757,Germany,G09,o,47,1,q
father,477972,480950,2978,Germany,G09,m,48,1,a
father,490568,492425,1857,Germany,G09,m,49,1,q
mother,492928,505430,12502,Germany,G09,f,49,2,a
father,506143,506867,724,Germany,G09,m,49,3,q
mother,506977,511254,4277,Germany,G09,f,49,4,a
mother,512696,523629,10933,Germany,G09,f,49,5,a
father,524751,526370,1619,Germany,G09,m,49,6,q
mother,526607,531800,5193,Germany,G09,f,49,7,a
mother,534828,539905,5077,Germany,G09,f,49,8,a
mother,542486,544292,1806,Germany,G09,f,49,9,a
father,510082,511701,1619,Germany,G09,m,50,1,q
mother,511795,512430,635,Germany,G09,f,50,2,a
mother,547491,552745,5254,Germany,G09,c,51,1,q
child,553165,554377,1212,Germany,G09,b,51,2,a
father,554463,558662,4199,Germany,G09,c,51,3,q
child,558714,559139,425,Germany,G09,f,51,4,a
father,560342,564977,4635,Germany,G09,c,51,5,q
mother,561033,562441,1408,Germany,G09,o,52,1,a
mother,578138,579187,1049,Germany,G09,b,53,1,a
father,580292,581044,752,Germany,G09,o,53,2,a
mother,581535,582696,1161,Germany,G09,b,53,3,q
child,582696,585316,2620,Germany,G09,m,53,4,a
mother,584784,585618,834,Germany,G09,c,53,5,q
child,585900,587908,2008,Germany,G09,m,53,6,a
mother,587530,588397,867,Germany,G09,b,53,7,q
child,588652,589280,628,Germany,G09,m,53,8,a
mother,589646,590248,602,Germany,G09,c,53,9,a
child,590988,591873,885,Germany,G09,f,53,10,q
father,591917,593535,1618,Germany,G09,c,53,11,a
child,598139,599581,1442,Germany,G09,m,53,12,a
silence,5828,7452,1624,Germany,G09,NA,NA,NA,NA
silence,11386,12331,945,Germany,G09,NA,NA,NA,NA
mother_gesture,19797,20634,837,Germany,G09,NA,NA,NA,NA
silence,21463,21861,398,Germany,G09,NA,NA,NA,NA
mother_gesture,21631,23335,1704,Germany,G09,NA,NA,NA,NA
silence,23916,27112,3196,Germany,G09,NA,NA,NA,NA
mother_gesture,29052,29892,840,Germany,G09,NA,NA,NA,NA
silence,30281,30883,602,Germany,G09,NA,NA,NA,NA
silence,32497,35336,2839,Germany,G09,NA,NA,NA,NA
silence,38839,44183,5344,Germany,G09,NA,NA,NA,NA
silence,48397,49590,1193,Germany,G09,NA,NA,NA,NA
silence,53684,53714,30,Germany,G09,NA,NA,NA,NA
silence,54254,54845,591,Germany,G09,NA,NA,NA,NA
silence,60325,61436,1111,Germany,G09,NA,NA,NA,NA
silence,63613,65602,1989,Germany,G09,NA,NA,NA,NA
silence,71060,72591,1531,Germany,G09,NA,NA,NA,NA
silence,74977,79911,4934,Germany,G09,NA,NA,NA,NA
silence,81939,85475,3536,Germany,G09,NA,NA,NA,NA
silence,87431,87800,369,Germany,G09,NA,NA,NA,NA
silence,88336,89314,978,Germany,G09,NA,NA,NA,NA
silence,90740,92776,2036,Germany,G09,NA,NA,NA,NA
silence,96287,98756,2469,Germany,G09,NA,NA,NA,NA
silence,100055,100386,331,Germany,G09,NA,NA,NA,NA
silence,104723,108270,3547,Germany,G09,NA,NA,NA,NA
silence,109707,110397,690,Germany,G09,NA,NA,NA,NA
silence,110916,112049,1133,Germany,G09,NA,NA,NA,NA
silence,113729,113812,83,Germany,G09,NA,NA,NA,NA
silence,114381,116165,1784,Germany,G09,NA,NA,NA,NA
silence,122271,122325,54,Germany,G09,NA,NA,NA,NA
silence,122867,123143,276,Germany,G09,NA,NA,NA,NA
silence,124651,127701,3050,Germany,G09,NA,NA,NA,NA
silence,128121,130121,2000,Germany,G09,NA,NA,NA,NA
silence,133568,134785,1217,Germany,G09,NA,NA,NA,NA
silence,137828,138718,890,Germany,G09,NA,NA,NA,NA
silence,139259,144088,4829,Germany,G09,NA,NA,NA,NA
silence,147618,149731,2113,Germany,G09,NA,NA,NA,NA
silence,150431,151944,1513,Germany,G09,NA,NA,NA,NA
silence,157226,158806,1580,Germany,G09,NA,NA,NA,NA
silence,159961,161795,1834,Germany,G09,NA,NA,NA,NA
silence,163419,163458,39,Germany,G09,NA,NA,NA,NA
silence,164287,168259,3972,Germany,G09,NA,NA,NA,NA
silence,176751,176793,42,Germany,G09,NA,NA,NA,NA
silence,184016,186071,2055,Germany,G09,NA,NA,NA,NA
silence,190762,190900,138,Germany,G09,NA,NA,NA,NA
silence,191594,191624,30,Germany,G09,NA,NA,NA,NA
silence,193828,193928,100,Germany,G09,NA,NA,NA,NA
silence,195038,195143,105,Germany,G09,NA,NA,NA,NA
silence,197066,199563,2497,Germany,G09,NA,NA,NA,NA
silence,200662,204270,3608,Germany,G09,NA,NA,NA,NA
silence,205883,206038,155,Germany,G09,NA,NA,NA,NA
silence,213651,215823,2172,Germany,G09,NA,NA,NA,NA
silence,221231,221811,580,Germany,G09,NA,NA,NA,NA
silence,224006,224038,32,Germany,G09,NA,NA,NA,NA
silence,225475,225950,475,Germany,G09,NA,NA,NA,NA
silence,227430,230546,3116,Germany,G09,NA,NA,NA,NA
silence,235281,235585,304,Germany,G09,NA,NA,NA,NA
silence,237778,237944,166,Germany,G09,NA,NA,NA,NA
silence,239176,244307,5131,Germany,G09,NA,NA,NA,NA
silence,245156,247508,2352,Germany,G09,NA,NA,NA,NA
silence,248784,253972,5188,Germany,G09,NA,NA,NA,NA
silence,255143,257519,2376,Germany,G09,NA,NA,NA,NA
silence,260643,261718,1075,Germany,G09,NA,NA,NA,NA
silence,262784,263320,536,Germany,G09,NA,NA,NA,NA
silence,263955,264988,1033,Germany,G09,NA,NA,NA,NA
silence,266059,266579,520,Germany,G09,NA,NA,NA,NA
silence,267088,268856,1768,Germany,G09,NA,NA,NA,NA
silence,270231,272270,2039,Germany,G09,NA,NA,NA,NA
silence,272905,276749,3844,Germany,G09,NA,NA,NA,NA
silence,280977,281060,83,Germany,G09,NA,NA,NA,NA
silence,283640,283690,50,Germany,G09,NA,NA,NA,NA
silence,285280,286314,1034,Germany,G09,NA,NA,NA,NA
silence,286701,287307,606,Germany,G09,NA,NA,NA,NA
silence,292475,300922,8447,Germany,G09,NA,NA,NA,NA
silence,302916,306182,3266,Germany,G09,NA,NA,NA,NA
mother_gesture,307087,307597,510,Germany,G09,NA,NA,NA,NA
silence,307756,307838,82,Germany,G09,NA,NA,NA,NA
silence,311662,313016,1354,Germany,G09,NA,NA,NA,NA
silence,314381,314662,281,Germany,G09,NA,NA,NA,NA
silence,317165,317237,72,Germany,G09,NA,NA,NA,NA
silence,323497,325939,2442,Germany,G09,NA,NA,NA,NA
silence,326336,326513,177,Germany,G09,NA,NA,NA,NA
silence,330762,333094,2332,Germany,G09,NA,NA,NA,NA
silence,333988,334613,625,Germany,G09,NA,NA,NA,NA
silence,339066,342431,3365,Germany,G09,NA,NA,NA,NA
silence,356271,362701,6430,Germany,G09,NA,NA,NA,NA
silence,365591,378414,12823,Germany,G09,NA,NA,NA,NA
silence,382082,386502,4420,Germany,G09,NA,NA,NA,NA
silence,390342,393342,3000,Germany,G09,NA,NA,NA,NA
silence,394395,395502,1107,Germany,G09,NA,NA,NA,NA
silence,400812,401812,1000,Germany,G09,NA,NA,NA,NA
silence,403254,403673,419,Germany,G09,NA,NA,NA,NA
silence,404342,406085,1743,Germany,G09,NA,NA,NA,NA
silence,407448,408922,1474,Germany,G09,NA,NA,NA,NA
silence,414922,416104,1182,Germany,G09,NA,NA,NA,NA
silence,416762,422254,5492,Germany,G09,NA,NA,NA,NA
silence,424718,425661,943,Germany,G09,NA,NA,NA,NA
silence,429776,429911,135,Germany,G09,NA,NA,NA,NA
father_gesture,430768,431276,508,Germany,G09,NA,NA,NA,NA
silence,432033,433044,1011,Germany,G09,NA,NA,NA,NA
silence,433629,433785,156,Germany,G09,NA,NA,NA,NA
silence,435068,435071,3,Germany,G09,NA,NA,NA,NA
silence,437298,439375,2077,Germany,G09,NA,NA,NA,NA
father_gesture,442837,444667,1830,Germany,G09,NA,NA,NA,NA
mother_gesture,444093,444707,614,Germany,G09,NA,NA,NA,NA
father_gesture,446888,447188,300,Germany,G09,NA,NA,NA,NA
father_gesture,449176,449712,536,Germany,G09,NA,NA,NA,NA
silence,452972,456581,3609,Germany,G09,NA,NA,NA,NA
silence,458309,458370,61,Germany,G09,NA,NA,NA,NA
silence,461082,462038,956,Germany,G09,NA,NA,NA,NA
mother_gesture,462592,463282,690,Germany,G09,NA,NA,NA,NA
silence,464723,465510,787,Germany,G09,NA,NA,NA,NA
mother_gesture,468474,468742,268,Germany,G09,NA,NA,NA,NA
silence,471154,475099,3945,Germany,G09,NA,NA,NA,NA
silence,476856,477972,1116,Germany,G09,NA,NA,NA,NA
silence,480950,490568,9618,Germany,G09,NA,NA,NA,NA
silence,492425,492928,503,Germany,G09,NA,NA,NA,NA
silence,505430,506143,713,Germany,G09,NA,NA,NA,NA
silence,506867,506977,110,Germany,G09,NA,NA,NA,NA
silence,511701,511795,94,Germany,G09,NA,NA,NA,NA
silence,512430,512696,266,Germany,G09,NA,NA,NA,NA
silence,523629,524751,1122,Germany,G09,NA,NA,NA,NA
silence,526370,526607,237,Germany,G09,NA,NA,NA,NA
silence,531800,534828,3028,Germany,G09,NA,NA,NA,NA
silence,539905,542486,2581,Germany,G09,NA,NA,NA,NA
silence,544292,547491,3199,Germany,G09,NA,NA,NA,NA
silence,552745,553165,420,Germany,G09,NA,NA,NA,NA
silence,554377,554463,86,Germany,G09,NA,NA,NA,NA
silence,558662,558714,52,Germany,G09,NA,NA,NA,NA
silence,559139,560342,1203,Germany,G09,NA,NA,NA,NA
silence,564977,578138,13161,Germany,G09,NA,NA,NA,NA
silence,579187,580292,1105,Germany,G09,NA,NA,NA,NA
father_gesture,580010,580723,713,Germany,G09,NA,NA,NA,NA
silence,581044,581535,491,Germany,G09,NA,NA,NA,NA
silence,585618,585900,282,Germany,G09,NA,NA,NA,NA
silence,588397,588652,255,Germany,G09,NA,NA,NA,NA
silence,589280,589646,366,Germany,G09,NA,NA,NA,NA
silence,590248,590988,740,Germany,G09,NA,NA,NA,NA
silence,591873,591917,44,Germany,G09,NA,NA,NA,NA
silence,593535,598139,4604,Germany,G09,NA,NA,NA,NA
child,313,3910,3597,Germany,G10,b,1,1,a
child,5520,6900,1380,Germany,G10,b,1,2,a
father,4610,8040,3430,Germany,G10,m,2,1,a
mother,8580,9640,1060,Germany,G10,f,2,2,a
father,9850,11340,1490,Germany,G10,m,2,3,a
father,14140,17440,3300,Germany,G10,m,2,4,a
mother,17190,17560,370,Germany,G10,f,2,5,q
father,17750,21640,3890,Germany,G10,m,2,6,a
mother,24190,25150,960,Germany,G10,f,2,7,i
father,27780,29490,1710,Germany,G10,m,2,8,a
mother,30740,32050,1310,Germany,G10,f,2,9,a
father,37410,38410,1000,Germany,G10,m,2,10,a
child,15830,16740,910,Germany,G10,o,3,1,a
child,22150,22950,800,Germany,G10,o,3,2,i
child,25740,26470,730,Germany,G10,o,3,3,a
child,29070,32140,3070,Germany,G10,o,3,4,a
child,35080,35530,450,Germany,G10,f,4,1,a
child,37940,39320,1380,Germany,G10,f,4,2,a
father,39420,40100,680,Germany,G10,c,4,3,a
father,40180,47740,7560,Germany,G10,c,5,1,a
child,48100,53340,5240,Germany,G10,b,6,1,a
father,53480,54530,1050,Germany,G10,c,6,2,q
child,54760,55320,560,Germany,G10,f,6,3,a
father,55270,56590,1320,Germany,G10,c,6,4,a
child,57560,58870,1310,Germany,G10,b,7,1,a
father,58530,59970,1440,Germany,G10,c,7,2,a
mother,61290,63410,2120,Germany,G10,c,7,3,a
child,63250,65110,1860,Germany,G10,f,8,1,i
father,65750,67480,1730,Germany,G10,c,8,2,a
child,67893,68413,520,Germany,G10,f,8,3,a
father,68430,70450,2020,Germany,G10,c,8,4,a
child,71890,74640,2750,Germany,G10,f,8,5,a
father,74030,75530,1500,Germany,G10,c,8,6,a
mother,75030,80280,5250,Germany,G10,c,8,7,q
child,81350,81860,510,Germany,G10,m,8,8,a
child,83620,86360,2740,Germany,G10,f,8,9,i
father,86090,86840,750,Germany,G10,c,8,10,a
father,86890,88290,1400,Germany,G10,f,8,11,q
child,88988,89760,772,Germany,G10,f,8,12,a
mother,89380,89990,610,Germany,G10,f,8,13,a
child,90570,92530,1960,Germany,G10,f,8,14,a
father,92290,92790,500,Germany,G10,c,8,15,q
mother,92450,95040,2590,Germany,G10,c,8,16,a
child,95340,95910,570,Germany,G10,m,8,17,a
father,95950,98210,2260,Germany,G10,c,8,18,a
mother,69980,71420,1440,Germany,G10,f,9,1,i
child,99280,100110,830,Germany,G10,f,9,2,a
mother,98080,99270,1190,Germany,G10,o,10,1,a
child,103790,105000,1210,Germany,G10,f,11,1,q
father,105080,106600,1520,Germany,G10,c,11,2,a
child,107540,110810,3270,Germany,G10,f,11,3,a
father,112050,113050,1000,Germany,G10,c,11,4,a
mother,113470,114030,560,Germany,G10,c,11,5,a
child,114780,118050,3270,Germany,G10,f,11,6,a
father,117460,119850,2390,Germany,G10,c,11,7,a
child,120510,123960,3450,Germany,G10,f,11,8,a
father,124220,127090,2870,Germany,G10,c,11,9,a
child,127620,131280,3660,Germany,G10,f,11,10,a
father,131260,133230,1970,Germany,G10,c,12,1,i
father,136220,137350,1130,Germany,G10,c,12,2,a
mother,138880,140130,1250,Germany,G10,c,13,1,a
child,140290,141540,1250,Germany,G10,m,13,2,a
father,142940,143880,940,Germany,G10,b,14,1,a
mother,148420,149370,950,Germany,G10,b,14,2,a
mother,152210,153010,800,Germany,G10,c,14,3,a
child,155180,156940,1760,Germany,G10,m,15,1,i
mother,156210,156730,520,Germany,G10,c,15,2,a
child,157460,158230,770,Germany,G10,b,15,3,a
mother,157960,159290,1330,Germany,G10,f,16,1,q
father,160120,161180,1060,Germany,G10,m,16,2,a
mother,163200,163630,430,Germany,G10,f,16,3,q
child,162930,165790,2860,Germany,G10,b,17,1,a
mother,169230,170610,1380,Germany,G10,c,18,1,q
father,171180,173380,2200,Germany,G10,b,18,2,a
child,176970,177750,780,Germany,G10,b,19,1,a
mother,179130,179950,820,Germany,G10,c,19,2,a
child,181590,187980,6390,Germany,G10,m,19,3,a
mother,188180,189120,940,Germany,G10,c,19,4,a
mother,199330,203810,4480,Germany,G10,c,19,5,a
mother,191310,192670,1360,Germany,G10,f,20,1,q
father,192500,195600,3100,Germany,G10,m,20,2,a
child,204040,204980,940,Germany,G10,b,21,1,a
mother,205260,208960,3700,Germany,G10,c,21,2,a
father,205410,206180,770,Germany,G10,c,21,3,a
mother,214680,216150,1470,Germany,G10,f,22,1,a
father,223600,231500,7900,Germany,G10,m,23,1,a
father,235280,239070,3790,Germany,G10,m,24,1,q
mother,239480,239880,400,Germany,G10,f,24,2,q
father,239910,241520,1610,Germany,G10,m,24,3,a
mother,242300,243180,880,Germany,G10,f,24,4,a
father,242910,244080,1170,Germany,G10,m,24,5,a
mother,247700,248160,460,Germany,G10,f,24,6,a
child,251140,252680,1540,Germany,G10,b,25,1,a
mother,254430,256960,2530,Germany,G10,c,25,2,q
child,258110,261490,3380,Germany,G10,m,25,3,a
father,267170,268200,1030,Germany,G10,c,25,4,q
mother,269040,270500,1460,Germany,G10,b,25,5,a
father,270930,271770,840,Germany,G10,m,25,6,q
child,273260,274340,1080,Germany,G10,m,25,7,q
father,274190,276320,2130,Germany,G10,c,25,8,a
mother,278730,279760,1030,Germany,G10,c,25,9,a
child,280310,282810,2500,Germany,G10,b,26,1,a
father,283830,285040,1210,Germany,G10,c,26,2,q
child,285300,290770,5470,Germany,G10,f,26,3,a
mother,290270,292640,2370,Germany,G10,c,26,4,a
child,292880,293850,970,Germany,G10,m,26,5,a
mother,294240,294950,710,Germany,G10,c,26,6,a
child,296940,298980,2040,Germany,G10,b,26,7,a
mother,298090,300850,2760,Germany,G10,c,26,8,a
father,303130,306820,3690,Germany,G10,c,26,9,a
child,307280,309270,1990,Germany,G10,b,26,10,a
mother,308730,312120,3390,Germany,G10,c,26,11,a
child,314160,315230,1070,Germany,G10,b,26,12,a
father,317690,320820,3130,Germany,G10,m,26,13,a
mother,320990,321580,590,Germany,G10,f,26,14,q
child,321900,326010,4110,Germany,G10,f,27,1,a
mother,327170,328064,894,Germany,G10,c,27,2,q
child,328540,335290,6750,Germany,G10,m,27,3,a
mother,336180,339440,3260,Germany,G10,c,27,4,q
father,339520,340120,600,Germany,G10,m,27,5,a
child,340200,341980,1780,Germany,G10,m,27,6,a
mother,341590,344620,3030,Germany,G10,c,27,7,q
child,346500,348900,2400,Germany,G10,m,27,8,a
mother,348730,353980,5250,Germany,G10,c,27,9,a
child,354480,355862,1382,Germany,G10,m,27,10,a
mother,356010,357940,1930,Germany,G10,c,27,11,i
mother,322640,325730,3090,Germany,G10,f,28,1,q
child,362080,363070,990,Germany,G10,b,28,2,a
mother,363220,366160,2940,Germany,G10,c,28,3,a
child,366520,367750,1230,Germany,G10,b,29,1,a
mother,368450,370340,1890,Germany,G10,c,29,2,a
father,381320,388620,7300,Germany,G10,m,30,1,a
mother,388170,389390,1220,Germany,G10,f,30,2,a
father,389660,394140,4480,Germany,G10,b,30,3,a
child,394400,394570,170,Germany,G10,f,30,4,a
father,394750,403420,8670,Germany,G10,c,30,5,a
mother,394810,396610,1800,Germany,G10,c,30,6,a
child,398730,401430,2700,Germany,G10,b,31,1,a
child,403780,407910,4130,Germany,G10,f,31,2,i
father,407860,409490,1630,Germany,G10,c,31,3,q
father,410800,412880,2080,Germany,G10,c,31,4,a
child,413310,413840,530,Germany,G10,f,31,5,a
father,413640,416150,2510,Germany,G10,c,31,6,a
mother,415730,416310,580,Germany,G10,c,31,7,a
father,416570,417780,1210,Germany,G10,c,31,8,a
child,417660,419100,1440,Germany,G10,b,31,9,a
mother,418050,419270,1220,Germany,G10,c,31,10,a
father,421080,422450,1370,Germany,G10,c,31,11,a
child,421910,423050,1140,Germany,G10,m,32,1,a
mother,423150,424140,990,Germany,G10,c,32,2,i
father,424480,425360,880,Germany,G10,c,32,3,q
mother,425570,426820,1250,Germany,G10,c,32,4,a
child,429030,430650,1620,Germany,G10,m,32,5,q
father,431140,436150,5010,Germany,G10,c,32,6,a
child,437490,441020,3530,Germany,G10,b,33,1,q
mother,441910,442240,330,Germany,G10,c,33,2,q
father,442390,443620,1230,Germany,G10,c,33,3,a
child,442570,443040,470,Germany,G10,b,33,4,a
mother,443440,444100,660,Germany,G10,c,33,5,a
mother,449580,450570,990,Germany,G10,c,34,1,a
mother,456000,458855,2855,Germany,G10,c,34,2,a
child,459130,464860,5730,Germany,G10,b,35,1,a
mother,465130,465660,530,Germany,G10,c,35,2,q
child,465630,466830,1200,Germany,G10,b,35,3,a
child,471800,479140,7340,Germany,G10,m,36,1,q
mother,479130,479910,780,Germany,G10,c,36,2,a
child,482330,483410,1080,Germany,G10,m,36,3,a
mother,484200,485193,993,Germany,G10,c,36,4,q
child,486300,489617,3317,Germany,G10,m,36,5,a
child,492990,493830,840,Germany,G10,m,37,1,a
mother,494660,495398,738,Germany,G10,c,37,2,q
mother,496630,498380,1750,Germany,G10,c,37,3,a
child,498330,499600,1270,Germany,G10,m,37,4,q
mother,499540,501282,1742,Germany,G10,c,37,5,a
mother,504070,504750,680,Germany,G10,c,37,6,a
father,507660,510830,3170,Germany,G10,m,38,1,a
child,513820,516330,2510,Germany,G10,b,39,1,q
father,516230,517980,1750,Germany,G10,c,39,2,a
mother,518200,519660,1460,Germany,G10,f,40,1,q
father,520180,523910,3730,Germany,G10,m,40,2,a
mother,525760,532340,6580,Germany,G10,f,40,3,a
father,532400,533950,1550,Germany,G10,m,40,4,q
mother,537130,539250,2120,Germany,G10,f,40,5,a
child,525570,526110,540,Germany,G10,f,41,1,i
child,560410,562510,2100,Germany,G10,f,42,1,a
father,562290,564100,1810,Germany,G10,c,42,2,q
father,564650,567660,3010,Germany,G10,c,43,1,q
child,568627,571020,2393,Germany,G10,f,43,2,a
father,570910,571940,1030,Germany,G10,c,43,3,q
child,572800,577510,4710,Germany,G10,f,43,4,a
father,577590,578620,1030,Germany,G10,c,43,5,q
mother,578120,579210,1090,Germany,G10,c,43,6,q
father,579500,580800,1300,Germany,G10,c,43,7,q
child,581710,589130,7420,Germany,G10,f,43,8,a
father,589220,590290,1070,Germany,G10,c,43,9,q
child,590430,597080,6650,Germany,G10,f,43,10,a
mother,597340,598540,1200,Germany,G10,c,43,11,q
child,599070,599770,700,Germany,G10,m,43,12,a
mother,600300,601350,1050,Germany,G10,c,43,13,q
silence,3910,4610,700,Germany,G10,NA,NA,NA,NA
silence,8040,8580,540,Germany,G10,NA,NA,NA,NA
silence,9640,9850,210,Germany,G10,NA,NA,NA,NA
silence,11340,14140,2800,Germany,G10,NA,NA,NA,NA
silence,17560,17750,190,Germany,G10,NA,NA,NA,NA
father_gesture,18319,19735,1416,Germany,G10,NA,NA,NA,NA
silence,21640,22150,510,Germany,G10,NA,NA,NA,NA
silence,22950,24190,1240,Germany,G10,NA,NA,NA,NA
silence,25150,25740,590,Germany,G10,NA,NA,NA,NA
silence,26470,27780,1310,Germany,G10,NA,NA,NA,NA
silence,32140,35080,2940,Germany,G10,NA,NA,NA,NA
silence,35530,37410,1880,Germany,G10,NA,NA,NA,NA
silence,39320,39420,100,Germany,G10,NA,NA,NA,NA
silence,40100,40180,80,Germany,G10,NA,NA,NA,NA
silence,47740,48100,360,Germany,G10,NA,NA,NA,NA
silence,53340,53480,140,Germany,G10,NA,NA,NA,NA
silence,54530,54760,230,Germany,G10,NA,NA,NA,NA
silence,56590,57560,970,Germany,G10,NA,NA,NA,NA
father_gesture,59283,59780,497,Germany,G10,NA,NA,NA,NA
silence,59970,61290,1320,Germany,G10,NA,NA,NA,NA
silence,65110,65750,640,Germany,G10,NA,NA,NA,NA
silence,67480,67893,413,Germany,G10,NA,NA,NA,NA
silence,68413,68430,17,Germany,G10,NA,NA,NA,NA
silence,71420,71890,470,Germany,G10,NA,NA,NA,NA
silence,80280,81350,1070,Germany,G10,NA,NA,NA,NA
silence,81860,83620,1760,Germany,G10,NA,NA,NA,NA
silence,86840,86890,50,Germany,G10,NA,NA,NA,NA
silence,88290,88988,698,Germany,G10,NA,NA,NA,NA
silence,89990,90570,580,Germany,G10,NA,NA,NA,NA
child_gesture,91304,91937,633,Germany,G10,NA,NA,NA,NA
silence,95040,95340,300,Germany,G10,NA,NA,NA,NA
silence,95910,95950,40,Germany,G10,NA,NA,NA,NA
silence,99270,99280,10,Germany,G10,NA,NA,NA,NA
silence,100110,103790,3680,Germany,G10,NA,NA,NA,NA
silence,105000,105080,80,Germany,G10,NA,NA,NA,NA
silence,106600,107540,940,Germany,G10,NA,NA,NA,NA
silence,110810,112050,1240,Germany,G10,NA,NA,NA,NA
silence,113050,113470,420,Germany,G10,NA,NA,NA,NA
silence,114030,114780,750,Germany,G10,NA,NA,NA,NA
child_gesture,116064,116999,935,Germany,G10,NA,NA,NA,NA
silence,119850,120510,660,Germany,G10,NA,NA,NA,NA
silence,123960,124220,260,Germany,G10,NA,NA,NA,NA
silence,127090,127620,530,Germany,G10,NA,NA,NA,NA
silence,133230,136220,2990,Germany,G10,NA,NA,NA,NA
silence,137350,138880,1530,Germany,G10,NA,NA,NA,NA
silence,140130,140290,160,Germany,G10,NA,NA,NA,NA
silence,141540,142940,1400,Germany,G10,NA,NA,NA,NA
silence,143880,148420,4540,Germany,G10,NA,NA,NA,NA
silence,149370,152210,2840,Germany,G10,NA,NA,NA,NA
silence,153010,155180,2170,Germany,G10,NA,NA,NA,NA
silence,156940,157460,520,Germany,G10,NA,NA,NA,NA
silence,159290,160120,830,Germany,G10,NA,NA,NA,NA
silence,161180,162930,1750,Germany,G10,NA,NA,NA,NA
silence,165790,169230,3440,Germany,G10,NA,NA,NA,NA
mother_gesture,170167,170699,532,Germany,G10,NA,NA,NA,NA
silence,170610,171180,570,Germany,G10,NA,NA,NA,NA
father_gesture,171543,172363,820,Germany,G10,NA,NA,NA,NA
silence,173380,176970,3590,Germany,G10,NA,NA,NA,NA
silence,177750,179130,1380,Germany,G10,NA,NA,NA,NA
silence,179950,181590,1640,Germany,G10,NA,NA,NA,NA
silence,187980,188180,200,Germany,G10,NA,NA,NA,NA
silence,189120,191310,2190,Germany,G10,NA,NA,NA,NA
silence,195600,199330,3730,Germany,G10,NA,NA,NA,NA
silence,203810,204040,230,Germany,G10,NA,NA,NA,NA
silence,204980,205260,280,Germany,G10,NA,NA,NA,NA
silence,208960,214680,5720,Germany,G10,NA,NA,NA,NA
silence,216150,223600,7450,Germany,G10,NA,NA,NA,NA
silence,231500,235280,3780,Germany,G10,NA,NA,NA,NA
father_gesture,238881,243856,4975,Germany,G10,NA,NA,NA,NA
silence,239070,239480,410,Germany,G10,NA,NA,NA,NA
silence,239880,239910,30,Germany,G10,NA,NA,NA,NA
silence,241520,242300,780,Germany,G10,NA,NA,NA,NA
silence,244080,247700,3620,Germany,G10,NA,NA,NA,NA
silence,248160,251140,2980,Germany,G10,NA,NA,NA,NA
silence,252680,254430,1750,Germany,G10,NA,NA,NA,NA
silence,256960,258110,1150,Germany,G10,NA,NA,NA,NA
silence,261490,267170,5680,Germany,G10,NA,NA,NA,NA
silence,268200,269040,840,Germany,G10,NA,NA,NA,NA
silence,270500,270930,430,Germany,G10,NA,NA,NA,NA
silence,271770,273260,1490,Germany,G10,NA,NA,NA,NA
silence,276320,278730,2410,Germany,G10,NA,NA,NA,NA
silence,279760,280310,550,Germany,G10,NA,NA,NA,NA
silence,282810,283830,1020,Germany,G10,NA,NA,NA,NA
silence,285040,285300,260,Germany,G10,NA,NA,NA,NA
silence,292640,292880,240,Germany,G10,NA,NA,NA,NA
silence,293850,294240,390,Germany,G10,NA,NA,NA,NA
silence,294950,296940,1990,Germany,G10,NA,NA,NA,NA
mother_gesture,298751,299218,467,Germany,G10,NA,NA,NA,NA
silence,300850,303130,2280,Germany,G10,NA,NA,NA,NA
silence,306820,307280,460,Germany,G10,NA,NA,NA,NA
mother_gesture,308880,311013,2133,Germany,G10,NA,NA,NA,NA
silence,312120,314160,2040,Germany,G10,NA,NA,NA,NA
silence,315230,317690,2460,Germany,G10,NA,NA,NA,NA
father_gesture,318538,319431,893,Germany,G10,NA,NA,NA,NA
silence,320820,320990,170,Germany,G10,NA,NA,NA,NA
silence,321580,321900,320,Germany,G10,NA,NA,NA,NA
silence,326010,327170,1160,Germany,G10,NA,NA,NA,NA
silence,328064,328540,476,Germany,G10,NA,NA,NA,NA
silence,335290,336180,890,Germany,G10,NA,NA,NA,NA
silence,339440,339520,80,Germany,G10,NA,NA,NA,NA
silence,340120,340200,80,Germany,G10,NA,NA,NA,NA
silence,344620,346500,1880,Germany,G10,NA,NA,NA,NA
silence,353980,354480,500,Germany,G10,NA,NA,NA,NA
silence,355862,356010,148,Germany,G10,NA,NA,NA,NA
silence,357940,362080,4140,Germany,G10,NA,NA,NA,NA
child_gesture,362357,368670,6313,Germany,G10,NA,NA,NA,NA
silence,363070,363220,150,Germany,G10,NA,NA,NA,NA
silence,366160,366520,360,Germany,G10,NA,NA,NA,NA
silence,367750,368450,700,Germany,G10,NA,NA,NA,NA
silence,370340,381320,10980,Germany,G10,NA,NA,NA,NA
silence,389390,389660,270,Germany,G10,NA,NA,NA,NA
silence,394140,394400,260,Germany,G10,NA,NA,NA,NA
silence,394570,394750,180,Germany,G10,NA,NA,NA,NA
silence,403420,403780,360,Germany,G10,NA,NA,NA,NA
child_gesture,408112,408840,728,Germany,G10,NA,NA,NA,NA
silence,409490,410800,1310,Germany,G10,NA,NA,NA,NA
father_gesture,411524,412082,558,Germany,G10,NA,NA,NA,NA
silence,412880,413310,430,Germany,G10,NA,NA,NA,NA
silence,416310,416570,260,Germany,G10,NA,NA,NA,NA
silence,419270,421080,1810,Germany,G10,NA,NA,NA,NA
silence,423050,423150,100,Germany,G10,NA,NA,NA,NA
silence,424140,424480,340,Germany,G10,NA,NA,NA,NA
silence,425360,425570,210,Germany,G10,NA,NA,NA,NA
silence,426820,429030,2210,Germany,G10,NA,NA,NA,NA
silence,430650,431140,490,Germany,G10,NA,NA,NA,NA
silence,436150,437490,1340,Germany,G10,NA,NA,NA,NA
child_gesture,439254,440889,1635,Germany,G10,NA,NA,NA,NA
silence,441020,441910,890,Germany,G10,NA,NA,NA,NA
silence,442240,442390,150,Germany,G10,NA,NA,NA,NA
father_gesture,443071,443549,478,Germany,G10,NA,NA,NA,NA
mother_gesture,443599,444087,488,Germany,G10,NA,NA,NA,NA
silence,444100,449580,5480,Germany,G10,NA,NA,NA,NA
silence,450570,456000,5430,Germany,G10,NA,NA,NA,NA
silence,458855,459130,275,Germany,G10,NA,NA,NA,NA
silence,464860,465130,270,Germany,G10,NA,NA,NA,NA
silence,466830,471800,4970,Germany,G10,NA,NA,NA,NA
silence,479910,482330,2420,Germany,G10,NA,NA,NA,NA
silence,483410,484200,790,Germany,G10,NA,NA,NA,NA
silence,485193,486300,1107,Germany,G10,NA,NA,NA,NA
silence,489617,492990,3373,Germany,G10,NA,NA,NA,NA
child_gesture,492813,502010,9197,Germany,G10,NA,NA,NA,NA
silence,493830,494660,830,Germany,G10,NA,NA,NA,NA
mother_gesture,494812,495321,509,Germany,G10,NA,NA,NA,NA
silence,495398,496630,1232,Germany,G10,NA,NA,NA,NA
silence,501282,504070,2788,Germany,G10,NA,NA,NA,NA
silence,504750,507660,2910,Germany,G10,NA,NA,NA,NA
silence,510830,513820,2990,Germany,G10,NA,NA,NA,NA
silence,517980,518200,220,Germany,G10,NA,NA,NA,NA
silence,519660,520180,520,Germany,G10,NA,NA,NA,NA
silence,523910,525570,1660,Germany,G10,NA,NA,NA,NA
silence,532340,532400,60,Germany,G10,NA,NA,NA,NA
silence,533950,537130,3180,Germany,G10,NA,NA,NA,NA
silence,539250,560410,21160,Germany,G10,NA,NA,NA,NA
silence,564100,564650,550,Germany,G10,NA,NA,NA,NA
father_gesture,566987,567536,549,Germany,G10,NA,NA,NA,NA
silence,567660,568627,967,Germany,G10,NA,NA,NA,NA
father_gesture,571735,572518,783,Germany,G10,NA,NA,NA,NA
silence,571940,572800,860,Germany,G10,NA,NA,NA,NA
silence,577510,577590,80,Germany,G10,NA,NA,NA,NA
father_gesture,578066,578756,690,Germany,G10,NA,NA,NA,NA
silence,579210,579500,290,Germany,G10,NA,NA,NA,NA
father_gesture,579996,580656,660,Germany,G10,NA,NA,NA,NA
silence,580800,581710,910,Germany,G10,NA,NA,NA,NA
silence,589130,589220,90,Germany,G10,NA,NA,NA,NA
father_gesture,589675,590254,579,Germany,G10,NA,NA,NA,NA
silence,590290,590430,140,Germany,G10,NA,NA,NA,NA
silence,597080,597340,260,Germany,G10,NA,NA,NA,NA
silence,598540,599070,530,Germany,G10,NA,NA,NA,NA
silence,599770,600300,530,Germany,G10,NA,NA,NA,NA
silence,601350,601520,170,Germany,G10,NA,NA,NA,NA
child,4220,5060,840,Germany,G11,m,1,1,a
mother,4970,5790,820,Germany,G11,c,1,2,q
child,5740,6160,420,Germany,G11,m,1,3,a
mother,6050,7570,1520,Germany,G11,c,1,4,i
child,7500,7940,440,Germany,G11,m,1,5,a
mother,7900,9360,1460,Germany,G11,c,1,6,q
mother,10340,12753,2413,Germany,G11,c,2,1,q
mother,13820,16863,3043,Germany,G11,c,3,1,a
mother,22010,23670,1660,Germany,G11,f,4,1,a
father,23810,24700,890,Germany,G11,m,4,2,a
father,27030,28090,1060,Germany,G11,c,5,1,a
child,32530,34850,2320,Germany,G11,m,6,1,a
mother,34830,36280,1450,Germany,G11,c,6,2,q
father,36320,38100,1780,Germany,G11,b,6,3,a
mother,37640,38640,1000,Germany,G11,f,6,4,a
father,41010,44430,3420,Germany,G11,o,7,1,a
child,43940,47300,3360,Germany,G11,m,8,1,a
mother,47960,48540,580,Germany,G11,c,8,2,a
father,48480,49420,940,Germany,G11,c,8,3,q
child,49970,50670,700,Germany,G11,f,8,4,a
mother,50000,51740,1740,Germany,G11,c,8,5,q
child,55300,60750,5450,Germany,G11,b,9,1,a
mother,60820,62730,1910,Germany,G11,c,10,1,q
child,63160,63620,460,Germany,G11,m,10,2,a
mother,65130,66020,890,Germany,G11,c,10,3,a
father,71860,78320,6460,Germany,G11,c,11,1,a
child,76000,76700,700,Germany,G11,f,11,2,a
father,93690,95260,1570,Germany,G11,m,12,1,a
mother,96000,99130,3130,Germany,G11,f,12,2,a
child,98560,100410,1850,Germany,G11,m,12,3,a
mother,100160,103770,3610,Germany,G11,c,12,4,q
child,103900,105510,1610,Germany,G11,m,12,5,a
father,104940,106410,1470,Germany,G11,m,12,6,a
mother,110370,113660,3290,Germany,G11,c,13,1,q
child,113580,114250,670,Germany,G11,m,13,2,a
mother,113840,115020,1180,Germany,G11,c,13,3,q
father,116250,118160,1910,Germany,G11,m,13,4,a
mother,118550,119185,635,Germany,G11,f,13,5,a
father,119870,123660,3790,Germany,G11,m,13,6,a
mother,126390,132148,5758,Germany,G11,c,14,1,q
mother,134440,136820,2380,Germany,G11,c,14,2,q
child,137630,138350,720,Germany,G11,m,14,3,a
mother,139200,140840,1640,Germany,G11,c,14,4,q
child,141030,142770,1740,Germany,G11,m,14,5,a
mother,142400,143310,910,Germany,G11,c,14,6,a
child,145330,149750,4420,Germany,G11,m,14,7,q
mother,149740,151260,1520,Germany,G11,c,14,8,q
child,152710,154090,1380,Germany,G11,b,14,9,a
mother,154010,154810,800,Germany,G11,c,14,10,a
father,154010,155110,1100,Germany,G11,c,14,11,a
child,154925,155589,664,Germany,G11,m,14,12,q
mother,155880,158570,2690,Germany,G11,c,14,13,a
child,159080,161070,1990,Germany,G11,m,14,14,a
mother,161530,162320,790,Germany,G11,c,14,15,a
child,165630,167690,2060,Germany,G11,m,14,16,q
mother,167640,169110,1470,Germany,G11,c,14,17,a
father,168850,171270,2420,Germany,G11,c,14,18,q
father,174240,175530,1290,Germany,G11,c,14,19,q
child,176250,177760,1510,Germany,G11,f,14,20,a
father,177690,178420,730,Germany,G11,c,14,21,a
mother,179870,180870,1000,Germany,G11,b,14,22,q
father,181810,182450,640,Germany,G11,m,14,23,a
child,181880,183400,1520,Germany,G11,m,14,24,a
mother,182640,183840,1200,Germany,G11,b,14,25,q
father,188320,189970,1650,Germany,G11,m,15,1,a
mother,190380,191170,790,Germany,G11,m,15,2,a
father,191570,192540,970,Germany,G11,m,15,3,q
mother,193390,194130,740,Germany,G11,f,15,4,q
father,194100,195950,1850,Germany,G11,m,15,5,a
mother,195190,198160,2970,Germany,G11,f,15,6,a
father,202370,203310,940,Germany,G11,c,16,1,q
child,208730,210310,1580,Germany,G11,f,16,2,a
mother,209700,214630,4930,Germany,G11,f,17,1,a
father,215300,216100,800,Germany,G11,m,17,2,q
mother,216390,222863,6473,Germany,G11,f,17,3,a
father,223150,223910,760,Germany,G11,m,17,4,a
father,226150,230620,4470,Germany,G11,m,17,5,a
mother,230800,231940,1140,Germany,G11,f,17,6,q
father,232090,239730,7640,Germany,G11,m,17,7,a
mother,239950,240490,540,Germany,G11,m,17,8,a
father,240290,240760,470,Germany,G11,m,17,9,a
father,243420,253290,9870,Germany,G11,m,17,10,a
mother,254020,256910,2890,Germany,G11,f,17,11,a
father,256350,260220,3870,Germany,G11,m,17,12,a
mother,261530,263280,1750,Germany,G11,f,17,13,a
father,263190,267110,3920,Germany,G11,m,17,14,a
father,269220,270540,1320,Germany,G11,m,17,15,a
child,239270,240890,1620,Germany,G11,o,18,1,a
child,247370,249220,1850,Germany,G11,b,19,1,a
mother,252050,252690,640,Germany,G11,c,19,2,a
child,266590,268510,1920,Germany,G11,m,20,1,q
mother,269020,270020,1000,Germany,G11,c,20,2,q
child,270010,271650,1640,Germany,G11,m,20,3,a
mother,272270,273090,820,Germany,G11,c,20,4,q
child,273120,273560,440,Germany,G11,m,20,5,a
mother,273470,276060,2590,Germany,G11,c,20,6,a
child,275050,276280,1230,Germany,G11,m,20,7,q
child,279210,280850,1640,Germany,G11,m,20,8,q
mother,280840,281680,840,Germany,G11,c,20,9,q
child,281650,282360,710,Germany,G11,m,20,10,a
mother,282380,284330,1950,Germany,G11,c,20,11,a
child,285070,285790,720,Germany,G11,m,20,12,a
mother,285540,288380,2840,Germany,G11,f,20,13,a
father,287480,288010,530,Germany,G11,m,20,14,a
child,290390,291830,1440,Germany,G11,m,20,15,q
mother,292400,303880,11480,Germany,G11,c,20,16,q
child,304670,305470,800,Germany,G11,m,20,17,a
mother,305740,309200,3460,Germany,G11,c,20,18,a
child,309330,312824,3494,Germany,G11,m,20,19,q
mother,312330,313200,870,Germany,G11,c,20,20,a
child,313470,314270,800,Germany,G11,b,20,21,a
mother,314690,316120,1430,Germany,G11,c,20,22,a
child,316460,317470,1010,Germany,G11,b,20,23,q
father,317490,323370,5880,Germany,G11,c,20,24,a
mother,333300,335690,2390,Germany,G11,f,21,1,a
child,334540,336940,2400,Germany,G11,m,22,1,q
mother,336870,338400,1530,Germany,G11,c,22,2,a
child,338580,344460,5880,Germany,G11,b,22,3,a
mother,344510,345130,620,Germany,G11,c,22,4,a
child,345500,347220,1720,Germany,G11,m,22,5,a
mother,347080,347990,910,Germany,G11,c,22,6,a
child,348200,349890,1690,Germany,G11,m,22,7,q
mother,349360,353390,4030,Germany,G11,c,22,8,a
child,355660,358310,2650,Germany,G11,m,22,9,q
mother,357560,358400,840,Germany,G11,c,22,10,a
child,358630,360520,1890,Germany,G11,m,22,11,a
mother,360340,361550,1210,Germany,G11,c,22,12,a
child,364250,366570,2320,Germany,G11,m,22,13,q
father,360870,361570,700,Germany,G11,o,23,1,a
father,365610,370200,4590,Germany,G11,o,23,2,a
child,370200,371910,1710,Germany,G11,f,24,1,q
father,371730,372390,660,Germany,G11,c,24,2,a
child,373222,375062,1840,Germany,G11,f,24,3,q
father,375020,375850,830,Germany,G11,c,24,4,a
mother,376050,377630,1580,Germany,G11,f,24,5,q
father,377590,379380,1790,Germany,G11,m,24,6,a
mother,379530,380440,910,Germany,G11,f,24,7,a
child,381220,383270,2050,Germany,G11,f,24,8,q
father,383180,388600,5420,Germany,G11,c,24,9,a
child,389780,390770,990,Germany,G11,f,24,10,a
father,391220,392550,1330,Germany,G11,c,24,11,a
mother,393500,397470,3970,Germany,G11,f,25,1,a
mother,400950,401950,1000,Germany,G11,f,25,2,a
father,402610,404270,1660,Germany,G11,m,25,3,q
mother,404180,405040,860,Germany,G11,f,25,4,a
mother,411780,416560,4780,Germany,G11,f,25,5,a
father,417020,417760,740,Germany,G11,m,25,6,a
child,404420,405930,1510,Germany,G11,m,26,1,a
mother,407140,409530,2390,Germany,G11,c,26,2,q
child,415550,418220,2670,Germany,G11,b,26,3,a
mother,417900,418920,1020,Germany,G11,c,26,4,q
child,419020,419430,410,Germany,G11,m,26,5,a
mother,420470,421900,1430,Germany,G11,c,26,6,q
father,422450,423140,690,Germany,G11,c,26,7,q
child,424580,427870,3290,Germany,G11,f,26,8,a
mother,429300,430830,1530,Germany,G11,c,26,9,q
child,431170,431750,580,Germany,G11,m,26,10,a
father,434350,435560,1210,Germany,G11,c,26,11,q
mother,432080,434900,2820,Germany,G11,f,27,1,a
mother,437330,446320,8990,Germany,G11,f,27,2,a
father,446520,450220,3700,Germany,G11,m,27,3,a
child,448050,455840,7790,Germany,G11,f,28,1,q
father,455640,456960,1320,Germany,G11,c,28,2,q
child,456590,458180,1590,Germany,G11,f,28,3,q
father,459110,460270,1160,Germany,G11,c,28,4,q
child,460430,463590,3160,Germany,G11,f,28,5,q
father,463350,464200,850,Germany,G11,c,28,6,a
child,465940,468880,2940,Germany,G11,f,28,7,q
father,466900,472760,5860,Germany,G11,c,28,8,a
child,477990,479080,1090,Germany,G11,f,28,9,q
father,480310,484360,4050,Germany,G11,c,28,10,a
child,484620,485420,800,Germany,G11,f,28,11,a
mother,484370,486350,1980,Germany,G11,c,29,1,a
child,486670,487398,728,Germany,G11,m,29,2,a
mother,493210,497060,3850,Germany,G11,f,30,1,a
child,499320,500630,1310,Germany,G11,b,31,1,a
father,504790,506990,2200,Germany,G11,m,32,1,a
mother,510110,516640,6530,Germany,G11,f,32,2,a
father,517830,518680,850,Germany,G11,m,32,3,q
mother,518880,523490,4610,Germany,G11,f,32,4,a
father,523780,527570,3790,Germany,G11,m,32,5,q
mother,528880,530810,1930,Germany,G11,f,32,6,a
child,530470,532030,1560,Germany,G11,m,33,1,a
mother,534900,535940,1040,Germany,G11,c,33,2,q
child,536030,536700,670,Germany,G11,m,33,3,a
mother,536400,538620,2220,Germany,G11,c,33,4,q
child,540130,543580,3450,Germany,G11,m,33,5,a
mother,543630,545360,1730,Germany,G11,c,33,6,a
child,545460,546250,790,Germany,G11,m,33,7,a
mother,548150,550190,2040,Germany,G11,c,33,8,q
mother,553000,555270,2270,Germany,G11,c,33,9,a
child,555230,556260,1030,Germany,G11,m,33,10,a
mother,556000,558060,2060,Germany,G11,c,33,11,a
child,558230,559340,1110,Germany,G11,m,33,12,a
mother,558900,560210,1310,Germany,G11,c,33,13,a
father,560180,561830,1650,Germany,G11,c,33,14,a
mother,562580,564020,1440,Germany,G11,c,33,15,a
child,564250,567790,3540,Germany,G11,m,33,16,a
child,571440,572820,1380,Germany,G11,b,33,17,q
father,573380,575340,1960,Germany,G11,c,33,18,a
child,576240,578340,2100,Germany,G11,b,33,19,q
mother,578650,581450,2800,Germany,G11,c,33,20,a
child,582740,588380,5640,Germany,G11,b,33,21,q
mother,588730,589470,740,Germany,G11,c,33,22,q
child,589430,590280,850,Germany,G11,m,33,23,q
mother,590010,594030,4020,Germany,G11,c,33,24,a
father,593850,594370,520,Germany,G11,c,33,25,a
child,594120,598300,4180,Germany,G11,b,33,26,q
child_gesture,4382,5384,1002,Germany,G11,NA,NA,NA,NA
silence,9360,10340,980,Germany,G11,NA,NA,NA,NA
silence,12753,13820,1067,Germany,G11,NA,NA,NA,NA
silence,16863,22010,5147,Germany,G11,NA,NA,NA,NA
silence,23670,23810,140,Germany,G11,NA,NA,NA,NA
silence,24700,27030,2330,Germany,G11,NA,NA,NA,NA
silence,28090,32530,4440,Germany,G11,NA,NA,NA,NA
silence,36280,36320,40,Germany,G11,NA,NA,NA,NA
silence,38640,41010,2370,Germany,G11,NA,NA,NA,NA
child_gesture,45773,47137,1364,Germany,G11,NA,NA,NA,NA
silence,47300,47960,660,Germany,G11,NA,NA,NA,NA
silence,49420,49970,550,Germany,G11,NA,NA,NA,NA
child_gesture,50133,50822,689,Germany,G11,NA,NA,NA,NA
silence,51740,55300,3560,Germany,G11,NA,NA,NA,NA
silence,60750,60820,70,Germany,G11,NA,NA,NA,NA
silence,62730,63160,430,Germany,G11,NA,NA,NA,NA
silence,63620,65130,1510,Germany,G11,NA,NA,NA,NA
silence,66020,71860,5840,Germany,G11,NA,NA,NA,NA
silence,78320,93690,15370,Germany,G11,NA,NA,NA,NA
silence,95260,96000,740,Germany,G11,NA,NA,NA,NA
child_gesture,99488,100204,716,Germany,G11,NA,NA,NA,NA
silence,103770,103900,130,Germany,G11,NA,NA,NA,NA
silence,106410,110370,3960,Germany,G11,NA,NA,NA,NA
silence,115020,116250,1230,Germany,G11,NA,NA,NA,NA
silence,118160,118550,390,Germany,G11,NA,NA,NA,NA
silence,119185,119870,685,Germany,G11,NA,NA,NA,NA
silence,123660,126390,2730,Germany,G11,NA,NA,NA,NA
silence,132148,134440,2292,Germany,G11,NA,NA,NA,NA
silence,136820,137630,810,Germany,G11,NA,NA,NA,NA
silence,138350,139200,850,Germany,G11,NA,NA,NA,NA
silence,140840,141030,190,Germany,G11,NA,NA,NA,NA
silence,143310,145330,2020,Germany,G11,NA,NA,NA,NA
silence,151260,152710,1450,Germany,G11,NA,NA,NA,NA
silence,155589,155880,291,Germany,G11,NA,NA,NA,NA
silence,158570,159080,510,Germany,G11,NA,NA,NA,NA
silence,161070,161530,460,Germany,G11,NA,NA,NA,NA
silence,162320,165630,3310,Germany,G11,NA,NA,NA,NA
silence,171270,174240,2970,Germany,G11,NA,NA,NA,NA
silence,175530,176250,720,Germany,G11,NA,NA,NA,NA
silence,178420,179870,1450,Germany,G11,NA,NA,NA,NA
silence,180870,181810,940,Germany,G11,NA,NA,NA,NA
silence,183840,188320,4480,Germany,G11,NA,NA,NA,NA
silence,189970,190380,410,Germany,G11,NA,NA,NA,NA
silence,191170,191570,400,Germany,G11,NA,NA,NA,NA
silence,192540,193390,850,Germany,G11,NA,NA,NA,NA
mother_gesture,193739,194232,493,Germany,G11,NA,NA,NA,NA
father_gesture,194130,195428,1298,Germany,G11,NA,NA,NA,NA
silence,198160,202370,4210,Germany,G11,NA,NA,NA,NA
silence,203310,208730,5420,Germany,G11,NA,NA,NA,NA
silence,214630,215300,670,Germany,G11,NA,NA,NA,NA
silence,216100,216390,290,Germany,G11,NA,NA,NA,NA
silence,222863,223150,287,Germany,G11,NA,NA,NA,NA
silence,223910,226150,2240,Germany,G11,NA,NA,NA,NA
silence,230620,230800,180,Germany,G11,NA,NA,NA,NA
silence,231940,232090,150,Germany,G11,NA,NA,NA,NA
silence,240890,243420,2530,Germany,G11,NA,NA,NA,NA
silence,253290,254020,730,Germany,G11,NA,NA,NA,NA
silence,260220,261530,1310,Germany,G11,NA,NA,NA,NA
silence,268510,269020,510,Germany,G11,NA,NA,NA,NA
silence,271650,272270,620,Germany,G11,NA,NA,NA,NA
silence,273090,273120,30,Germany,G11,NA,NA,NA,NA
mother_gesture,274119,274739,620,Germany,G11,NA,NA,NA,NA
silence,276280,279210,2930,Germany,G11,NA,NA,NA,NA
silence,282360,282380,20,Germany,G11,NA,NA,NA,NA
silence,284330,285070,740,Germany,G11,NA,NA,NA,NA
silence,288380,290390,2010,Germany,G11,NA,NA,NA,NA
silence,291830,292400,570,Germany,G11,NA,NA,NA,NA
silence,303880,304670,790,Germany,G11,NA,NA,NA,NA
silence,305470,305740,270,Germany,G11,NA,NA,NA,NA
silence,309200,309330,130,Germany,G11,NA,NA,NA,NA
silence,313200,313470,270,Germany,G11,NA,NA,NA,NA
silence,314270,314690,420,Germany,G11,NA,NA,NA,NA
silence,316120,316460,340,Germany,G11,NA,NA,NA,NA
silence,317470,317490,20,Germany,G11,NA,NA,NA,NA
father_gesture,320580,322000,1420,Germany,G11,NA,NA,NA,NA
silence,323370,333300,9930,Germany,G11,NA,NA,NA,NA
child_gesture,335184,336239,1055,Germany,G11,NA,NA,NA,NA
silence,338400,338580,180,Germany,G11,NA,NA,NA,NA
silence,344460,344510,50,Germany,G11,NA,NA,NA,NA
silence,345130,345500,370,Germany,G11,NA,NA,NA,NA
silence,347990,348200,210,Germany,G11,NA,NA,NA,NA
silence,353390,355660,2270,Germany,G11,NA,NA,NA,NA
silence,358400,358630,230,Germany,G11,NA,NA,NA,NA
silence,361570,364250,2680,Germany,G11,NA,NA,NA,NA
silence,372390,373222,832,Germany,G11,NA,NA,NA,NA
silence,375850,376050,200,Germany,G11,NA,NA,NA,NA
silence,379380,379530,150,Germany,G11,NA,NA,NA,NA
silence,380440,381220,780,Germany,G11,NA,NA,NA,NA
silence,388600,389780,1180,Germany,G11,NA,NA,NA,NA
silence,390770,391220,450,Germany,G11,NA,NA,NA,NA
silence,392550,393500,950,Germany,G11,NA,NA,NA,NA
silence,397470,400950,3480,Germany,G11,NA,NA,NA,NA
silence,401950,402610,660,Germany,G11,NA,NA,NA,NA
silence,405930,407140,1210,Germany,G11,NA,NA,NA,NA
silence,409530,411780,2250,Germany,G11,NA,NA,NA,NA
silence,418920,419020,100,Germany,G11,NA,NA,NA,NA
silence,419430,420470,1040,Germany,G11,NA,NA,NA,NA
silence,421900,422450,550,Germany,G11,NA,NA,NA,NA
silence,423140,424580,1440,Germany,G11,NA,NA,NA,NA
silence,427870,429300,1430,Germany,G11,NA,NA,NA,NA
silence,430830,431170,340,Germany,G11,NA,NA,NA,NA
silence,431750,432080,330,Germany,G11,NA,NA,NA,NA
silence,435560,437330,1770,Germany,G11,NA,NA,NA,NA
silence,446320,446520,200,Germany,G11,NA,NA,NA,NA
child_gesture,457414,458466,1052,Germany,G11,NA,NA,NA,NA
silence,458180,459110,930,Germany,G11,NA,NA,NA,NA
silence,460270,460430,160,Germany,G11,NA,NA,NA,NA
child_gesture,461159,463527,2368,Germany,G11,NA,NA,NA,NA
silence,464200,465940,1740,Germany,G11,NA,NA,NA,NA
child_gesture,467215,467799,584,Germany,G11,NA,NA,NA,NA
silence,472760,477990,5230,Germany,G11,NA,NA,NA,NA
silence,479080,480310,1230,Germany,G11,NA,NA,NA,NA
silence,484360,484370,10,Germany,G11,NA,NA,NA,NA
silence,486350,486670,320,Germany,G11,NA,NA,NA,NA
silence,487398,493210,5812,Germany,G11,NA,NA,NA,NA
silence,497060,499320,2260,Germany,G11,NA,NA,NA,NA
silence,500630,504790,4160,Germany,G11,NA,NA,NA,NA
silence,506990,510110,3120,Germany,G11,NA,NA,NA,NA
mother_gesture,511894,512317,423,Germany,G11,NA,NA,NA,NA
silence,516640,517830,1190,Germany,G11,NA,NA,NA,NA
silence,518680,518880,200,Germany,G11,NA,NA,NA,NA
silence,523490,523780,290,Germany,G11,NA,NA,NA,NA
silence,527570,528880,1310,Germany,G11,NA,NA,NA,NA
silence,532030,534900,2870,Germany,G11,NA,NA,NA,NA
silence,535940,536030,90,Germany,G11,NA,NA,NA,NA
silence,538620,540130,1510,Germany,G11,NA,NA,NA,NA
silence,543580,543630,50,Germany,G11,NA,NA,NA,NA
silence,545360,545460,100,Germany,G11,NA,NA,NA,NA
silence,546250,548150,1900,Germany,G11,NA,NA,NA,NA
silence,550190,553000,2810,Germany,G11,NA,NA,NA,NA
silence,558060,558230,170,Germany,G11,NA,NA,NA,NA
silence,561830,562580,750,Germany,G11,NA,NA,NA,NA
silence,564020,564250,230,Germany,G11,NA,NA,NA,NA
silence,567790,571440,3650,Germany,G11,NA,NA,NA,NA
silence,572820,573380,560,Germany,G11,NA,NA,NA,NA
silence,575340,576240,900,Germany,G11,NA,NA,NA,NA
child_gesture,576500,577845,1345,Germany,G11,NA,NA,NA,NA
silence,578340,578650,310,Germany,G11,NA,NA,NA,NA
silence,581450,582740,1290,Germany,G11,NA,NA,NA,NA
child_gesture,583509,584179,670,Germany,G11,NA,NA,NA,NA
silence,588380,588730,350,Germany,G11,NA,NA,NA,NA
mother_gesture,590375,591212,837,Germany,G11,NA,NA,NA,NA
child_gesture,597250,598265,1015,Germany,G11,NA,NA,NA,NA
father,740,2720,1980,Germany,G12,m,1,1,q
mother,2830,3600,770,Germany,G12,f,1,2,a
child,1020,2070,1050,Germany,G12,f,2,1,i
father,3600,4280,680,Germany,G12,c,2,2,a
child,3700,4930,1230,Germany,G12,f,2,3,i
father,5290,7940,2650,Germany,G12,c,2,4,q
child,7340,9400,2060,Germany,G12,f,2,5,i
father,9310,10080,770,Germany,G12,c,2,6,q
child,10490,12430,1940,Germany,G12,f,2,7,a
father,12080,12960,880,Germany,G12,c,2,8,q
child,13090,14380,1290,Germany,G12,f,2,9,a
father,14170,15140,970,Germany,G12,c,2,10,q
child,15360,16340,980,Germany,G12,f,2,11,a
father,16440,17440,1000,Germany,G12,c,2,12,a
child,19430,21140,1710,Germany,G12,m,3,1,a
father,21140,23380,2240,Germany,G12,c,3,2,i
child,23320,25260,1940,Germany,G12,b,3,3,a
father,25340,29260,3920,Germany,G12,c,3,4,a
child,29380,32340,2960,Germany,G12,f,3,5,a
father,31820,35000,3180,Germany,G12,b,3,6,q
mother,35150,36830,1680,Germany,G12,f,3,7,a
child,38100,39510,1410,Germany,G12,m,4,1,q
mother,39860,45980,6120,Germany,G12,c,4,2,a
child,42600,43170,570,Germany,G12,m,4,3,a
child,46560,48940,2380,Germany,G12,c,4,4,a
mother,47390,53360,5970,Germany,G12,c,4,5,a
child,49760,51260,1500,Germany,G12,m,4,6,a
child,54760,56040,1280,Germany,G12,b,4,7,a
mother,56280,57880,1600,Germany,G12,c,4,8,a
father,56410,59510,3100,Germany,G12,m,5,1,a
mother,59100,59910,810,Germany,G12,f,5,2,a
father,59890,60410,520,Germany,G12,m,5,3,a
child,60840,61500,660,Germany,G12,m,6,1,q
mother,61540,63980,2440,Germany,G12,c,6,2,i
child,63660,64960,1300,Germany,G12,m,6,3,a
mother,65450,67260,1810,Germany,G12,c,6,4,a
father,67980,70060,2080,Germany,G12,c,6,5,i
child,68060,69610,1550,Germany,G12,b,6,6,a
child,70180,73950,3770,Germany,G12,f,6,7,a
father,72320,73500,1180,Germany,G12,c,6,8,a
father,73530,75360,1830,Germany,G12,c,6,9,a
father,77120,82040,4920,Germany,G12,c,6,10,a
father,84770,85980,1210,Germany,G12,c,6,11,q
child,85960,86320,360,Germany,G12,f,6,12,a
father,87720,88560,840,Germany,G12,c,6,13,a
child,89020,91980,2960,Germany,G12,f,6,14,q
child,93750,96680,2930,Germany,G12,f,6,15,q
father,96700,97560,860,Germany,G12,c,6,16,a
father,101400,104410,3010,Germany,G12,c,6,17,q
mother,106590,108210,1620,Germany,G12,c,7,1,q
child,108490,110660,2170,Germany,G12,m,7,2,a
father,111790,114220,2430,Germany,G12,b,7,3,a
father,117980,120640,2660,Germany,G12,m,8,1,q
child,122720,124810,2090,Germany,G12,f,9,1,a
father,124590,128810,4220,Germany,G12,c,9,2,a
father,129980,130550,570,Germany,G12,c,9,3,a
child,131080,132430,1350,Germany,G12,f,9,4,q
father,132030,133980,1950,Germany,G12,c,9,5,a
child,135110,136560,1450,Germany,G12,f,9,6,a
father,136880,141140,4260,Germany,G12,c,9,7,q
child,141620,143470,1850,Germany,G12,f,9,8,a
father,145180,146520,1340,Germany,G12,c,9,9,i
child,147860,149180,1320,Germany,G12,f,9,10,a
father,149120,149950,830,Germany,G12,c,9,11,q
child,150320,150840,520,Germany,G12,f,9,12,a
father,151200,152170,970,Germany,G12,c,9,13,q
child,152090,152580,490,Germany,G12,f,9,14,a
father,152380,153240,860,Germany,G12,c,9,15,q
child,154200,155280,1080,Germany,G12,f,9,16,a
father,155470,156710,1240,Germany,G12,c,9,17,i
father,162710,163860,1150,Germany,G12,c,9,18,q
child,164450,166390,1940,Germany,G12,f,9,19,a
father,166290,167460,1170,Germany,G12,c,9,20,q
child,167560,167980,420,Germany,G12,f,9,21,a
father,168040,169220,1180,Germany,G12,c,9,22,a
child,169890,170380,490,Germany,G12,f,9,23,a
father,171740,173090,1350,Germany,G12,c,9,24,i
mother,171780,173330,1550,Germany,G12,c,9,25,q
father,176420,178750,2330,Germany,G12,m,10,1,a
mother,178350,183310,4960,Germany,G12,f,10,2,q
father,182960,183810,850,Germany,G12,m,10,3,a
father,185320,189470,4150,Germany,G12,m,10,4,a
child,178240,181790,3550,Germany,G12,b,11,1,a
mother,194410,195320,910,Germany,G12,c,12,1,q
child,195350,195810,460,Germany,G12,m,12,2,a
mother,196160,198480,2320,Germany,G12,c,12,3,q
child,198520,200890,2370,Germany,G12,m,12,4,a
father,201490,202940,1450,Germany,G12,c,12,5,q
mother,202120,205210,3090,Germany,G12,c,12,6,a
child,205250,206230,980,Germany,G12,m,12,7,a
mother,206320,208910,2590,Germany,G12,c,12,8,a
father,210520,214720,4200,Germany,G12,c,12,9,a
child,215590,218180,2590,Germany,G12,f,12,10,a
father,217650,218900,1250,Germany,G12,c,12,11,q
child,219100,219880,780,Germany,G12,f,12,12,a
father,220550,221840,1290,Germany,G12,c,12,13,a
mother,225150,226250,1100,Germany,G12,b,12,14,a
father,225500,225960,460,Germany,G12,m,12,15,a
child,230320,231970,1650,Germany,G12,f,12,16,a
father,231950,232980,1030,Germany,G12,c,12,17,q
child,233010,233730,720,Germany,G12,f,12,18,a
mother,236790,237810,1020,Germany,G12,c,13,1,q
child,237800,238490,690,Germany,G12,m,13,2,a
mother,238560,241600,3040,Germany,G12,c,13,3,a
child,244230,244770,540,Germany,G12,m,13,4,a
father,246090,251330,5240,Germany,G12,m,14,1,q
mother,251120,252870,1750,Germany,G12,f,14,2,a
father,252760,253340,580,Germany,G12,m,14,3,q
mother,253390,253960,570,Germany,G12,f,14,4,a
father,253980,255950,1970,Germany,G12,m,14,5,a
child,249980,251690,1710,Germany,G12,b,15,1,a
father,259240,263540,4300,Germany,G12,c,16,1,a
mother,262720,266130,3410,Germany,G12,f,17,1,a
father,266110,266740,630,Germany,G12,m,17,2,a
mother,267180,269230,2050,Germany,G12,f,17,3,a
father,267300,268930,1630,Germany,G12,m,17,4,a
father,269090,269470,380,Germany,G12,m,17,5,a
mother,272630,276060,3430,Germany,G12,f,17,6,a
father,276130,276760,630,Germany,G12,m,17,7,a
mother,276880,277680,800,Germany,G12,f,17,8,a
child,271550,273230,1680,Germany,G12,b,18,1,a
child,276190,277720,1530,Germany,G12,f,19,1,a
child,278420,281310,2890,Germany,G12,m,20,1,a
child,283160,286940,3780,Germany,G12,b,20,2,a
father,286480,287470,990,Germany,G12,c,20,3,q
child,287520,287970,450,Germany,G12,f,20,4,a
mother,290080,290900,820,Germany,G12,c,20,5,a
mother,295270,296190,920,Germany,G12,c,21,1,q
child,296210,297010,800,Germany,G12,m,21,2,a
mother,297300,298790,1490,Germany,G12,c,21,3,q
child,298810,299390,580,Germany,G12,m,21,4,a
mother,299690,301530,1840,Germany,G12,c,21,5,q
child,303110,306130,3020,Germany,G12,m,21,6,a
mother,306290,307280,990,Germany,G12,c,21,7,a
father,309870,311790,1920,Germany,G12,c,22,1,a
child,311870,313330,1460,Germany,G12,f,22,2,a
child,316120,317510,1390,Germany,G12,b,22,3,a
mother,317570,318990,1420,Germany,G12,c,22,4,a
father,323910,325610,1700,Germany,G12,m,23,1,q
mother,324040,325120,1080,Germany,G12,f,23,2,a
mother,325190,328380,3190,Germany,G12,f,24,1,a
mother,336990,339130,2140,Germany,G12,m,24,2,a
father,337460,338190,730,Germany,G12,f,24,3,a
father,339050,341640,2590,Germany,G12,m,24,4,q
mother,341500,343150,1650,Germany,G12,f,24,5,a
father,343000,344400,1400,Germany,G12,m,24,6,q
mother,344340,351110,6770,Germany,G12,f,24,7,a
father,351040,351640,600,Germany,G12,m,24,8,a
child,349310,351190,1880,Germany,G12,b,25,1,a
mother,351700,353440,1740,Germany,G12,c,25,2,q
father,354210,355110,900,Germany,G12,c,25,3,q
child,356820,357550,730,Germany,G12,f,25,4,a
father,363970,365500,1530,Germany,G12,c,25,5,a
child,365880,366640,760,Germany,G12,f,25,6,a
child,368560,369530,970,Germany,G12,f,25,7,a
father,369880,371710,1830,Germany,G12,c,25,8,q
mother,368440,371100,2660,Germany,G12,f,26,1,a
mother,372990,374560,1570,Germany,G12,f,26,2,a
mother,376830,389820,12990,Germany,G12,f,26,3,a
father,382690,384250,1560,Germany,G12,m,26,4,a
father,388570,389220,650,Germany,G12,m,26,5,a
father,389920,395810,5890,Germany,G12,m,26,6,a
mother,392180,392790,610,Germany,G12,f,26,7,a
mother,395810,404650,8840,Germany,G12,f,26,8,a
father,403070,403600,530,Germany,G12,m,26,9,a
father,404440,404900,460,Germany,G12,m,26,10,a
child,406430,409350,2920,Germany,G12,b,27,1,a
father,409320,410420,1100,Germany,G12,c,27,2,q
child,410400,410840,440,Germany,G12,f,27,3,a
father,410970,411590,620,Germany,G12,c,27,4,a
mother,419380,420310,930,Germany,G12,c,28,1,q
child,420420,420990,570,Germany,G12,m,28,2,a
mother,421500,422660,1160,Germany,G12,c,28,3,q
child,423030,424620,1590,Germany,G12,m,28,4,a
mother,425150,428570,3420,Germany,G12,c,28,5,a
father,429760,431490,1730,Germany,G12,c,28,6,i
father,435050,436190,1140,Germany,G12,c,28,7,q
child,436420,437030,610,Germany,G12,f,28,8,a
mother,437540,439000,1460,Germany,G12,b,28,9,a
father,442720,448590,5870,Germany,G12,m,29,1,a
mother,444810,445760,950,Germany,G12,f,29,2,a
child,445170,452970,7800,Germany,G12,m,30,1,a
mother,453080,454480,1400,Germany,G12,c,30,2,q
child,454610,456360,1750,Germany,G12,m,30,3,a
father,457470,459150,1680,Germany,G12,c,30,4,q
child,459680,460220,540,Germany,G12,f,30,5,a
mother,460230,462160,1930,Germany,G12,c,30,6,a
father,463050,464890,1840,Germany,G12,c,30,7,a
child,464990,467110,2120,Germany,G12,b,30,8,a
mother,467860,468430,570,Germany,G12,c,30,9,q
father,467910,469160,1250,Germany,G12,c,30,10,q
child,469550,470530,980,Germany,G12,b,30,11,a
child,472230,482600,10370,Germany,G12,o,31,1,a
mother,484250,492530,8280,Germany,G12,f,32,1,a
father,490310,490900,590,Germany,G12,m,32,2,a
mother,494860,495370,510,Germany,G12,f,32,3,a
mother,499010,526780,27770,Germany,G12,f,32,4,a
father,506620,507380,760,Germany,G12,m,32,5,a
father,513690,514200,510,Germany,G12,m,32,6,a
father,516690,517340,650,Germany,G12,m,32,7,a
father,522770,523500,730,Germany,G12,m,32,8,a
father,526960,527610,650,Germany,G12,m,32,9,a
mother,528220,533940,5720,Germany,G12,f,32,10,a
father,530130,530830,700,Germany,G12,m,32,11,a
father,532970,533710,740,Germany,G12,m,32,12,a
child,491190,496240,5050,Germany,G12,b,33,1,a
father,495540,498320,2780,Germany,G12,c,33,2,i
mother,496630,497620,990,Germany,G12,c,33,3,a
child,535720,536880,1160,Germany,G12,b,34,1,a
child,539470,542290,2820,Germany,G12,b,34,2,a
father,542280,544280,2000,Germany,G12,c,34,3,q
child,544590,548470,3880,Germany,G12,b,34,4,a
child,549980,550740,760,Germany,G12,b,34,5,a
mother,546700,547790,1090,Germany,G12,f,35,1,a
mother,551760,553120,1360,Germany,G12,f,35,2,a
father,553570,554050,480,Germany,G12,m,35,3,a
father,556940,562280,5340,Germany,G12,m,36,1,a
child,561250,563030,1780,Germany,G12,m,37,1,a
mother,563730,564790,1060,Germany,G12,c,37,2,q
child,564900,566510,1610,Germany,G12,m,37,3,a
mother,567020,568520,1500,Germany,G12,c,37,4,q
child,568680,570910,2230,Germany,G12,m,37,5,a
father,569950,570430,480,Germany,G12,m,37,6,a
mother,570950,571890,940,Germany,G12,b,37,7,q
child,572120,572570,450,Germany,G12,m,37,8,a
mother,572430,574260,1830,Germany,G12,c,37,9,a
child,575110,577400,2290,Germany,G12,m,37,10,a
mother,577560,579080,1520,Germany,G12,c,37,11,a
child,579150,581130,1980,Germany,G12,m,37,12,a
mother,582690,585070,2380,Germany,G12,c,37,13,a
child,585830,587150,1320,Germany,G12,m,37,14,a
mother,587130,588730,1600,Germany,G12,c,37,15,q
child,588760,593940,5180,Germany,G12,m,37,16,a
mother,593880,595830,1950,Germany,G12,c,37,17,q
child,595860,596370,510,Germany,G12,m,37,18,a
mother,596520,597190,670,Germany,G12,c,37,19,a
silence,2720,2830,110,Germany,G12,NA,NA,NA,NA
silence,4930,5290,360,Germany,G12,NA,NA,NA,NA
silence,10080,10490,410,Germany,G12,NA,NA,NA,NA
silence,12960,13090,130,Germany,G12,NA,NA,NA,NA
silence,15140,15360,220,Germany,G12,NA,NA,NA,NA
silence,16340,16440,100,Germany,G12,NA,NA,NA,NA
silence,17440,19430,1990,Germany,G12,NA,NA,NA,NA
silence,25260,25340,80,Germany,G12,NA,NA,NA,NA
silence,29260,29380,120,Germany,G12,NA,NA,NA,NA
silence,35000,35150,150,Germany,G12,NA,NA,NA,NA
silence,36830,38100,1270,Germany,G12,NA,NA,NA,NA
silence,39510,39860,350,Germany,G12,NA,NA,NA,NA
silence,45980,46560,580,Germany,G12,NA,NA,NA,NA
silence,53360,54760,1400,Germany,G12,NA,NA,NA,NA
silence,56040,56280,240,Germany,G12,NA,NA,NA,NA
silence,60410,60840,430,Germany,G12,NA,NA,NA,NA
silence,61500,61540,40,Germany,G12,NA,NA,NA,NA
silence,64960,65450,490,Germany,G12,NA,NA,NA,NA
silence,67260,67980,720,Germany,G12,NA,NA,NA,NA
silence,70060,70180,120,Germany,G12,NA,NA,NA,NA
silence,75360,77120,1760,Germany,G12,NA,NA,NA,NA
silence,82040,84770,2730,Germany,G12,NA,NA,NA,NA
silence,86320,87720,1400,Germany,G12,NA,NA,NA,NA
silence,88560,89020,460,Germany,G12,NA,NA,NA,NA
silence,91980,93750,1770,Germany,G12,NA,NA,NA,NA
silence,96680,96700,20,Germany,G12,NA,NA,NA,NA
silence,97560,101400,3840,Germany,G12,NA,NA,NA,NA
father_gesture,101500,104770,3270,Germany,G12,NA,NA,NA,NA
silence,104410,106590,2180,Germany,G12,NA,NA,NA,NA
silence,108210,108490,280,Germany,G12,NA,NA,NA,NA
silence,110660,111790,1130,Germany,G12,NA,NA,NA,NA
silence,114220,117980,3760,Germany,G12,NA,NA,NA,NA
silence,120640,122720,2080,Germany,G12,NA,NA,NA,NA
silence,128810,129980,1170,Germany,G12,NA,NA,NA,NA
silence,130550,131080,530,Germany,G12,NA,NA,NA,NA
silence,133980,135110,1130,Germany,G12,NA,NA,NA,NA
silence,136560,136880,320,Germany,G12,NA,NA,NA,NA
silence,141140,141620,480,Germany,G12,NA,NA,NA,NA
silence,143470,145180,1710,Germany,G12,NA,NA,NA,NA
silence,146520,147860,1340,Germany,G12,NA,NA,NA,NA
silence,149950,150320,370,Germany,G12,NA,NA,NA,NA
silence,150840,151200,360,Germany,G12,NA,NA,NA,NA
silence,153240,154200,960,Germany,G12,NA,NA,NA,NA
silence,155280,155470,190,Germany,G12,NA,NA,NA,NA
silence,156710,162710,6000,Germany,G12,NA,NA,NA,NA
silence,163860,164450,590,Germany,G12,NA,NA,NA,NA
silence,167460,167560,100,Germany,G12,NA,NA,NA,NA
silence,167980,168040,60,Germany,G12,NA,NA,NA,NA
silence,169220,169890,670,Germany,G12,NA,NA,NA,NA
silence,170380,171740,1360,Germany,G12,NA,NA,NA,NA
silence,173330,176420,3090,Germany,G12,NA,NA,NA,NA
silence,183810,185320,1510,Germany,G12,NA,NA,NA,NA
silence,189470,194410,4940,Germany,G12,NA,NA,NA,NA
silence,195320,195350,30,Germany,G12,NA,NA,NA,NA
silence,195810,196160,350,Germany,G12,NA,NA,NA,NA
silence,198480,198520,40,Germany,G12,NA,NA,NA,NA
silence,200890,201490,600,Germany,G12,NA,NA,NA,NA
silence,205210,205250,40,Germany,G12,NA,NA,NA,NA
silence,206230,206320,90,Germany,G12,NA,NA,NA,NA
silence,208910,210520,1610,Germany,G12,NA,NA,NA,NA
silence,214720,215590,870,Germany,G12,NA,NA,NA,NA
silence,218900,219100,200,Germany,G12,NA,NA,NA,NA
silence,219880,220550,670,Germany,G12,NA,NA,NA,NA
silence,221840,225150,3310,Germany,G12,NA,NA,NA,NA
silence,226250,230320,4070,Germany,G12,NA,NA,NA,NA
silence,232980,233010,30,Germany,G12,NA,NA,NA,NA
silence,233730,236790,3060,Germany,G12,NA,NA,NA,NA
silence,238490,238560,70,Germany,G12,NA,NA,NA,NA
silence,241600,244230,2630,Germany,G12,NA,NA,NA,NA
silence,244770,246090,1320,Germany,G12,NA,NA,NA,NA
father_gesture,246846,248709,1863,Germany,G12,NA,NA,NA,NA
silence,253340,253390,50,Germany,G12,NA,NA,NA,NA
silence,253960,253980,20,Germany,G12,NA,NA,NA,NA
silence,255950,259240,3290,Germany,G12,NA,NA,NA,NA
silence,266740,267180,440,Germany,G12,NA,NA,NA,NA
silence,269470,271550,2080,Germany,G12,NA,NA,NA,NA
silence,276060,276130,70,Germany,G12,NA,NA,NA,NA
silence,277720,278420,700,Germany,G12,NA,NA,NA,NA
silence,281310,283160,1850,Germany,G12,NA,NA,NA,NA
silence,287470,287520,50,Germany,G12,NA,NA,NA,NA
silence,287970,290080,2110,Germany,G12,NA,NA,NA,NA
silence,290900,295270,4370,Germany,G12,NA,NA,NA,NA
silence,296190,296210,20,Germany,G12,NA,NA,NA,NA
silence,297010,297300,290,Germany,G12,NA,NA,NA,NA
silence,298790,298810,20,Germany,G12,NA,NA,NA,NA
silence,299390,299690,300,Germany,G12,NA,NA,NA,NA
silence,301530,303110,1580,Germany,G12,NA,NA,NA,NA
silence,306130,306290,160,Germany,G12,NA,NA,NA,NA
silence,307280,309870,2590,Germany,G12,NA,NA,NA,NA
silence,311790,311870,80,Germany,G12,NA,NA,NA,NA
silence,313330,316120,2790,Germany,G12,NA,NA,NA,NA
silence,317510,317570,60,Germany,G12,NA,NA,NA,NA
silence,318990,323910,4920,Germany,G12,NA,NA,NA,NA
silence,328380,336990,8610,Germany,G12,NA,NA,NA,NA
father_gesture,341325,342435,1110,Germany,G12,NA,NA,NA,NA
silence,351640,351700,60,Germany,G12,NA,NA,NA,NA
mother_gesture,352212,353612,1400,Germany,G12,NA,NA,NA,NA
silence,353440,354210,770,Germany,G12,NA,NA,NA,NA
silence,355110,356820,1710,Germany,G12,NA,NA,NA,NA
silence,357550,363970,6420,Germany,G12,NA,NA,NA,NA
silence,365500,365880,380,Germany,G12,NA,NA,NA,NA
silence,366640,368440,1800,Germany,G12,NA,NA,NA,NA
silence,371710,372990,1280,Germany,G12,NA,NA,NA,NA
silence,374560,376830,2270,Germany,G12,NA,NA,NA,NA
silence,389820,389920,100,Germany,G12,NA,NA,NA,NA
silence,404900,406430,1530,Germany,G12,NA,NA,NA,NA
silence,410840,410970,130,Germany,G12,NA,NA,NA,NA
silence,411590,419380,7790,Germany,G12,NA,NA,NA,NA
silence,420310,420420,110,Germany,G12,NA,NA,NA,NA
silence,420990,421500,510,Germany,G12,NA,NA,NA,NA
silence,422660,423030,370,Germany,G12,NA,NA,NA,NA
silence,424620,425150,530,Germany,G12,NA,NA,NA,NA
silence,428570,429760,1190,Germany,G12,NA,NA,NA,NA
silence,431490,435050,3560,Germany,G12,NA,NA,NA,NA
silence,436190,436420,230,Germany,G12,NA,NA,NA,NA
silence,437030,437540,510,Germany,G12,NA,NA,NA,NA
silence,439000,442720,3720,Germany,G12,NA,NA,NA,NA
silence,452970,453080,110,Germany,G12,NA,NA,NA,NA
silence,454480,454610,130,Germany,G12,NA,NA,NA,NA
silence,456360,457470,1110,Germany,G12,NA,NA,NA,NA
silence,459150,459680,530,Germany,G12,NA,NA,NA,NA
silence,460220,460230,10,Germany,G12,NA,NA,NA,NA
silence,462160,463050,890,Germany,G12,NA,NA,NA,NA
silence,464890,464990,100,Germany,G12,NA,NA,NA,NA
silence,467110,467860,750,Germany,G12,NA,NA,NA,NA
silence,469160,469550,390,Germany,G12,NA,NA,NA,NA
silence,470530,472230,1700,Germany,G12,NA,NA,NA,NA
silence,482600,484250,1650,Germany,G12,NA,NA,NA,NA
father_gesture,496017,496519,502,Germany,G12,NA,NA,NA,NA
mother_gesture,496991,498199,1208,Germany,G12,NA,NA,NA,NA
father_gesture,497141,499045,1904,Germany,G12,NA,NA,NA,NA
silence,498320,499010,690,Germany,G12,NA,NA,NA,NA
silence,526780,526960,180,Germany,G12,NA,NA,NA,NA
silence,527610,528220,610,Germany,G12,NA,NA,NA,NA
silence,533940,535720,1780,Germany,G12,NA,NA,NA,NA
silence,536880,539470,2590,Germany,G12,NA,NA,NA,NA
child_gesture,539245,542379,3134,Germany,G12,NA,NA,NA,NA
silence,544280,544590,310,Germany,G12,NA,NA,NA,NA
silence,548470,549980,1510,Germany,G12,NA,NA,NA,NA
silence,550740,551760,1020,Germany,G12,NA,NA,NA,NA
silence,553120,553570,450,Germany,G12,NA,NA,NA,NA
silence,554050,556940,2890,Germany,G12,NA,NA,NA,NA
father_gesture,557401,558369,968,Germany,G12,NA,NA,NA,NA
silence,563030,563730,700,Germany,G12,NA,NA,NA,NA
silence,564790,564900,110,Germany,G12,NA,NA,NA,NA
silence,566510,567020,510,Germany,G12,NA,NA,NA,NA
silence,568520,568680,160,Germany,G12,NA,NA,NA,NA
silence,570910,570950,40,Germany,G12,NA,NA,NA,NA
silence,571890,572120,230,Germany,G12,NA,NA,NA,NA
silence,574260,575110,850,Germany,G12,NA,NA,NA,NA
silence,577400,577560,160,Germany,G12,NA,NA,NA,NA
silence,579080,579150,70,Germany,G12,NA,NA,NA,NA
child_gesture,579241,580559,1318,Germany,G12,NA,NA,NA,NA
silence,581130,582690,1560,Germany,G12,NA,NA,NA,NA
silence,585070,585830,760,Germany,G12,NA,NA,NA,NA
silence,588730,588760,30,Germany,G12,NA,NA,NA,NA
silence,595830,595860,30,Germany,G12,NA,NA,NA,NA
silence,596370,596520,150,Germany,G12,NA,NA,NA,NA
father,490,1583,1093,Germany,G13,b,1,1,q
mother,1752,2297,545,Germany,G13,f,1,2,a
child,4952,6490,1538,Germany,G13,b,2,1,q
mother,7959,8635,676,Germany,G13,c,3,1,i
child,8649,9249,600,Germany,G13,m,3,2,a
mother,9435,10676,1241,Germany,G13,c,3,3,a
child,10780,11255,475,Germany,G13,m,3,4,a
mother,12621,15124,2503,Germany,G13,c,3,5,a
child,16173,17780,1607,Germany,G13,b,4,1,a
mother,20014,22497,2483,Germany,G13,f,5,1,a
child,21000,24076,3076,Germany,G13,m,6,1,a
mother,24200,27462,3262,Germany,G13,c,6,2,a
child,28014,28842,828,Germany,G13,m,6,3,a
mother,28297,28876,579,Germany,G13,c,6,4,a
child,29297,30538,1241,Germany,G13,m,6,5,a
mother,30200,35786,5586,Germany,G13,c,6,6,a
child,31869,33083,1214,Germany,G13,m,6,7,a
child,35883,40642,4759,Germany,G13,m,6,8,a
mother,40386,46517,6131,Germany,G13,c,6,9,a
child,45435,46483,1048,Germany,G13,m,6,10,a
child,49152,50786,1634,Germany,G13,m,6,11,a
mother,50855,60366,9511,Germany,G13,c,6,12,i
mother,64200,67152,2952,Germany,G13,c,6,13,q
mother,69249,70766,1517,Germany,G13,c,6,14,q
child,69973,71352,1379,Germany,G13,m,7,1,a
mother,71290,73890,2600,Germany,G13,c,7,2,i
mother,84124,85621,1497,Germany,G13,f,8,1,q
father,86152,87423,1271,Germany,G13,m,8,2,a
mother,88455,90697,2242,Germany,G13,f,8,3,a
mother,94331,95966,1635,Germany,G13,c,9,1,a
mother,97711,99876,2165,Germany,G13,c,9,2,a
child,100069,101593,1524,Germany,G13,b,10,1,a
child,103476,104745,1269,Germany,G13,b,10,2,a
mother,105276,107690,2414,Germany,G13,c,10,3,a
child,107649,108186,537,Germany,G13,m,10,4,a
mother,108235,108862,627,Germany,G13,c,10,5,a
child,108800,110545,1745,Germany,G13,m,10,6,a
mother,110469,113897,3428,Germany,G13,c,10,7,a
mother,115711,116904,1193,Germany,G13,c,10,8,q
child,118414,119159,745,Germany,G13,m,10,9,q
mother,119145,119931,786,Germany,G13,c,10,10,a
mother,123228,124917,1689,Germany,G13,c,10,11,a
child,126049,127021,972,Germany,G13,m,10,12,q
mother,126780,129911,3131,Germany,G13,c,10,13,a
child,129966,130566,600,Germany,G13,m,10,14,a
mother,133042,137552,4510,Germany,G13,c,10,15,q
mother,139945,148076,8131,Germany,G13,c,10,16,q
child,148173,148904,731,Germany,G13,m,10,17,a
mother,149697,150683,986,Germany,G13,c,10,18,q
child,149869,151338,1469,Germany,G13,m,10,19,a
mother,151462,158649,7187,Germany,G13,c,10,20,q
mother,164449,170835,6386,Germany,G13,c,10,21,q
child,174952,176531,1579,Germany,G13,f,10,22,a
mother,176945,178297,1352,Germany,G13,c,10,23,a
father,177145,178117,972,Germany,G13,c,10,24,a
child,178600,179917,1317,Germany,G13,f,10,25,a
father,180786,182945,2159,Germany,G13,c,10,26,a
mother,187993,189435,1442,Germany,G13,b,10,27,a
child,191021,193200,2179,Germany,G13,m,10,28,a
mother,194014,196711,2697,Germany,G13,c,10,29,a
mother,198035,200359,2324,Germany,G13,c,10,30,a
mother,211014,211669,655,Germany,G13,c,10,31,a
child,212373,212952,579,Germany,G13,m,10,32,a
mother,212545,214131,1586,Germany,G13,c,10,33,a
child,214159,214993,834,Germany,G13,m,10,34,a
mother,214973,218469,3496,Germany,G13,c,10,35,i
child,218449,219111,662,Germany,G13,m,10,36,a
mother,220166,222152,1986,Germany,G13,c,10,37,i
child,220462,223021,2559,Germany,G13,m,10,38,a
mother,223000,224945,1945,Germany,G13,c,10,39,a
child,223697,225731,2034,Germany,G13,m,10,40,a
mother,225800,226849,1049,Germany,G13,c,10,41,a
child,226373,227359,986,Germany,G13,m,10,42,a
mother,229759,238262,8503,Germany,G13,c,10,43,a
child,229883,230704,821,Germany,G13,m,10,44,a
mother,240490,241242,752,Germany,G13,c,10,45,q
mother,103380,105138,1758,Germany,G13,f,11,1,a
child,159849,164683,4834,Germany,G13,b,12,1,a
mother,252738,253986,1248,Germany,G13,c,13,1,a
mother,256649,269193,12544,Germany,G13,f,14,1,a
mother,278345,281255,2910,Germany,G13,c,15,1,a
mother,293662,294428,766,Germany,G13,c,16,1,q
mother,303986,305766,1780,Germany,G13,f,17,1,q
child,307483,309414,1931,Germany,G13,f,18,1,q
mother,311435,317235,5800,Germany,G13,c,18,2,a
mother,318255,324200,5945,Germany,G13,c,19,1,q
mother,327255,328897,1642,Germany,G13,c,20,1,q
child,329304,330049,745,Germany,G13,m,20,2,a
mother,330842,332035,1193,Germany,G13,c,20,3,q
child,333104,335938,2834,Germany,G13,m,20,4,a
mother,335993,337469,1476,Germany,G13,c,20,5,i
child,338600,339311,711,Germany,G13,m,20,6,a
child,344469,345849,1380,Germany,G13,m,20,7,a
mother,345869,346524,655,Germany,G13,c,20,8,q
child,346890,347773,883,Germany,G13,m,20,9,a
mother,348483,350842,2359,Germany,G13,c,20,10,q
child,351249,352021,772,Germany,G13,m,20,11,a
mother,352304,360145,7841,Germany,G13,c,20,12,q
mother,366600,367911,1311,Germany,G13,c,20,13,q
mother,370235,370862,627,Germany,G13,c,20,14,q
child,370966,371483,517,Germany,G13,m,20,15,a
mother,371697,372207,510,Germany,G13,c,20,16,q
child,373331,374559,1228,Germany,G13,m,20,17,a
child,363083,364573,1490,Germany,G13,f,21,1,a
father,364669,365207,538,Germany,G13,c,21,2,a
child,375173,382628,7455,Germany,G13,f,22,1,a
mother,383076,386076,3000,Germany,G13,c,23,1,q
child,388262,389573,1311,Germany,G13,m,23,2,a
mother,389704,390290,586,Germany,G13,c,23,3,a
child,390504,393083,2579,Germany,G13,b,23,4,a
child,398090,399324,1234,Germany,G13,b,23,5,a
child,400897,401676,779,Germany,G13,m,23,6,a
mother,401642,402869,1227,Germany,G13,c,23,7,q
child,403035,404931,1896,Germany,G13,m,23,8,a
mother,404518,406014,1496,Germany,G13,c,23,9,a
child,405159,406104,945,Germany,G13,m,23,10,a
mother,406097,407504,1407,Germany,G13,c,23,11,a
child,408049,412683,4634,Germany,G13,m,23,12,a
mother,413152,413669,517,Germany,G13,c,23,13,a
child,413718,419497,5779,Germany,G13,m,23,14,a
mother,419966,422311,2345,Germany,G13,c,23,15,i
child,420069,421842,1773,Germany,G13,m,23,16,a
child,424842,426200,1358,Germany,G13,m,23,17,q
mother,425814,438186,12372,Germany,G13,c,23,18,q
child,431904,432711,807,Germany,G13,m,23,19,q
child,440042,441869,1827,Germany,G13,m,23,20,q
mother,441649,445035,3386,Germany,G13,c,23,21,a
child,446366,447021,655,Germany,G13,m,23,22,q
mother,446586,448366,1780,Germany,G13,c,23,23,a
child,447676,449049,1373,Germany,G13,m,23,24,a
mother,449918,451759,1841,Germany,G13,c,23,25,a
child,452642,453414,772,Germany,G13,m,23,26,a
mother,452911,454531,1620,Germany,G13,c,23,27,i
child,455380,456566,1186,Germany,G13,m,23,28,q
mother,456690,457986,1296,Germany,G13,c,23,29,a
child,458262,459483,1221,Germany,G13,m,23,30,a
mother,462386,466697,4311,Germany,G13,c,23,31,a
child,467655,468766,1111,Germany,G13,m,23,32,q
mother,469724,477483,7759,Germany,G13,c,23,33,a
mother,486014,486621,607,Germany,G13,c,23,34,q
father,493918,499373,5455,Germany,G13,m,24,1,a
mother,500269,500821,552,Germany,G13,f,24,2,a
mother,503380,508255,4875,Germany,G13,f,24,3,q
father,508290,509235,945,Germany,G13,m,24,4,a
mother,509407,510421,1014,Germany,G13,f,24,5,q
father,510311,513807,3496,Germany,G13,m,24,6,a
mother,514807,518235,3428,Germany,G13,f,24,7,q
child,504649,505842,1193,Germany,G13,m,25,1,q
child,529786,530628,842,Germany,G13,b,26,1,a
child,538566,539780,1214,Germany,G13,m,27,1,a
mother,540297,542338,2041,Germany,G13,c,27,2,i
child,542580,543400,820,Germany,G13,m,27,3,q
mother,543504,544952,1448,Germany,G13,c,27,4,a
child,544138,544718,580,Germany,G13,m,27,5,q
mother,546676,547614,938,Germany,G13,f,28,1,a
child,550428,551780,1352,Germany,G13,b,29,1,a
mother,552118,554924,2806,Germany,G13,f,30,1,q
father,554807,555255,448,Germany,G13,m,30,2,a
mother,555435,559421,3986,Germany,G13,f,30,3,a
mother,576469,582159,5690,Germany,G13,f,31,1,a
mother,588242,591738,3496,Germany,G13,f,31,2,a
mother,593835,596483,2648,Germany,G13,c,31,3,q
child,597849,598504,655,Germany,G13,m,31,4,a
child,598821,599531,710,Germany,G13,m,31,5,a
silence,1583,1752,169,Germany,G13,NA,NA,NA,NA
silence,2297,4952,2655,Germany,G13,NA,NA,NA,NA
silence,6490,7959,1469,Germany,G13,NA,NA,NA,NA
silence,8635,8649,14,Germany,G13,NA,NA,NA,NA
silence,9249,9435,186,Germany,G13,NA,NA,NA,NA
silence,10676,10780,104,Germany,G13,NA,NA,NA,NA
silence,11255,12621,1366,Germany,G13,NA,NA,NA,NA
silence,15124,16173,1049,Germany,G13,NA,NA,NA,NA
silence,17780,20014,2234,Germany,G13,NA,NA,NA,NA
mother_gesture,21042,22589,1547,Germany,G13,NA,NA,NA,NA
silence,24076,24200,124,Germany,G13,NA,NA,NA,NA
silence,27462,28014,552,Germany,G13,NA,NA,NA,NA
silence,28876,29297,421,Germany,G13,NA,NA,NA,NA
silence,35786,35883,97,Germany,G13,NA,NA,NA,NA
silence,46517,49152,2635,Germany,G13,NA,NA,NA,NA
silence,50786,50855,69,Germany,G13,NA,NA,NA,NA
silence,60366,64200,3834,Germany,G13,NA,NA,NA,NA
silence,67152,69249,2097,Germany,G13,NA,NA,NA,NA
silence,73890,84124,10234,Germany,G13,NA,NA,NA,NA
silence,85621,86152,531,Germany,G13,NA,NA,NA,NA
silence,87423,88455,1032,Germany,G13,NA,NA,NA,NA
silence,90697,94331,3634,Germany,G13,NA,NA,NA,NA
silence,95966,97711,1745,Germany,G13,NA,NA,NA,NA
mother_gesture,97601,98880,1279,Germany,G13,NA,NA,NA,NA
silence,99876,100069,193,Germany,G13,NA,NA,NA,NA
silence,101593,103380,1787,Germany,G13,NA,NA,NA,NA
silence,105138,105276,138,Germany,G13,NA,NA,NA,NA
silence,108186,108235,49,Germany,G13,NA,NA,NA,NA
mother_gesture,111826,113194,1368,Germany,G13,NA,NA,NA,NA
silence,113897,115711,1814,Germany,G13,NA,NA,NA,NA
silence,116904,118414,1510,Germany,G13,NA,NA,NA,NA
silence,119931,123228,3297,Germany,G13,NA,NA,NA,NA
silence,124917,126049,1132,Germany,G13,NA,NA,NA,NA
silence,129911,129966,55,Germany,G13,NA,NA,NA,NA
silence,130566,133042,2476,Germany,G13,NA,NA,NA,NA
silence,137552,139945,2393,Germany,G13,NA,NA,NA,NA
mother_gesture,146513,147153,640,Germany,G13,NA,NA,NA,NA
silence,148076,148173,97,Germany,G13,NA,NA,NA,NA
silence,148904,149697,793,Germany,G13,NA,NA,NA,NA
silence,151338,151462,124,Germany,G13,NA,NA,NA,NA
silence,158649,159849,1200,Germany,G13,NA,NA,NA,NA
silence,170835,174952,4117,Germany,G13,NA,NA,NA,NA
silence,176531,176945,414,Germany,G13,NA,NA,NA,NA
silence,178297,178600,303,Germany,G13,NA,NA,NA,NA
silence,179917,180786,869,Germany,G13,NA,NA,NA,NA
silence,182945,187993,5048,Germany,G13,NA,NA,NA,NA
silence,189435,191021,1586,Germany,G13,NA,NA,NA,NA
silence,193200,194014,814,Germany,G13,NA,NA,NA,NA
silence,196711,198035,1324,Germany,G13,NA,NA,NA,NA
silence,200359,211014,10655,Germany,G13,NA,NA,NA,NA
silence,211669,212373,704,Germany,G13,NA,NA,NA,NA
silence,214131,214159,28,Germany,G13,NA,NA,NA,NA
silence,219111,220166,1055,Germany,G13,NA,NA,NA,NA
silence,225731,225800,69,Germany,G13,NA,NA,NA,NA
silence,227359,229759,2400,Germany,G13,NA,NA,NA,NA
silence,238262,240490,2228,Germany,G13,NA,NA,NA,NA
silence,241242,252738,11496,Germany,G13,NA,NA,NA,NA
silence,253986,256649,2663,Germany,G13,NA,NA,NA,NA
mother_gesture,257121,258400,1279,Germany,G13,NA,NA,NA,NA
silence,269193,278345,9152,Germany,G13,NA,NA,NA,NA
silence,281255,293662,12407,Germany,G13,NA,NA,NA,NA
silence,294428,303986,9558,Germany,G13,NA,NA,NA,NA
silence,305766,307483,1717,Germany,G13,NA,NA,NA,NA
child_gesture,308138,308928,790,Germany,G13,NA,NA,NA,NA
silence,309414,311435,2021,Germany,G13,NA,NA,NA,NA
silence,317235,318255,1020,Germany,G13,NA,NA,NA,NA
silence,324200,327255,3055,Germany,G13,NA,NA,NA,NA
silence,328897,329304,407,Germany,G13,NA,NA,NA,NA
silence,330049,330842,793,Germany,G13,NA,NA,NA,NA
silence,332035,333104,1069,Germany,G13,NA,NA,NA,NA
silence,335938,335993,55,Germany,G13,NA,NA,NA,NA
silence,337469,338600,1131,Germany,G13,NA,NA,NA,NA
silence,339311,344469,5158,Germany,G13,NA,NA,NA,NA
silence,345849,345869,20,Germany,G13,NA,NA,NA,NA
silence,346524,346890,366,Germany,G13,NA,NA,NA,NA
silence,347773,348483,710,Germany,G13,NA,NA,NA,NA
silence,350842,351249,407,Germany,G13,NA,NA,NA,NA
silence,352021,352304,283,Germany,G13,NA,NA,NA,NA
silence,360145,363083,2938,Germany,G13,NA,NA,NA,NA
child_gesture,364006,364999,993,Germany,G13,NA,NA,NA,NA
silence,364573,364669,96,Germany,G13,NA,NA,NA,NA
silence,365207,366600,1393,Germany,G13,NA,NA,NA,NA
silence,367911,370235,2324,Germany,G13,NA,NA,NA,NA
silence,370862,370966,104,Germany,G13,NA,NA,NA,NA
silence,371483,371697,214,Germany,G13,NA,NA,NA,NA
silence,372207,373331,1124,Germany,G13,NA,NA,NA,NA
silence,374559,375173,614,Germany,G13,NA,NA,NA,NA
silence,382628,383076,448,Germany,G13,NA,NA,NA,NA
silence,386076,388262,2186,Germany,G13,NA,NA,NA,NA
silence,389573,389704,131,Germany,G13,NA,NA,NA,NA
silence,390290,390504,214,Germany,G13,NA,NA,NA,NA
silence,393083,398090,5007,Germany,G13,NA,NA,NA,NA
silence,399324,400897,1573,Germany,G13,NA,NA,NA,NA
silence,402869,403035,166,Germany,G13,NA,NA,NA,NA
silence,407504,408049,545,Germany,G13,NA,NA,NA,NA
silence,412683,413152,469,Germany,G13,NA,NA,NA,NA
silence,413669,413718,49,Germany,G13,NA,NA,NA,NA
silence,419497,419966,469,Germany,G13,NA,NA,NA,NA
mother_gesture,421962,422501,539,Germany,G13,NA,NA,NA,NA
silence,422311,424842,2531,Germany,G13,NA,NA,NA,NA
silence,438186,440042,1856,Germany,G13,NA,NA,NA,NA
silence,445035,446366,1331,Germany,G13,NA,NA,NA,NA
child_gesture,447030,449250,2220,Germany,G13,NA,NA,NA,NA
silence,449049,449918,869,Germany,G13,NA,NA,NA,NA
silence,451759,452642,883,Germany,G13,NA,NA,NA,NA
silence,454531,455380,849,Germany,G13,NA,NA,NA,NA
silence,456566,456690,124,Germany,G13,NA,NA,NA,NA
silence,457986,458262,276,Germany,G13,NA,NA,NA,NA
silence,459483,462386,2903,Germany,G13,NA,NA,NA,NA
silence,466697,467655,958,Germany,G13,NA,NA,NA,NA
silence,468766,469724,958,Germany,G13,NA,NA,NA,NA
silence,477483,486014,8531,Germany,G13,NA,NA,NA,NA
silence,486621,493918,7297,Germany,G13,NA,NA,NA,NA
father_gesture,497543,498357,814,Germany,G13,NA,NA,NA,NA
silence,499373,500269,896,Germany,G13,NA,NA,NA,NA
child_gesture,499682,500669,987,Germany,G13,NA,NA,NA,NA
silence,500821,503380,2559,Germany,G13,NA,NA,NA,NA
child_gesture,504631,505901,1270,Germany,G13,NA,NA,NA,NA
silence,508255,508290,35,Germany,G13,NA,NA,NA,NA
silence,509235,509407,172,Germany,G13,NA,NA,NA,NA
silence,513807,514807,1000,Germany,G13,NA,NA,NA,NA
silence,518235,529786,11551,Germany,G13,NA,NA,NA,NA
silence,530628,538566,7938,Germany,G13,NA,NA,NA,NA
silence,539780,540297,517,Germany,G13,NA,NA,NA,NA
silence,542338,542580,242,Germany,G13,NA,NA,NA,NA
child_gesture,542660,545761,3101,Germany,G13,NA,NA,NA,NA
silence,543400,543504,104,Germany,G13,NA,NA,NA,NA
silence,544952,546676,1724,Germany,G13,NA,NA,NA,NA
silence,547614,550428,2814,Germany,G13,NA,NA,NA,NA
silence,551780,552118,338,Germany,G13,NA,NA,NA,NA
silence,555255,555435,180,Germany,G13,NA,NA,NA,NA
silence,559421,576469,17048,Germany,G13,NA,NA,NA,NA
silence,582159,588242,6083,Germany,G13,NA,NA,NA,NA
silence,591738,593835,2097,Germany,G13,NA,NA,NA,NA
silence,596483,597849,1366,Germany,G13,NA,NA,NA,NA
silence,598504,598655,151,Germany,G13,NA,NA,NA,NA
father,890,2780,1890,Germany,G14,c,1,1,a
mother,2370,3930,1560,Germany,G14,c,2,1,a
father,3950,4790,840,Germany,G14,c,2,2,a
child,4770,7140,2370,Germany,G14,b,2,3,a
father,7120,8140,1020,Germany,G14,c,2,4,q
child,8100,8580,480,Germany,G14,f,2,5,a
mother,10270,12630,2360,Germany,G14,c,2,6,a
father,13420,14960,1540,Germany,G14,c,2,7,a
mother,14960,15360,400,Germany,G14,f,2,8,a
mother,16390,17770,1380,Germany,G14,c,2,9,a
father,16640,18440,1800,Germany,G14,c,2,10,q
child,18490,18940,450,Germany,G14,f,2,11,a
father,19070,25870,6800,Germany,G14,c,2,12,a
mother,22410,23630,1220,Germany,G14,o,3,1,a
mother,26110,28010,1900,Germany,G14,c,4,1,q
child,28370,28900,530,Germany,G14,m,4,2,a
father,28480,29630,1150,Germany,G14,m,4,3,a
mother,30180,34590,4410,Germany,G14,b,4,4,a
father,30200,34690,4490,Germany,G14,b,4,5,a
father,34860,35480,620,Germany,G14,c,4,6,a
child,35260,35960,700,Germany,G14,f,4,7,a
mother,35890,36690,800,Germany,G14,c,4,8,a
father,35960,37580,1620,Germany,G14,c,4,9,a
child,36940,37680,740,Germany,G14,b,5,1,a
father,38010,43580,5570,Germany,G14,c,5,2,a
mother,47960,53040,5080,Germany,G14,c,6,1,q
child,53020,54140,1120,Germany,G14,m,6,2,a
mother,54300,58220,3920,Germany,G14,c,6,3,a
father,54520,56140,1620,Germany,G14,c,6,4,q
child,56180,56730,550,Germany,G14,f,6,5,a
father,58120,58900,780,Germany,G14,c,6,6,a
mother,59390,60420,1030,Germany,G14,b,6,7,a
child,59770,61000,1230,Germany,G14,b,6,8,a
mother,61850,73480,11630,Germany,G14,b,6,9,a
father,65800,66440,640,Germany,G14,c,6,10,a
father,73460,74240,780,Germany,G14,b,6,11,a
father,81380,82500,1120,Germany,G14,c,7,1,q
child,81730,83440,1710,Germany,G14,f,7,2,a
father,83930,86630,2700,Germany,G14,c,7,3,i
father,88760,93110,4350,Germany,G14,c,7,4,a
mother,94280,96510,2230,Germany,G14,b,8,1,a
child,96950,97570,620,Germany,G14,m,8,2,a
mother,97860,99350,1490,Germany,G14,c,8,3,q
child,99410,101480,2070,Germany,G14,m,8,4,a
child,103860,106070,2210,Germany,G14,m,8,5,a
mother,106200,107490,1290,Germany,G14,c,8,6,q
child,107520,107970,450,Germany,G14,m,8,7,a
mother,108070,109050,980,Germany,G14,c,8,8,q
child,110250,112240,1990,Germany,G14,m,8,9,a
mother,113590,114430,840,Germany,G14,c,8,10,q
child,114550,114950,400,Germany,G14,m,8,11,a
father,115120,116250,1130,Germany,G14,c,8,12,q
child,115910,116500,590,Germany,G14,b,8,13,a
mother,117080,117770,690,Germany,G14,c,8,14,q
child,117800,118520,720,Germany,G14,m,8,15,a
mother,118900,121420,2520,Germany,G14,c,8,16,a
father,121160,122060,900,Germany,G14,b,8,17,a
child,121540,122180,640,Germany,G14,m,8,18,a
mother,122140,123360,1220,Germany,G14,b,8,19,a
father,124900,128220,3320,Germany,G14,c,8,20,q
child,128590,133010,4420,Germany,G14,f,8,21,a
father,133060,133740,680,Germany,G14,c,8,22,q
child,134320,138110,3790,Germany,G14,b,8,23,a
mother,138100,139170,1070,Germany,G14,c,8,24,q
child,140130,140690,560,Germany,G14,b,8,25,a
mother,145110,145820,710,Germany,G14,b,8,26,a
mother,150270,153730,3460,Germany,G14,b,8,27,a
child,153990,154570,580,Germany,G14,m,8,28,a
mother,154600,155680,1080,Germany,G14,c,8,29,q
child,155750,156480,730,Germany,G14,m,8,30,a
mother,156870,158150,1280,Germany,G14,b,8,31,a
father,145370,149340,3970,Germany,G14,c,9,1,a
mother,160270,161560,1290,Germany,G14,f,10,1,q
father,162490,164210,1720,Germany,G14,m,10,2,a
mother,164420,165580,1160,Germany,G14,f,10,3,q
father,166040,168930,2890,Germany,G14,m,10,4,a
mother,172530,175470,2940,Germany,G14,f,10,5,q
father,176980,178820,1840,Germany,G14,m,10,6,a
father,183130,186400,3270,Germany,G14,o,11,1,a
child,185030,186120,1090,Germany,G14,b,12,1,a
father,186880,189750,2870,Germany,G14,c,12,2,a
child,187260,188590,1330,Germany,G14,m,12,3,q
child,189340,191000,1660,Germany,G14,m,12,4,q
father,189830,191660,1830,Germany,G14,c,12,5,q
mother,190880,194210,3330,Germany,G14,c,12,6,a
father,196140,198450,2310,Germany,G14,c,12,7,a
mother,199840,200560,720,Germany,G14,f,13,1,a
father,200920,202000,1080,Germany,G14,m,13,2,a
father,203900,207310,3410,Germany,G14,m,13,3,a
mother,207620,208400,780,Germany,G14,f,13,4,a
mother,212110,217540,5430,Germany,G14,o,14,1,a
father,214520,214930,410,Germany,G14,c,15,1,a
child,216510,217540,1030,Germany,G14,b,15,2,a
father,218280,219200,920,Germany,G14,c,15,3,a
child,219270,220140,870,Germany,G14,f,15,4,a
father,220530,227620,7090,Germany,G14,c,15,5,a
mother,218960,221270,2310,Germany,G14,o,16,1,i
father,239690,242220,2530,Germany,G14,c,17,1,a
mother,240030,240980,950,Germany,G14,b,17,2,a
mother,243750,244500,750,Germany,G14,b,17,3,a
father,244010,246560,2550,Germany,G14,c,17,4,a
father,248780,250450,1670,Germany,G14,c,17,5,q
mother,251530,255980,4450,Germany,G14,b,18,1,a
child,256280,256910,630,Germany,G14,m,18,2,a
mother,256860,260280,3420,Germany,G14,c,18,3,q
child,258550,258990,440,Germany,G14,m,18,4,a
child,260570,261410,840,Germany,G14,m,18,5,a
father,261410,262530,1120,Germany,G14,c,18,6,q
child,262690,263640,950,Germany,G14,b,18,7,a
father,264710,265560,850,Germany,G14,c,18,8,q
mother,266630,267340,710,Germany,G14,c,18,9,q
father,268970,270990,2020,Germany,G14,c,18,10,q
mother,268980,269610,630,Germany,G14,c,18,11,a
child,270060,271200,1140,Germany,G14,f,18,12,a
father,271220,273060,1840,Germany,G14,c,18,13,q
child,273050,273470,420,Germany,G14,f,18,14,a
mother,273460,275700,2240,Germany,G14,b,18,15,a
father,273500,275150,1650,Germany,G14,b,18,16,q
father,276050,277300,1250,Germany,G14,c,18,17,q
child,277350,278120,770,Germany,G14,f,18,18,a
father,278170,281019,2849,Germany,G14,c,18,19,q
child,281340,282060,720,Germany,G14,f,18,20,a
father,282070,284020,1950,Germany,G14,c,18,21,a
child,284780,286040,1260,Germany,G14,b,18,22,a
father,285440,287270,1830,Germany,G14,c,18,23,q
child,287470,288200,730,Germany,G14,f,18,24,a
father,290170,290860,690,Germany,G14,c,18,25,a
father,292920,296670,3750,Germany,G14,c,19,1,a
child,293820,296460,2640,Germany,G14,f,19,2,a
father,296710,301040,4330,Germany,G14,o,19,3,a
father,301600,302750,1150,Germany,G14,c,19,4,q
child,302820,303250,430,Germany,G14,f,19,5,a
father,303240,305890,2650,Germany,G14,c,19,6,a
mother,305920,309711,3791,Germany,G14,b,19,7,a
father,307670,308220,550,Germany,G14,m,19,8,a
child,308530,310290,1760,Germany,G14,b,20,1,a
father,310170,315752,5582,Germany,G14,c,20,2,a
father,318680,323680,5000,Germany,G14,c,20,3,q
father,326120,327780,1660,Germany,G14,c,21,1,a
father,334550,336120,1570,Germany,G14,c,22,1,a
mother,335920,338650,2730,Germany,G14,f,22,2,a
father,338610,339540,930,Germany,G14,c,22,3,a
child,338800,340560,1760,Germany,G14,b,22,4,a
mother,340590,342820,2230,Germany,G14,c,22,5,a
father,340840,347400,6560,Germany,G14,c,22,6,a
child,342110,343600,1490,Germany,G14,f,22,7,a
child,350430,351570,1140,Germany,G14,m,22,8,a
mother,351510,352240,730,Germany,G14,c,22,9,a
father,351570,352790,1220,Germany,G14,m,22,10,a
father,353470,354910,1440,Germany,G14,c,22,11,a
father,358710,359490,780,Germany,G14,c,22,12,a
father,364520,369470,4950,Germany,G14,c,22,13,a
child,369590,370440,850,Germany,G14,b,22,14,a
mother,368610,376180,7570,Germany,G14,f,23,1,a
father,376140,376670,530,Germany,G14,m,23,2,a
mother,377270,384180,6910,Germany,G14,f,23,3,a
father,382610,385350,2740,Germany,G14,m,23,4,a
mother,384430,385240,810,Germany,G14,f,23,5,a
father,385470,386540,1070,Germany,G14,c,24,1,a
child,389850,391000,1150,Germany,G14,f,25,1,a
father,391050,399390,8340,Germany,G14,c,25,2,a
mother,397120,402110,4990,Germany,G14,c,26,1,a
child,398880,400600,1720,Germany,G14,b,26,2,a
father,402130,405760,3630,Germany,G14,c,26,3,a
mother,402910,403730,820,Germany,G14,c,26,4,a
mother,405930,407260,1330,Germany,G14,c,26,5,a
father,407090,408600,1510,Germany,G14,c,26,6,a
father,409530,413390,3860,Germany,G14,c,27,1,q
child,413380,414320,940,Germany,G14,f,27,2,a
father,414310,415310,1000,Germany,G14,c,27,3,q
child,415330,415780,450,Germany,G14,f,27,4,a
father,415800,418360,2560,Germany,G14,c,27,5,a
child,416700,417810,1110,Germany,G14,m,27,6,a
mother,417780,422600,4820,Germany,G14,c,28,1,q
child,423090,423510,420,Germany,G14,m,28,2,a
mother,423280,425930,2650,Germany,G14,c,28,3,q
child,426620,429930,3310,Germany,G14,m,28,4,a
father,429170,429990,820,Germany,G14,b,28,5,q
father,430190,430840,650,Germany,G14,b,28,6,q
mother,432020,433360,1340,Germany,G14,c,28,7,q
child,435470,436760,1290,Germany,G14,m,28,8,a
father,436770,437630,860,Germany,G14,c,28,9,q
mother,436930,438240,1310,Germany,G14,c,28,10,q
child,438450,439130,680,Germany,G14,m,28,11,a
mother,439240,440600,1360,Germany,G14,b,28,12,a
father,440900,443100,2200,Germany,G14,c,28,13,a
mother,442290,445420,3130,Germany,G14,b,28,14,a
father,443940,445620,1680,Germany,G14,m,28,15,a
mother,446800,460020,13220,Germany,G14,b,28,16,a
father,459240,460690,1450,Germany,G14,c,28,17,a
mother,460400,467150,6750,Germany,G14,c,28,18,q
father,467380,476290,8910,Germany,G14,c,29,1,a
child,477850,479000,1150,Germany,G14,b,30,1,a
father,479130,480700,1570,Germany,G14,c,30,2,a
child,480850,482100,1250,Germany,G14,b,30,3,a
father,483850,485320,1470,Germany,G14,c,30,4,q
child,485350,486020,670,Germany,G14,f,30,5,a
father,485990,487730,1740,Germany,G14,c,30,6,a
mother,487730,488840,1110,Germany,G14,c,30,7,a
child,487950,488420,470,Germany,G14,f,30,8,a
father,489450,490650,1200,Germany,G14,c,30,9,a
father,494550,495530,980,Germany,G14,f,30,10,a
child,494770,499090,4320,Germany,G14,f,30,11,a
father,497870,499290,1420,Germany,G14,c,30,12,a
child,499540,499980,440,Germany,G14,f,30,13,a
father,502850,503990,1140,Germany,G14,c,30,14,a
child,503330,505240,1910,Germany,G14,f,31,1,a
father,505680,506950,1270,Germany,G14,c,31,2,a
child,507010,507870,860,Germany,G14,f,31,3,a
father,508690,514370,5680,Germany,G14,c,31,4,q
child,509530,510030,500,Germany,G14,f,31,5,a
child,519050,520260,1210,Germany,G14,f,31,6,a
child,515760,516500,740,Germany,G14,f,32,1,a
father,518320,522750,4430,Germany,G14,c,33,1,q
father,525020,526800,1780,Germany,G14,b,33,2,a
father,529530,532000,2470,Germany,G14,c,34,1,q
child,531900,532890,990,Germany,G14,f,34,2,a
father,532880,543570,10690,Germany,G14,c,34,3,a
child,547570,548510,940,Germany,G14,m,35,1,q
mother,548490,549270,780,Germany,G14,c,35,2,a
child,552770,554530,1760,Germany,G14,m,35,3,q
mother,554560,555080,520,Germany,G14,c,35,4,a
mother,557650,564290,6640,Germany,G14,c,35,5,a
father,574080,574700,620,Germany,G14,c,35,6,a
father,577210,579380,2170,Germany,G14,c,36,1,q
child,579180,580380,1200,Germany,G14,f,36,2,a
father,580210,581010,800,Germany,G14,c,36,3,q
child,581120,581620,500,Germany,G14,f,36,4,a
father,581600,582100,500,Germany,G14,c,36,5,a
mother,582190,584060,1870,Germany,G14,c,37,1,q
child,584200,585350,1150,Germany,G14,m,37,2,a
mother,585480,588290,2810,Germany,G14,c,37,3,q
child,588740,589800,1060,Germany,G14,m,37,4,a
mother,589840,590570,730,Germany,G14,c,37,5,q
child,590790,591340,550,Germany,G14,m,37,6,a
mother,597990,600540,2550,Germany,G14,c,37,7,q
silence,3930,3950,20,Germany,G14,NA,NA,NA,NA
silence,8580,10270,1690,Germany,G14,NA,NA,NA,NA
silence,12630,13420,790,Germany,G14,NA,NA,NA,NA
silence,15360,16390,1030,Germany,G14,NA,NA,NA,NA
silence,18440,18490,50,Germany,G14,NA,NA,NA,NA
silence,18940,19070,130,Germany,G14,NA,NA,NA,NA
silence,25870,26110,240,Germany,G14,NA,NA,NA,NA
silence,28010,28370,360,Germany,G14,NA,NA,NA,NA
silence,29630,30180,550,Germany,G14,NA,NA,NA,NA
silence,34690,34860,170,Germany,G14,NA,NA,NA,NA
child_gesture,37268,38612,1344,Germany,G14,NA,NA,NA,NA
silence,37680,38010,330,Germany,G14,NA,NA,NA,NA
silence,43580,47960,4380,Germany,G14,NA,NA,NA,NA
silence,54140,54300,160,Germany,G14,NA,NA,NA,NA
silence,58900,59390,490,Germany,G14,NA,NA,NA,NA
silence,61000,61850,850,Germany,G14,NA,NA,NA,NA
mother_gesture,70915,71422,507,Germany,G14,NA,NA,NA,NA
silence,74240,81380,7140,Germany,G14,NA,NA,NA,NA
silence,83440,83930,490,Germany,G14,NA,NA,NA,NA
silence,86630,88760,2130,Germany,G14,NA,NA,NA,NA
silence,93110,94280,1170,Germany,G14,NA,NA,NA,NA
silence,96510,96950,440,Germany,G14,NA,NA,NA,NA
silence,97570,97860,290,Germany,G14,NA,NA,NA,NA
silence,99350,99410,60,Germany,G14,NA,NA,NA,NA
silence,101480,103860,2380,Germany,G14,NA,NA,NA,NA
silence,106070,106200,130,Germany,G14,NA,NA,NA,NA
silence,107490,107520,30,Germany,G14,NA,NA,NA,NA
silence,107970,108070,100,Germany,G14,NA,NA,NA,NA
silence,109050,110250,1200,Germany,G14,NA,NA,NA,NA
silence,112240,113590,1350,Germany,G14,NA,NA,NA,NA
silence,114430,114550,120,Germany,G14,NA,NA,NA,NA
silence,114950,115120,170,Germany,G14,NA,NA,NA,NA
silence,116500,117080,580,Germany,G14,NA,NA,NA,NA
silence,117770,117800,30,Germany,G14,NA,NA,NA,NA
silence,118520,118900,380,Germany,G14,NA,NA,NA,NA
silence,123360,124900,1540,Germany,G14,NA,NA,NA,NA
silence,128220,128590,370,Germany,G14,NA,NA,NA,NA
silence,133010,133060,50,Germany,G14,NA,NA,NA,NA
silence,133740,134320,580,Germany,G14,NA,NA,NA,NA
child_gesture,134796,138378,3582,Germany,G14,NA,NA,NA,NA
silence,139170,140130,960,Germany,G14,NA,NA,NA,NA
silence,140690,145110,4420,Germany,G14,NA,NA,NA,NA
silence,149340,150270,930,Germany,G14,NA,NA,NA,NA
silence,153730,153990,260,Germany,G14,NA,NA,NA,NA
silence,154570,154600,30,Germany,G14,NA,NA,NA,NA
silence,155680,155750,70,Germany,G14,NA,NA,NA,NA
silence,156480,156870,390,Germany,G14,NA,NA,NA,NA
silence,158150,160270,2120,Germany,G14,NA,NA,NA,NA
silence,161560,162490,930,Germany,G14,NA,NA,NA,NA
silence,164210,164420,210,Germany,G14,NA,NA,NA,NA
silence,165580,166040,460,Germany,G14,NA,NA,NA,NA
father_gesture,166228,167830,1602,Germany,G14,NA,NA,NA,NA
silence,168930,172530,3600,Germany,G14,NA,NA,NA,NA
mother_gesture,173792,175353,1561,Germany,G14,NA,NA,NA,NA
silence,175470,176980,1510,Germany,G14,NA,NA,NA,NA
silence,178820,183130,4310,Germany,G14,NA,NA,NA,NA
silence,186400,186880,480,Germany,G14,NA,NA,NA,NA
silence,194210,196140,1930,Germany,G14,NA,NA,NA,NA
silence,198450,199840,1390,Germany,G14,NA,NA,NA,NA
silence,200560,200920,360,Germany,G14,NA,NA,NA,NA
silence,202000,203900,1900,Germany,G14,NA,NA,NA,NA
silence,207310,207620,310,Germany,G14,NA,NA,NA,NA
silence,208400,212110,3710,Germany,G14,NA,NA,NA,NA
child_gesture,216847,218105,1258,Germany,G14,NA,NA,NA,NA
silence,217540,218280,740,Germany,G14,NA,NA,NA,NA
silence,227620,239690,12070,Germany,G14,NA,NA,NA,NA
silence,242220,243750,1530,Germany,G14,NA,NA,NA,NA
silence,246560,248780,2220,Germany,G14,NA,NA,NA,NA
silence,250450,251530,1080,Germany,G14,NA,NA,NA,NA
silence,255980,256280,300,Germany,G14,NA,NA,NA,NA
silence,260280,260570,290,Germany,G14,NA,NA,NA,NA
silence,262530,262690,160,Germany,G14,NA,NA,NA,NA
silence,263640,264710,1070,Germany,G14,NA,NA,NA,NA
silence,265560,266630,1070,Germany,G14,NA,NA,NA,NA
silence,267340,268970,1630,Germany,G14,NA,NA,NA,NA
silence,271200,271220,20,Germany,G14,NA,NA,NA,NA
silence,275700,276050,350,Germany,G14,NA,NA,NA,NA
silence,277300,277350,50,Germany,G14,NA,NA,NA,NA
silence,278120,278170,50,Germany,G14,NA,NA,NA,NA
silence,281019,281340,321,Germany,G14,NA,NA,NA,NA
silence,282060,282070,10,Germany,G14,NA,NA,NA,NA
silence,284020,284780,760,Germany,G14,NA,NA,NA,NA
silence,287270,287470,200,Germany,G14,NA,NA,NA,NA
silence,288200,290170,1970,Germany,G14,NA,NA,NA,NA
silence,290860,292920,2060,Germany,G14,NA,NA,NA,NA
father_gesture,294604,296477,1873,Germany,G14,NA,NA,NA,NA
silence,296670,296710,40,Germany,G14,NA,NA,NA,NA
silence,301040,301600,560,Germany,G14,NA,NA,NA,NA
silence,302750,302820,70,Germany,G14,NA,NA,NA,NA
silence,305890,305920,30,Germany,G14,NA,NA,NA,NA
child_gesture,308925,310500,1575,Germany,G14,NA,NA,NA,NA
father_gesture,310612,312233,1621,Germany,G14,NA,NA,NA,NA
silence,315752,318680,2928,Germany,G14,NA,NA,NA,NA
father_gesture,319174,319724,550,Germany,G14,NA,NA,NA,NA
father_gesture,320086,321041,955,Germany,G14,NA,NA,NA,NA
silence,323680,326120,2440,Germany,G14,NA,NA,NA,NA
silence,327780,334550,6770,Germany,G14,NA,NA,NA,NA
child_gesture,334860,335673,813,Germany,G14,NA,NA,NA,NA
child_gesture,339276,340728,1452,Germany,G14,NA,NA,NA,NA
silence,340560,340590,30,Germany,G14,NA,NA,NA,NA
child_gesture,342875,344301,1426,Germany,G14,NA,NA,NA,NA
silence,347400,350430,3030,Germany,G14,NA,NA,NA,NA
silence,352790,353470,680,Germany,G14,NA,NA,NA,NA
silence,354910,358710,3800,Germany,G14,NA,NA,NA,NA
silence,359490,364520,5030,Germany,G14,NA,NA,NA,NA
father_gesture,364852,365471,619,Germany,G14,NA,NA,NA,NA
silence,376670,377270,600,Germany,G14,NA,NA,NA,NA
mother_gesture,380780,382107,1327,Germany,G14,NA,NA,NA,NA
silence,385350,385470,120,Germany,G14,NA,NA,NA,NA
silence,386540,389850,3310,Germany,G14,NA,NA,NA,NA
silence,391000,391050,50,Germany,G14,NA,NA,NA,NA
mother_gesture,400424,401718,1294,Germany,G14,NA,NA,NA,NA
silence,402110,402130,20,Germany,G14,NA,NA,NA,NA
silence,405760,405930,170,Germany,G14,NA,NA,NA,NA
silence,408600,409530,930,Germany,G14,NA,NA,NA,NA
silence,415310,415330,20,Germany,G14,NA,NA,NA,NA
silence,415780,415800,20,Germany,G14,NA,NA,NA,NA
silence,422600,423090,490,Germany,G14,NA,NA,NA,NA
silence,425930,426620,690,Germany,G14,NA,NA,NA,NA
silence,429990,430190,200,Germany,G14,NA,NA,NA,NA
silence,430840,432020,1180,Germany,G14,NA,NA,NA,NA
silence,433360,435470,2110,Germany,G14,NA,NA,NA,NA
silence,436760,436770,10,Germany,G14,NA,NA,NA,NA
silence,438240,438450,210,Germany,G14,NA,NA,NA,NA
silence,439130,439240,110,Germany,G14,NA,NA,NA,NA
silence,440600,440900,300,Germany,G14,NA,NA,NA,NA
silence,445620,446800,1180,Germany,G14,NA,NA,NA,NA
mother_gesture,457248,458467,1219,Germany,G14,NA,NA,NA,NA
silence,467150,467380,230,Germany,G14,NA,NA,NA,NA
silence,476290,477850,1560,Germany,G14,NA,NA,NA,NA
child_gesture,478035,481554,3519,Germany,G14,NA,NA,NA,NA
silence,479000,479130,130,Germany,G14,NA,NA,NA,NA
silence,480700,480850,150,Germany,G14,NA,NA,NA,NA
silence,482100,483850,1750,Germany,G14,NA,NA,NA,NA
father_gesture,484226,485480,1254,Germany,G14,NA,NA,NA,NA
silence,485320,485350,30,Germany,G14,NA,NA,NA,NA
silence,488840,489450,610,Germany,G14,NA,NA,NA,NA
silence,490650,494550,3900,Germany,G14,NA,NA,NA,NA
child_gesture,493059,498750,5691,Germany,G14,NA,NA,NA,NA
silence,499290,499540,250,Germany,G14,NA,NA,NA,NA
silence,499980,502850,2870,Germany,G14,NA,NA,NA,NA
silence,505240,505680,440,Germany,G14,NA,NA,NA,NA
silence,506950,507010,60,Germany,G14,NA,NA,NA,NA
silence,507870,508690,820,Germany,G14,NA,NA,NA,NA
father_gesture,509638,510199,561,Germany,G14,NA,NA,NA,NA
father_gesture,510910,512117,1207,Germany,G14,NA,NA,NA,NA
silence,514370,515760,1390,Germany,G14,NA,NA,NA,NA
silence,516500,518320,1820,Germany,G14,NA,NA,NA,NA
silence,522750,525020,2270,Germany,G14,NA,NA,NA,NA
silence,526800,529530,2730,Germany,G14,NA,NA,NA,NA
father_gesture,530208,531986,1778,Germany,G14,NA,NA,NA,NA
silence,543570,547570,4000,Germany,G14,NA,NA,NA,NA
silence,549270,552770,3500,Germany,G14,NA,NA,NA,NA
silence,554530,554560,30,Germany,G14,NA,NA,NA,NA
silence,555080,557650,2570,Germany,G14,NA,NA,NA,NA
silence,564290,574080,9790,Germany,G14,NA,NA,NA,NA
silence,574700,577210,2510,Germany,G14,NA,NA,NA,NA
silence,581010,581120,110,Germany,G14,NA,NA,NA,NA
silence,582100,582190,90,Germany,G14,NA,NA,NA,NA
silence,584060,584200,140,Germany,G14,NA,NA,NA,NA
silence,585350,585480,130,Germany,G14,NA,NA,NA,NA
silence,588290,588740,450,Germany,G14,NA,NA,NA,NA
silence,589800,589840,40,Germany,G14,NA,NA,NA,NA
silence,590570,590790,220,Germany,G14,NA,NA,NA,NA
silence,591340,597990,6650,Germany,G14,NA,NA,NA,NA
mother,154,11438,11284,Germany,G15,f,1,1,a
father,11582,12491,909,Germany,G15,m,1,2,q
mother,12951,14712,1761,Germany,G15,f,1,3,a
father,14734,16484,1750,Germany,G15,m,1,4,a
mother,16710,27323,10613,Germany,G15,f,1,5,a
father,27423,28082,659,Germany,G15,m,1,6,q
mother,28144,32019,3875,Germany,G15,f,1,7,a
father,32087,32973,886,Germany,G15,m,1,8,q
mother,33047,35183,2136,Germany,G15,f,1,9,a
father,35337,35746,409,Germany,G15,m,1,10,q
mother,35865,36422,557,Germany,G15,f,1,11,a
father,37393,40518,3125,Germany,G15,m,1,12,q
mother,40549,44833,4284,Germany,G15,f,1,13,a
father,48469,49810,1341,Germany,G15,c,2,1,q
mother,49861,51781,1920,Germany,G15,c,3,1,q
father,52793,53645,852,Germany,G15,c,3,2,q
mother,54031,57236,3205,Germany,G15,f,3,3,a
child,54482,54891,409,Germany,G15,f,3,4,a
father,58332,59616,1284,Germany,G15,m,3,5,q
mother,60514,63866,3352,Germany,G15,f,3,6,a
father,67881,69654,1773,Germany,G15,m,3,7,a
mother,69753,75047,5294,Germany,G15,f,4,1,a
father,75078,76407,1329,Germany,G15,m,4,2,a
mother,76493,81243,4750,Germany,G15,f,4,3,a
father,81292,82724,1432,Germany,G15,m,4,4,a
father,84536,86593,2057,Germany,G15,m,5,1,a
mother,88878,89821,943,Germany,G15,f,5,2,q
father,89844,91674,1830,Germany,G15,m,6,1,q
mother,91354,91957,603,Germany,G15,f,6,2,a
mother,94970,96561,1591,Germany,G15,c,7,1,q
child,96592,97046,454,Germany,G15,m,7,2,a
father,96743,99846,3103,Germany,G15,m,8,1,a
mother,99705,100694,989,Germany,G15,f,8,2,a
father,100940,102235,1295,Germany,G15,m,8,3,a
mother,102629,103913,1284,Germany,G15,f,8,4,q
father,103898,104751,853,Germany,G15,m,8,5,a
mother,105095,106731,1636,Germany,G15,f,8,6,a
mother,113594,117014,3420,Germany,G15,c,9,1,a
father,120233,121995,1762,Germany,G15,m,10,1,q
father,125077,126213,1136,Germany,G15,m,10,2,a
mother,126911,129002,2091,Germany,G15,f,11,1,q
father,128857,129676,819,Germany,G15,m,11,2,a
mother,129900,130957,1057,Germany,G15,f,11,3,q
father,131053,137860,6807,Germany,G15,m,11,4,a
mother,137803,138507,704,Germany,G15,f,11,5,a
father,138870,140245,1375,Germany,G15,m,11,6,a
child,141324,143233,1909,Germany,G15,b,12,1,a
mother,143504,144731,1227,Germany,G15,c,12,2,q
child,144846,145857,1011,Germany,G15,m,12,3,a
child,149203,151465,2262,Germany,G15,b,12,4,a
father,152313,153438,1125,Germany,G15,c,12,5,q
child,153444,156569,3125,Germany,G15,f,12,6,a
father,157231,162186,4955,Germany,G15,c,12,7,a
child,162230,163139,909,Germany,G15,f,12,8,a
father,163145,164202,1057,Germany,G15,c,12,9,a
child,164973,165757,784,Germany,G15,f,12,10,a
father,167747,170610,2863,Germany,G15,c,12,11,a
mother,172361,174225,1864,Germany,G15,b,12,12,q
child,175747,178679,2932,Germany,G15,f,12,13,a
father,176059,176866,807,Germany,G15,m,12,14,a
child,184072,186947,2875,Germany,G15,b,12,15,a
child,189864,192171,2307,Germany,G15,b,12,16,a
father,192650,195320,2670,Germany,G15,c,12,17,a
mother,193316,195135,1819,Germany,G15,c,12,18,a
father,195825,202678,6853,Germany,G15,c,12,19,a
child,206653,208846,2193,Germany,G15,b,12,20,a
father,216129,219129,3000,Germany,G15,c,12,21,a
mother,210604,211740,1136,Germany,G15,c,13,1,i
father,222916,224325,1409,Germany,G15,c,14,1,a
child,224605,225559,954,Germany,G15,f,14,2,a
child,239311,240675,1364,Germany,G15,f,14,3,i
mother,235729,242866,7137,Germany,G15,f,15,1,a
father,243299,244389,1090,Germany,G15,m,15,2,a
mother,244509,248066,3557,Germany,G15,f,15,3,a
father,246811,247720,909,Germany,G15,m,15,4,a
mother,248694,251126,2432,Germany,G15,f,15,5,a
father,256452,259247,2795,Germany,G15,m,15,6,a
child,243591,244409,818,Germany,G15,f,16,1,i
mother,256667,257667,1000,Germany,G15,f,17,1,a
mother,259295,262216,2921,Germany,G15,f,17,2,a
father,262248,262726,478,Germany,G15,m,17,3,q
mother,266790,270801,4011,Germany,G15,f,17,4,a
father,272642,273983,1341,Germany,G15,m,17,5,a
mother,274728,275478,750,Germany,G15,f,17,6,a
father,276290,277631,1341,Germany,G15,m,17,7,a
child,279201,282610,3409,Germany,G15,b,18,1,a
father,283249,283726,477,Germany,G15,c,18,2,q
child,284502,286127,1625,Germany,G15,b,18,3,a
father,286763,287934,1171,Germany,G15,c,18,4,a
mother,287036,287911,875,Germany,G15,c,18,5,a
child,288727,289681,954,Germany,G15,b,18,6,q
father,289730,290674,944,Germany,G15,c,18,7,a
mother,289957,290536,579,Germany,G15,c,18,8,a
mother,291891,294448,2557,Germany,G15,c,19,1,q
mother,296257,297586,1329,Germany,G15,c,19,2,a
child,297668,300747,3079,Germany,G15,m,19,3,a
mother,304182,305034,852,Germany,G15,c,19,4,q
child,307602,310921,3319,Germany,G15,b,19,5,a
father,310682,315928,5246,Germany,G15,c,19,6,a
mother,318968,325332,6364,Germany,G15,f,20,1,a
father,325227,325795,568,Germany,G15,m,20,2,a
mother,327102,334932,7830,Germany,G15,f,20,3,a
father,336121,337110,989,Germany,G15,m,20,4,q
mother,338580,339285,705,Germany,G15,f,20,5,a
father,340369,345733,5364,Germany,G15,m,20,6,a
mother,348243,359492,11249,Germany,G15,f,20,7,a
father,359551,360131,580,Germany,G15,m,20,8,q
mother,360213,369752,9539,Germany,G15,f,20,9,a
mother,374179,377542,3363,Germany,G15,f,20,10,a
child,333861,334929,1068,Germany,G15,o,21,1,a
father,372448,373402,954,Germany,G15,c,22,1,q
child,373545,374159,614,Germany,G15,f,22,2,a
father,375562,376403,841,Germany,G15,c,22,3,a
father,377580,383512,5932,Germany,G15,c,22,4,a
mother,383209,384766,1557,Germany,G15,c,24,1,q
mother,389936,390345,409,Germany,G15,c,24,2,q
father,392845,393607,762,Germany,G15,c,25,1,i
child,394696,400798,6102,Germany,G15,b,26,1,a
father,402718,403775,1057,Germany,G15,c,26,2,q
child,403828,404237,409,Germany,G15,f,26,3,q
father,404494,408244,3750,Germany,G15,c,26,4,q
child,410777,418925,8148,Germany,G15,f,26,5,a
mother,418880,420402,1522,Germany,G15,c,27,1,q
child,420251,421876,1625,Germany,G15,m,27,2,a
mother,421967,424683,2716,Germany,G15,c,27,3,a
child,430136,431580,1444,Germany,G15,m,27,4,a
mother,434155,435036,881,Germany,G15,c,27,5,a
father,435167,438675,3508,Germany,G15,c,27,6,a
child,438385,438982,597,Germany,G15,b,27,7,a
mother,453896,454840,944,Germany,G15,c,27,8,q
child,456124,456362,238,Germany,G15,m,27,9,a
mother,459407,462055,2648,Germany,G15,c,27,10,q
mother,465407,465998,591,Germany,G15,c,27,11,q
child,466953,467419,466,Germany,G15,m,27,12,a
father,471620,474023,2403,Germany,G15,c,27,13,a
mother,474617,475321,704,Germany,G15,f,27,14,q
father,478685,480162,1477,Germany,G15,c,27,15,q
child,481172,481627,455,Germany,G15,f,27,16,a
father,482093,482638,545,Germany,G15,c,27,17,q
child,484183,487556,3373,Germany,G15,f,27,18,a
father,506154,506802,648,Germany,G15,c,27,19,q
mother,491222,493188,1966,Germany,G15,c,28,1,q
mother,508037,509946,1909,Germany,G15,c,29,1,q
father,509986,515300,5314,Germany,G15,c,29,2,a
child,515363,516408,1045,Germany,G15,f,29,3,a
father,517213,523914,6701,Germany,G15,c,29,4,q
child,523892,524608,716,Germany,G15,f,29,5,a
father,524775,526581,1806,Germany,G15,c,29,6,q
child,528863,529609,746,Germany,G15,b,30,1,a
father,533034,534386,1352,Germany,G15,c,30,2,q
child,535758,536224,466,Germany,G15,f,30,3,a
mother,541488,543026,1538,Germany,G15,c,30,4,q
child,544062,544659,597,Germany,G15,m,30,5,a
mother,548361,556567,8206,Germany,G15,f,31,1,a
father,556626,571029,14403,Germany,G15,m,31,2,a
child,557925,559686,1761,Germany,G15,b,32,1,a
mother,560429,561115,686,Germany,G15,c,32,2,q
child,561160,561503,343,Germany,G15,m,32,3,a
mother,571888,573433,1545,Germany,G15,f,32,4,q
father,573973,575018,1045,Germany,G15,m,32,5,a
mother,577456,578741,1285,Germany,G15,f,32,6,q
father,580194,580694,500,Germany,G15,m,33,1,q
mother,580970,582015,1045,Germany,G15,f,33,2,q
father,582717,583598,881,Germany,G15,m,33,3,q
mother,583606,584144,538,Germany,G15,f,33,4,q
father,584208,592716,8508,Germany,G15,m,33,5,q
mother,594040,600603,6563,Germany,G15,f,33,6,a
child,581681,583413,1732,Germany,G15,b,34,1,a
child,584977,602378,17401,Germany,G15,o,35,1,a
child,357088,359463,2375,Germany,G15,b,44,1,a
silence,11438,11582,144,Germany,G15,NA,NA,NA,NA
silence,12491,12951,460,Germany,G15,NA,NA,NA,NA
silence,14712,14734,22,Germany,G15,NA,NA,NA,NA
silence,16484,16710,226,Germany,G15,NA,NA,NA,NA
silence,27323,27423,100,Germany,G15,NA,NA,NA,NA
silence,28082,28144,62,Germany,G15,NA,NA,NA,NA
silence,32019,32087,68,Germany,G15,NA,NA,NA,NA
silence,32973,33047,74,Germany,G15,NA,NA,NA,NA
silence,35183,35337,154,Germany,G15,NA,NA,NA,NA
silence,35746,35865,119,Germany,G15,NA,NA,NA,NA
silence,36422,37393,971,Germany,G15,NA,NA,NA,NA
silence,40518,40549,31,Germany,G15,NA,NA,NA,NA
silence,44833,48469,3636,Germany,G15,NA,NA,NA,NA
silence,49810,49861,51,Germany,G15,NA,NA,NA,NA
silence,51781,52793,1012,Germany,G15,NA,NA,NA,NA
father_gesture,52996,53700,704,Germany,G15,NA,NA,NA,NA
silence,53645,54031,386,Germany,G15,NA,NA,NA,NA
silence,57236,58332,1096,Germany,G15,NA,NA,NA,NA
silence,59616,60514,898,Germany,G15,NA,NA,NA,NA
silence,63866,67881,4015,Germany,G15,NA,NA,NA,NA
silence,69654,69753,99,Germany,G15,NA,NA,NA,NA
silence,75047,75078,31,Germany,G15,NA,NA,NA,NA
silence,76407,76493,86,Germany,G15,NA,NA,NA,NA
silence,81243,81292,49,Germany,G15,NA,NA,NA,NA
silence,82724,84536,1812,Germany,G15,NA,NA,NA,NA
silence,86593,88878,2285,Germany,G15,NA,NA,NA,NA
silence,89821,89844,23,Germany,G15,NA,NA,NA,NA
silence,91957,94970,3013,Germany,G15,NA,NA,NA,NA
mother_gesture,94970,96561,1591,Germany,G15,NA,NA,NA,NA
silence,96561,96592,31,Germany,G15,NA,NA,NA,NA
silence,100694,100940,246,Germany,G15,NA,NA,NA,NA
silence,102235,102629,394,Germany,G15,NA,NA,NA,NA
silence,104751,105095,344,Germany,G15,NA,NA,NA,NA
silence,106731,113594,6863,Germany,G15,NA,NA,NA,NA
silence,117014,120233,3219,Germany,G15,NA,NA,NA,NA
father_gesture,120233,121995,1762,Germany,G15,NA,NA,NA,NA
silence,121995,125077,3082,Germany,G15,NA,NA,NA,NA
silence,126213,126911,698,Germany,G15,NA,NA,NA,NA
silence,129676,129900,224,Germany,G15,NA,NA,NA,NA
silence,130957,131053,96,Germany,G15,NA,NA,NA,NA
silence,138507,138870,363,Germany,G15,NA,NA,NA,NA
silence,140245,141324,1079,Germany,G15,NA,NA,NA,NA
silence,143233,143504,271,Germany,G15,NA,NA,NA,NA
silence,144731,144846,115,Germany,G15,NA,NA,NA,NA
silence,145857,149203,3346,Germany,G15,NA,NA,NA,NA
child_gesture,149754,150527,773,Germany,G15,NA,NA,NA,NA
silence,151465,152313,848,Germany,G15,NA,NA,NA,NA
silence,153438,153444,6,Germany,G15,NA,NA,NA,NA
child_gesture,154328,155066,738,Germany,G15,NA,NA,NA,NA
silence,156569,157231,662,Germany,G15,NA,NA,NA,NA
silence,162186,162230,44,Germany,G15,NA,NA,NA,NA
silence,163139,163145,6,Germany,G15,NA,NA,NA,NA
silence,164202,164973,771,Germany,G15,NA,NA,NA,NA
silence,165757,167747,1990,Germany,G15,NA,NA,NA,NA
silence,170610,172361,1751,Germany,G15,NA,NA,NA,NA
silence,174225,175747,1522,Germany,G15,NA,NA,NA,NA
child_gesture,176551,178573,2022,Germany,G15,NA,NA,NA,NA
silence,178679,184072,5393,Germany,G15,NA,NA,NA,NA
child_gesture,184623,185748,1125,Germany,G15,NA,NA,NA,NA
silence,186947,189864,2917,Germany,G15,NA,NA,NA,NA
child_gesture,190179,191554,1375,Germany,G15,NA,NA,NA,NA
silence,192171,192650,479,Germany,G15,NA,NA,NA,NA
silence,195320,195825,505,Germany,G15,NA,NA,NA,NA
silence,202678,206653,3975,Germany,G15,NA,NA,NA,NA
silence,208846,210604,1758,Germany,G15,NA,NA,NA,NA
silence,211740,216129,4389,Germany,G15,NA,NA,NA,NA
silence,219129,222916,3787,Germany,G15,NA,NA,NA,NA
silence,224325,224605,280,Germany,G15,NA,NA,NA,NA
silence,225559,235729,10170,Germany,G15,NA,NA,NA,NA
silence,242866,243299,433,Germany,G15,NA,NA,NA,NA
father_gesture,243299,244389,1090,Germany,G15,NA,NA,NA,NA
silence,244409,244509,100,Germany,G15,NA,NA,NA,NA
silence,248066,248694,628,Germany,G15,NA,NA,NA,NA
mother_gesture,248904,249529,625,Germany,G15,NA,NA,NA,NA
silence,251126,256452,5326,Germany,G15,NA,NA,NA,NA
silence,259247,259295,48,Germany,G15,NA,NA,NA,NA
silence,262216,262248,32,Germany,G15,NA,NA,NA,NA
silence,262726,266790,4064,Germany,G15,NA,NA,NA,NA
silence,270801,272642,1841,Germany,G15,NA,NA,NA,NA
silence,273983,274728,745,Germany,G15,NA,NA,NA,NA
silence,275478,276290,812,Germany,G15,NA,NA,NA,NA
silence,277631,279201,1570,Germany,G15,NA,NA,NA,NA
silence,282610,283249,639,Germany,G15,NA,NA,NA,NA
silence,283726,284502,776,Germany,G15,NA,NA,NA,NA
silence,286127,286763,636,Germany,G15,NA,NA,NA,NA
silence,287934,288727,793,Germany,G15,NA,NA,NA,NA
silence,289681,289730,49,Germany,G15,NA,NA,NA,NA
silence,290674,291891,1217,Germany,G15,NA,NA,NA,NA
silence,294448,296257,1809,Germany,G15,NA,NA,NA,NA
silence,297586,297668,82,Germany,G15,NA,NA,NA,NA
silence,300747,304182,3435,Germany,G15,NA,NA,NA,NA
silence,305034,307602,2568,Germany,G15,NA,NA,NA,NA
silence,315928,318968,3040,Germany,G15,NA,NA,NA,NA
silence,325795,327102,1307,Germany,G15,NA,NA,NA,NA
silence,334932,336121,1189,Germany,G15,NA,NA,NA,NA
silence,337110,338580,1470,Germany,G15,NA,NA,NA,NA
silence,339285,340369,1084,Germany,G15,NA,NA,NA,NA
silence,345733,348243,2510,Germany,G15,NA,NA,NA,NA
mother_gesture,357925,359413,1488,Germany,G15,NA,NA,NA,NA
silence,359492,359551,59,Germany,G15,NA,NA,NA,NA
silence,360131,360213,82,Germany,G15,NA,NA,NA,NA
mother_gesture,360640,361299,659,Germany,G15,NA,NA,NA,NA
silence,369752,372448,2696,Germany,G15,NA,NA,NA,NA
silence,373402,373545,143,Germany,G15,NA,NA,NA,NA
silence,374159,374179,20,Germany,G15,NA,NA,NA,NA
silence,377542,377580,38,Germany,G15,NA,NA,NA,NA
silence,384766,389936,5170,Germany,G15,NA,NA,NA,NA
silence,390345,392845,2500,Germany,G15,NA,NA,NA,NA
silence,393607,394696,1089,Germany,G15,NA,NA,NA,NA
silence,400798,402718,1920,Germany,G15,NA,NA,NA,NA
silence,403775,403828,53,Germany,G15,NA,NA,NA,NA
silence,404237,404494,257,Germany,G15,NA,NA,NA,NA
silence,408244,410777,2533,Germany,G15,NA,NA,NA,NA
silence,421876,421967,91,Germany,G15,NA,NA,NA,NA
mother_gesture,422777,423777,1000,Germany,G15,NA,NA,NA,NA
silence,424683,430136,5453,Germany,G15,NA,NA,NA,NA
silence,431580,434155,2575,Germany,G15,NA,NA,NA,NA
silence,435036,435167,131,Germany,G15,NA,NA,NA,NA
silence,438982,453896,14914,Germany,G15,NA,NA,NA,NA
silence,454840,456124,1284,Germany,G15,NA,NA,NA,NA
silence,456362,459407,3045,Germany,G15,NA,NA,NA,NA
silence,462055,465407,3352,Germany,G15,NA,NA,NA,NA
silence,465998,466953,955,Germany,G15,NA,NA,NA,NA
silence,467419,471620,4201,Germany,G15,NA,NA,NA,NA
silence,474023,474617,594,Germany,G15,NA,NA,NA,NA
silence,475321,478685,3364,Germany,G15,NA,NA,NA,NA
silence,480162,481172,1010,Germany,G15,NA,NA,NA,NA
silence,481627,482093,466,Germany,G15,NA,NA,NA,NA
silence,482638,484183,1545,Germany,G15,NA,NA,NA,NA
silence,487556,491222,3666,Germany,G15,NA,NA,NA,NA
silence,493188,506154,12966,Germany,G15,NA,NA,NA,NA
silence,506802,508037,1235,Germany,G15,NA,NA,NA,NA
silence,509946,509986,40,Germany,G15,NA,NA,NA,NA
silence,515300,515363,63,Germany,G15,NA,NA,NA,NA
silence,516408,517213,805,Germany,G15,NA,NA,NA,NA
silence,524608,524775,167,Germany,G15,NA,NA,NA,NA
silence,526581,528863,2282,Germany,G15,NA,NA,NA,NA
silence,529609,533034,3425,Germany,G15,NA,NA,NA,NA
silence,534386,535758,1372,Germany,G15,NA,NA,NA,NA
silence,536224,541488,5264,Germany,G15,NA,NA,NA,NA
silence,543026,544062,1036,Germany,G15,NA,NA,NA,NA
silence,544659,548361,3702,Germany,G15,NA,NA,NA,NA
silence,556567,556626,59,Germany,G15,NA,NA,NA,NA
silence,571029,571888,859,Germany,G15,NA,NA,NA,NA
silence,573433,573973,540,Germany,G15,NA,NA,NA,NA
silence,575018,577456,2438,Germany,G15,NA,NA,NA,NA
silence,578741,580194,1453,Germany,G15,NA,NA,NA,NA
silence,580694,580970,276,Germany,G15,NA,NA,NA,NA
silence,583598,583606,8,Germany,G15,NA,NA,NA,NA
silence,584144,584208,64,Germany,G15,NA,NA,NA,NA
mother,1740,2480,740,Germany,G16,b,1,1,a
child,1800,2300,500,Germany,G16,b,2,1,a
father,2440,3060,620,Germany,G16,m,3,1,a
mother,5460,9860,4400,Germany,G16,c,4,1,q
child,8780,9300,520,Germany,G16,m,4,2,a
mother,11970,15130,3160,Germany,G16,c,4,3,a
father,15540,16750,1210,Germany,G16,c,4,4,a
mother,15740,16780,1040,Germany,G16,c,4,5,q
child,20710,21790,1080,Germany,G16,m,4,6,a
mother,27740,29760,2020,Germany,G16,f,5,1,q
father,30580,32260,1680,Germany,G16,m,5,2,a
mother,32190,34030,1840,Germany,G16,f,5,3,q
father,34130,36380,2250,Germany,G16,m,5,4,a
mother,35030,38650,3620,Germany,G16,c,6,1,q
father,39150,39760,610,Germany,G16,b,6,2,a
child,39240,39750,510,Germany,G16,b,6,3,a
mother,39720,50830,11110,Germany,G16,c,6,4,q
child,51560,53240,1680,Germany,G16,m,6,5,a
mother,53290,54300,1010,Germany,G16,b,6,6,i
child,57370,58300,930,Germany,G16,b,6,7,a
mother,58940,60500,1560,Germany,G16,b,6,8,i
child,61000,64550,3550,Germany,G16,b,6,9,a
mother,65070,66000,930,Germany,G16,b,7,1,a
child,66030,68510,2480,Germany,G16,m,8,1,a
mother,68150,69960,1810,Germany,G16,c,8,2,a
child,70060,71090,1030,Germany,G16,f,9,1,a
mother,77440,81190,3750,Germany,G16,b,10,1,a
child,82710,83260,550,Germany,G16,f,11,1,a
mother,87210,89520,2310,Germany,G16,c,12,1,i
father,90130,90870,740,Germany,G16,c,12,2,q
mother,92640,93310,670,Germany,G16,c,12,3,q
child,94340,95320,980,Germany,G16,b,12,4,a
mother,95410,104700,9290,Germany,G16,c,12,5,a
child,104750,105620,870,Germany,G16,m,12,6,a
mother,106330,112800,6470,Germany,G16,c,12,7,q
child,111340,112060,720,Germany,G16,m,12,8,q
child,113080,114590,1510,Germany,G16,m,12,9,a
mother,114850,118980,4130,Germany,G16,c,12,10,a
child,122210,122930,720,Germany,G16,m,12,11,a
mother,123930,124800,870,Germany,G16,b,13,1,a
mother,126660,127720,1060,Germany,G16,c,14,1,q
child,127700,128480,780,Germany,G16,m,14,2,a
mother,128470,128910,440,Germany,G16,c,14,3,q
mother,132920,135470,2550,Germany,G16,c,15,1,a
child,135350,136270,920,Germany,G16,m,15,2,a
father,137860,138550,690,Germany,G16,c,16,1,a
mother,142580,144930,2350,Germany,G16,c,17,1,a
mother,149040,150110,1070,Germany,G16,f,18,1,q
father,152090,153630,1540,Germany,G16,m,18,2,a
mother,152280,153140,860,Germany,G16,f,18,3,q
mother,156250,159650,3400,Germany,G16,f,18,4,q
father,160160,160940,780,Germany,G16,m,18,5,a
father,164510,167090,2580,Germany,G16,m,18,6,a
father,171070,173170,2100,Germany,G16,m,18,7,a
father,177300,179240,1940,Germany,G16,m,18,8,a
mother,178230,179880,1650,Germany,G16,c,19,1,a
mother,185800,188710,2910,Germany,G16,c,20,1,q
father,190120,191720,1600,Germany,G16,m,21,1,a
mother,194100,195720,1620,Germany,G16,f,22,1,q
father,196210,197030,820,Germany,G16,b,22,2,a
mother,197170,197960,790,Germany,G16,f,22,3,q
father,197950,198600,650,Germany,G16,m,22,4,a
mother,198310,200020,1710,Germany,G16,f,22,5,q
father,199820,200610,790,Germany,G16,m,22,6,a
child,200940,203690,2750,Germany,G16,b,23,1,a
mother,203890,204630,740,Germany,G16,c,23,2,q
child,204580,206830,2250,Germany,G16,b,23,3,a
mother,206770,207740,970,Germany,G16,c,23,4,q
child,211260,212510,1250,Germany,G16,m,24,1,a
mother,213360,214020,660,Germany,G16,c,24,2,a
mother,218940,220070,1130,Germany,G16,c,24,3,i
child,229850,230680,830,Germany,G16,f,25,1,a
mother,231490,232310,820,Germany,G16,f,25,2,a
child,241810,246040,4230,Germany,G16,b,26,1,a
mother,246140,247040,900,Germany,G16,c,26,2,q
mother,256440,262520,6080,Germany,G16,c,27,1,i
child,258260,259270,1010,Germany,G16,m,27,2,a
child,261830,263683,1853,Germany,G16,m,27,3,a
mother,263430,267490,4060,Germany,G16,c,27,4,a
child,269030,271380,2350,Germany,G16,m,27,5,a
mother,271650,274010,2360,Germany,G16,c,27,6,a
child,274510,275700,1190,Germany,G16,m,27,7,a
mother,275750,276930,1180,Germany,G16,c,27,8,a
child,276960,279560,2600,Germany,G16,m,27,9,a
mother,277130,279920,2790,Germany,G16,c,27,10,q
child,280210,280930,720,Germany,G16,m,27,11,a
mother,280510,281510,1000,Germany,G16,c,27,12,a
father,284600,286120,1520,Germany,G16,c,27,13,a
child,286470,287240,770,Germany,G16,f,27,14,a
mother,286620,288710,2090,Germany,G16,c,27,15,a
child,289620,290610,990,Germany,G16,m,27,16,a
mother,290620,291960,1340,Germany,G16,c,27,17,q
child,292090,295160,3070,Germany,G16,m,27,18,a
mother,294660,295670,1010,Germany,G16,c,27,19,q
child,296550,297450,900,Germany,G16,m,27,20,a
mother,298140,299210,1070,Germany,G16,c,27,21,i
child,302720,304980,2260,Germany,G16,m,27,22,a
mother,305060,307310,2250,Germany,G16,c,27,23,q
child,308370,308930,560,Germany,G16,m,27,24,a
father,301540,302510,970,Germany,G16,m,28,1,a
father,313250,313770,520,Germany,G16,m,29,1,a
mother,313840,314640,800,Germany,G16,f,29,2,q
father,314670,315210,540,Germany,G16,m,29,3,a
mother,315210,316720,1510,Germany,G16,f,29,4,q
father,316470,317090,620,Germany,G16,m,29,5,a
mother,317840,318800,960,Germany,G16,f,29,6,a
child,323850,324710,860,Germany,G16,o,30,1,a
child,327200,354740,27540,Germany,G16,o,30,2,a
mother,328900,330940,2040,Germany,G16,c,31,1,q
mother,354430,355730,1300,Germany,G16,c,32,1,a
child,362410,362860,450,Germany,G16,o,33,1,a
child,364110,376660,12550,Germany,G16,o,33,2,a
child,377290,378600,1310,Germany,G16,b,34,1,a
mother,378910,385280,6370,Germany,G16,c,34,2,a
father,386570,387460,890,Germany,G16,c,35,1,q
child,388040,388840,800,Germany,G16,f,35,2,a
father,388910,389480,570,Germany,G16,c,35,3,q
mother,388850,390650,1800,Germany,G16,c,36,1,i
mother,402480,403200,720,Germany,G16,c,36,2,a
child,408150,409690,1540,Germany,G16,b,37,1,a
father,411470,412220,750,Germany,G16,c,37,2,q
mother,415420,416400,980,Germany,G16,c,37,3,q
father,416650,417130,480,Germany,G16,c,37,4,a
child,417580,425850,8270,Germany,G16,b,37,5,a
mother,425260,426860,1600,Germany,G16,c,37,6,a
child,427280,427880,600,Germany,G16,b,37,7,a
mother,427940,428610,670,Germany,G16,c,37,8,a
child,429690,430340,650,Germany,G16,b,37,9,a
mother,432070,432960,890,Germany,G16,c,37,10,q
child,434620,436020,1400,Germany,G16,m,37,11,a
father,437700,440280,2580,Germany,G16,c,37,12,a
child,438610,439330,720,Germany,G16,f,37,13,a
mother,439830,440890,1060,Germany,G16,c,37,14,a
father,443080,447200,4120,Germany,G16,b,37,15,a
father,452130,452750,620,Germany,G16,m,38,1,q
mother,452960,453610,650,Germany,G16,f,38,2,a
mother,457170,458940,1770,Germany,G16,f,38,3,a
father,469980,470920,940,Germany,G16,m,39,1,q
mother,471040,471690,650,Germany,G16,f,39,2,q
father,471670,472550,880,Germany,G16,m,39,3,q
mother,472400,473300,900,Germany,G16,f,39,4,a
father,473230,473950,720,Germany,G16,m,39,5,a
mother,473690,474230,540,Germany,G16,f,39,6,a
father,475070,475990,920,Germany,G16,m,39,7,q
mother,475190,479240,4050,Germany,G16,f,39,8,a
father,479150,479760,610,Germany,G16,m,39,9,a
mother,480420,483460,3040,Germany,G16,f,39,10,a
child,483050,483780,730,Germany,G16,f,40,1,a
mother,487520,488210,690,Germany,G16,c,40,2,q
father,488550,489860,1310,Germany,G16,m,40,3,a
mother,489970,490890,920,Germany,G16,c,40,4,q
mother,492840,493640,800,Germany,G16,c,40,5,a
child,492950,495910,2960,Germany,G16,b,40,6,a
father,494140,496090,1950,Germany,G16,b,40,7,a
child,508840,509950,1110,Germany,G16,b,41,1,a
child,526020,527580,1560,Germany,G16,b,42,1,a
mother,528430,533640,5210,Germany,G16,c,42,2,a
mother,548830,552400,3570,Germany,G16,c,43,1,a
child,554210,554870,660,Germany,G16,m,43,2,a
mother,558040,558750,710,Germany,G16,b,43,3,a
mother,561540,562770,1230,Germany,G16,c,44,1,a
mother,570710,571230,520,Germany,G16,f,45,1,q
father,578580,580580,2000,Germany,G16,m,45,2,q
mother,580600,581290,690,Germany,G16,f,45,3,a
child,581010,581530,520,Germany,G16,m,46,1,a
mother,582360,583540,1180,Germany,G16,c,46,2,q
mother,585450,587840,2390,Germany,G16,c,46,3,q
child,585510,586230,720,Germany,G16,m,46,4,a
child,589690,591260,1570,Germany,G16,b,46,5,a
mother,591360,592200,840,Germany,G16,c,46,6,q
father,592210,594150,1940,Germany,G16,c,46,7,i
child,595000,595670,670,Germany,G16,f,46,8,a
mother,595890,596550,660,Germany,G16,c,46,9,a
silence,3060,5460,2400,Germany,G16,NA,NA,NA,NA
silence,9860,11970,2110,Germany,G16,NA,NA,NA,NA
silence,15130,15540,410,Germany,G16,NA,NA,NA,NA
silence,16780,20710,3930,Germany,G16,NA,NA,NA,NA
silence,21790,27740,5950,Germany,G16,NA,NA,NA,NA
silence,29760,30580,820,Germany,G16,NA,NA,NA,NA
silence,34030,34130,100,Germany,G16,NA,NA,NA,NA
silence,38650,39150,500,Germany,G16,NA,NA,NA,NA
silence,50830,51560,730,Germany,G16,NA,NA,NA,NA
silence,53240,53290,50,Germany,G16,NA,NA,NA,NA
silence,54300,57370,3070,Germany,G16,NA,NA,NA,NA
silence,58300,58940,640,Germany,G16,NA,NA,NA,NA
silence,60500,61000,500,Germany,G16,NA,NA,NA,NA
silence,64550,65070,520,Germany,G16,NA,NA,NA,NA
silence,66000,66030,30,Germany,G16,NA,NA,NA,NA
child_gesture,67136,68773,1637,Germany,G16,NA,NA,NA,NA
silence,69960,70060,100,Germany,G16,NA,NA,NA,NA
silence,71090,77440,6350,Germany,G16,NA,NA,NA,NA
silence,81190,82710,1520,Germany,G16,NA,NA,NA,NA
silence,83260,87210,3950,Germany,G16,NA,NA,NA,NA
silence,89520,90130,610,Germany,G16,NA,NA,NA,NA
silence,90870,92640,1770,Germany,G16,NA,NA,NA,NA
silence,93310,94340,1030,Germany,G16,NA,NA,NA,NA
silence,95320,95410,90,Germany,G16,NA,NA,NA,NA
silence,104700,104750,50,Germany,G16,NA,NA,NA,NA
silence,105620,106330,710,Germany,G16,NA,NA,NA,NA
silence,112800,113080,280,Germany,G16,NA,NA,NA,NA
silence,114590,114850,260,Germany,G16,NA,NA,NA,NA
silence,118980,122210,3230,Germany,G16,NA,NA,NA,NA
silence,122930,123930,1000,Germany,G16,NA,NA,NA,NA
silence,124800,126660,1860,Germany,G16,NA,NA,NA,NA
silence,128910,132920,4010,Germany,G16,NA,NA,NA,NA
silence,136270,137860,1590,Germany,G16,NA,NA,NA,NA
silence,138550,142580,4030,Germany,G16,NA,NA,NA,NA
mother_gesture,142707,144184,1477,Germany,G16,NA,NA,NA,NA
mother_gesture,144224,145140,916,Germany,G16,NA,NA,NA,NA
silence,144930,149040,4110,Germany,G16,NA,NA,NA,NA
silence,150110,152090,1980,Germany,G16,NA,NA,NA,NA
silence,153630,156250,2620,Germany,G16,NA,NA,NA,NA
silence,159650,160160,510,Germany,G16,NA,NA,NA,NA
silence,160940,164510,3570,Germany,G16,NA,NA,NA,NA
silence,167090,171070,3980,Germany,G16,NA,NA,NA,NA
father_gesture,167569,169634,2065,Germany,G16,NA,NA,NA,NA
mother_gesture,168253,170024,1771,Germany,G16,NA,NA,NA,NA
silence,173170,177300,4130,Germany,G16,NA,NA,NA,NA
silence,179880,185800,5920,Germany,G16,NA,NA,NA,NA
silence,188710,190120,1410,Germany,G16,NA,NA,NA,NA
silence,191720,194100,2380,Germany,G16,NA,NA,NA,NA
mother_gesture,194642,195728,1086,Germany,G16,NA,NA,NA,NA
silence,195720,196210,490,Germany,G16,NA,NA,NA,NA
silence,197030,197170,140,Germany,G16,NA,NA,NA,NA
silence,200610,200940,330,Germany,G16,NA,NA,NA,NA
silence,203690,203890,200,Germany,G16,NA,NA,NA,NA
silence,207740,211260,3520,Germany,G16,NA,NA,NA,NA
silence,212510,213360,850,Germany,G16,NA,NA,NA,NA
silence,214020,218940,4920,Germany,G16,NA,NA,NA,NA
silence,220070,229850,9780,Germany,G16,NA,NA,NA,NA
silence,230680,231490,810,Germany,G16,NA,NA,NA,NA
silence,232310,241810,9500,Germany,G16,NA,NA,NA,NA
silence,246040,246140,100,Germany,G16,NA,NA,NA,NA
silence,247040,256440,9400,Germany,G16,NA,NA,NA,NA
child_gesture,261850,263458,1608,Germany,G16,NA,NA,NA,NA
silence,267490,269030,1540,Germany,G16,NA,NA,NA,NA
silence,271380,271650,270,Germany,G16,NA,NA,NA,NA
silence,274010,274510,500,Germany,G16,NA,NA,NA,NA
silence,275700,275750,50,Germany,G16,NA,NA,NA,NA
silence,276930,276960,30,Germany,G16,NA,NA,NA,NA
silence,279920,280210,290,Germany,G16,NA,NA,NA,NA
silence,281510,284600,3090,Germany,G16,NA,NA,NA,NA
silence,286120,286470,350,Germany,G16,NA,NA,NA,NA
silence,288710,289620,910,Germany,G16,NA,NA,NA,NA
silence,290610,290620,10,Germany,G16,NA,NA,NA,NA
silence,291960,292090,130,Germany,G16,NA,NA,NA,NA
silence,295670,296550,880,Germany,G16,NA,NA,NA,NA
silence,297450,298140,690,Germany,G16,NA,NA,NA,NA
silence,299210,301540,2330,Germany,G16,NA,NA,NA,NA
silence,302510,302720,210,Germany,G16,NA,NA,NA,NA
silence,304980,305060,80,Germany,G16,NA,NA,NA,NA
silence,307310,308370,1060,Germany,G16,NA,NA,NA,NA
silence,308930,313250,4320,Germany,G16,NA,NA,NA,NA
silence,313770,313840,70,Germany,G16,NA,NA,NA,NA
silence,314640,314670,30,Germany,G16,NA,NA,NA,NA
silence,317090,317840,750,Germany,G16,NA,NA,NA,NA
silence,318800,323850,5050,Germany,G16,NA,NA,NA,NA
silence,324710,327200,2490,Germany,G16,NA,NA,NA,NA
silence,355730,362410,6680,Germany,G16,NA,NA,NA,NA
silence,362860,364110,1250,Germany,G16,NA,NA,NA,NA
silence,376660,377290,630,Germany,G16,NA,NA,NA,NA
silence,378600,378910,310,Germany,G16,NA,NA,NA,NA
mother_gesture,381884,383318,1434,Germany,G16,NA,NA,NA,NA
silence,385280,386570,1290,Germany,G16,NA,NA,NA,NA
silence,387460,388040,580,Germany,G16,NA,NA,NA,NA
silence,388840,388850,10,Germany,G16,NA,NA,NA,NA
silence,390650,402480,11830,Germany,G16,NA,NA,NA,NA
silence,403200,408150,4950,Germany,G16,NA,NA,NA,NA
silence,409690,411470,1780,Germany,G16,NA,NA,NA,NA
silence,412220,415420,3200,Germany,G16,NA,NA,NA,NA
silence,416400,416650,250,Germany,G16,NA,NA,NA,NA
silence,417130,417580,450,Germany,G16,NA,NA,NA,NA
child_gesture,423009,424720,1711,Germany,G16,NA,NA,NA,NA
silence,426860,427280,420,Germany,G16,NA,NA,NA,NA
silence,427880,427940,60,Germany,G16,NA,NA,NA,NA
silence,428610,429690,1080,Germany,G16,NA,NA,NA,NA
silence,430340,432070,1730,Germany,G16,NA,NA,NA,NA
silence,432960,434620,1660,Germany,G16,NA,NA,NA,NA
silence,436020,437700,1680,Germany,G16,NA,NA,NA,NA
silence,440890,443080,2190,Germany,G16,NA,NA,NA,NA
silence,447200,452130,4930,Germany,G16,NA,NA,NA,NA
silence,452750,452960,210,Germany,G16,NA,NA,NA,NA
silence,453610,457170,3560,Germany,G16,NA,NA,NA,NA
mother_gesture,457021,459002,1981,Germany,G16,NA,NA,NA,NA
silence,458940,469980,11040,Germany,G16,NA,NA,NA,NA
silence,470920,471040,120,Germany,G16,NA,NA,NA,NA
silence,474230,475070,840,Germany,G16,NA,NA,NA,NA
silence,479760,480420,660,Germany,G16,NA,NA,NA,NA
silence,483780,487520,3740,Germany,G16,NA,NA,NA,NA
silence,488210,488550,340,Germany,G16,NA,NA,NA,NA
silence,489860,489970,110,Germany,G16,NA,NA,NA,NA
silence,490890,492840,1950,Germany,G16,NA,NA,NA,NA
silence,496090,508840,12750,Germany,G16,NA,NA,NA,NA
silence,509950,526020,16070,Germany,G16,NA,NA,NA,NA
silence,527580,528430,850,Germany,G16,NA,NA,NA,NA
silence,533640,548830,15190,Germany,G16,NA,NA,NA,NA
silence,552400,554210,1810,Germany,G16,NA,NA,NA,NA
silence,554870,558040,3170,Germany,G16,NA,NA,NA,NA
silence,558750,561540,2790,Germany,G16,NA,NA,NA,NA
silence,562770,570710,7940,Germany,G16,NA,NA,NA,NA
silence,571230,578580,7350,Germany,G16,NA,NA,NA,NA
silence,580580,580600,20,Germany,G16,NA,NA,NA,NA
silence,581530,582360,830,Germany,G16,NA,NA,NA,NA
silence,583540,585450,1910,Germany,G16,NA,NA,NA,NA
silence,587840,589690,1850,Germany,G16,NA,NA,NA,NA
silence,591260,591360,100,Germany,G16,NA,NA,NA,NA
silence,592200,592210,10,Germany,G16,NA,NA,NA,NA
silence,594150,595000,850,Germany,G16,NA,NA,NA,NA
silence,595670,595890,220,Germany,G16,NA,NA,NA,NA
child,999,2601,1602,Germany,G17,f,1,1,q
mother,2518,2806,288,Germany,G17,c,1,2,a
father,2607,3242,635,Germany,G17,c,1,3,a
father,4704,5420,716,Germany,G17,c,1,4,a
mother,6747,8949,2202,Germany,G17,c,2,1,q
child,6848,9319,2471,Germany,G17,m,2,2,a
mother,9569,12094,2525,Germany,G17,c,2,3,q
child,13685,14257,572,Germany,G17,m,2,4,a
mother,14257,16598,2341,Germany,G17,c,2,5,q
child,16603,18348,1745,Germany,G17,b,2,6,a
child,20041,23408,3367,Germany,G17,b,2,7,q
mother,23517,24012,495,Germany,G17,c,2,8,a
mother,29541,30911,1370,Germany,G17,c,2,9,a
child,30714,31565,851,Germany,G17,m,2,10,q
child,35228,36300,1072,Germany,G17,f,2,11,q
father,36375,37863,1488,Germany,G17,c,2,12,a
mother,38714,39459,745,Germany,G17,c,2,13,a
child,41868,43339,1471,Germany,G17,f,2,14,q
father,43401,44021,620,Germany,G17,c,2,15,a
child,45853,47802,1949,Germany,G17,m,3,1,q
mother,48175,48723,548,Germany,G17,c,3,2,q
child,48767,49694,927,Germany,G17,m,3,3,q
mother,50026,53747,3721,Germany,G17,c,3,4,a
child,64358,67449,3091,Germany,G17,b,4,1,a
mother,69262,69978,716,Germany,G17,c,4,2,q
child,70483,71795,1312,Germany,G17,m,4,3,a
child,73074,75719,2645,Germany,G17,m,5,1,q
mother,76094,81743,5649,Germany,G17,c,5,2,a
child,83305,84247,942,Germany,G17,m,5,3,a
mother,87132,88464,1332,Germany,G17,f,6,1,q
father,88555,89041,486,Germany,G17,m,6,2,a
mother,89007,89344,337,Germany,G17,f,6,3,a
child,91339,93550,2211,Germany,G17,m,7,1,i
mother,94425,95161,736,Germany,G17,c,7,2,q
child,95959,96598,639,Germany,G17,m,7,3,a
father,97444,100334,2890,Germany,G17,c,7,4,a
mother,98983,99892,909,Germany,G17,c,7,5,a
child,100430,101618,1188,Germany,G17,f,7,6,q
father,101680,103363,1683,Germany,G17,c,7,7,a
child,103872,106834,2962,Germany,G17,f,7,8,q
father,107512,108940,1428,Germany,G17,c,7,9,a
mother,109579,117031,7452,Germany,G17,c,7,10,a
child,117959,122983,5024,Germany,G17,f,7,11,q
father,123247,124271,1024,Germany,G17,c,7,12,a
child,125060,128815,3755,Germany,G17,b,7,13,a
father,128863,132642,3779,Germany,G17,c,7,14,a
mother,129855,131154,1299,Germany,G17,c,7,15,a
child,135776,137247,1471,Germany,G17,f,7,16,a
father,137214,138334,1120,Germany,G17,c,7,17,a
child,138411,140411,2000,Germany,G17,f,7,18,a
father,140339,141762,1423,Germany,G17,c,7,19,a
child,142820,144954,2134,Germany,G17,f,7,20,a
mother,145055,146031,976,Germany,G17,c,7,21,a
father,146045,147440,1395,Germany,G17,c,7,22,a
child,149469,150531,1062,Germany,G17,f,7,23,a
father,150805,151281,476,Germany,G17,m,7,24,q
child,154622,161853,7231,Germany,G17,b,7,25,a
father,161959,164521,2562,Germany,G17,c,7,26,a
child,165478,169771,4293,Germany,G17,f,7,27,a
father,170194,170598,404,Germany,G17,c,7,28,a
mother,173243,174103,860,Germany,G17,f,7,29,q
father,177565,179334,1769,Germany,G17,c,8,1,q
child,180368,180815,447,Germany,G17,f,8,2,a
father,180819,181579,760,Germany,G17,c,8,3,q
child,181589,183017,1428,Germany,G17,f,8,4,a
father,182892,184483,1591,Germany,G17,c,8,5,q
mother,183868,184988,1120,Germany,G17,c,8,6,a
father,186363,187377,1014,Germany,G17,c,8,7,a
child,188161,189935,1774,Germany,G17,f,8,8,a
father,189844,190483,639,Germany,G17,c,8,9,a
mother,190103,191550,1447,Germany,G17,c,8,10,q
father,193569,194574,1005,Germany,G17,b,8,11,a
mother,194661,195420,759,Germany,G17,f,8,12,a
father,195420,197363,1943,Germany,G17,c,8,13,a
child,197969,198685,716,Germany,G17,m,8,14,q
mother,198214,201295,3081,Germany,G17,c,8,15,a
child,216819,218127,1308,Germany,G17,m,9,1,a
mother,218622,221440,2818,Germany,G17,c,9,2,q
mother,224137,229651,5514,Germany,G17,c,9,3,q
child,230358,231267,909,Germany,G17,m,9,4,a
mother,231517,234295,2778,Germany,G17,c,9,5,i
mother,238920,239810,890,Germany,G17,c,10,1,q
mother,249805,250786,981,Germany,G17,c,10,2,q
mother,273319,275944,2625,Germany,G17,c,10,3,a
child,276324,277348,1024,Germany,G17,m,10,4,a
mother,278488,280517,2029,Germany,G17,c,10,5,a
child,280781,281719,938,Germany,G17,m,10,6,a
father,281488,283271,1783,Germany,G17,c,10,7,q
child,284156,285425,1269,Germany,G17,f,10,8,a
father,285449,290151,4702,Germany,G17,c,10,9,q
child,289146,289589,443,Germany,G17,f,10,10,a
mother,290209,290901,692,Germany,G17,c,10,11,a
father,291286,292050,764,Germany,G17,c,10,12,q
mother,294608,299920,5312,Germany,G17,f,10,13,a
mother,302545,304271,1726,Germany,G17,c,10,14,a
child,313387,313983,596,Germany,G17,b,11,1,a
mother,314401,315271,870,Germany,G17,c,11,2,q
child,315473,315959,486,Germany,G17,m,11,3,a
father,315868,317214,1346,Germany,G17,c,11,4,a
mother,316247,317454,1207,Germany,G17,c,11,5,a
mother,318627,319372,745,Germany,G17,c,11,6,a
mother,323545,324113,568,Germany,G17,c,11,7,i
child,324041,324425,384,Germany,G17,m,11,8,a
child,328151,330166,2015,Germany,G17,b,11,9,a
father,330310,331473,1163,Germany,G17,c,11,10,a
mother,331646,333944,2298,Germany,G17,c,11,11,a
mother,326267,327661,1394,Germany,G17,c,12,1,a
child,337599,338300,701,Germany,G17,m,14,1,a
father,337743,338786,1043,Germany,G17,m,14,2,a
father,340541,341295,754,Germany,G17,m,14,3,a
mother,343618,344598,980,Germany,G17,f,14,4,a
father,346469,347175,706,Germany,G17,m,14,5,q
child,342728,348545,5817,Germany,G17,b,15,1,a
mother,355868,357824,1956,Germany,G17,c,16,1,q
child,358863,361094,2231,Germany,G17,b,17,1,a
mother,361363,362142,779,Germany,G17,c,17,2,a
child,362738,365156,2418,Germany,G17,m,17,3,a
mother,365728,368161,2433,Germany,G17,c,17,4,a
mother,368949,369613,664,Germany,G17,c,17,5,a
child,368166,370387,2221,Germany,G17,m,18,1,a
mother,370358,370834,476,Germany,G17,c,18,2,q
child,370906,373180,2274,Germany,G17,m,18,3,a
mother,373209,373776,567,Germany,G17,c,18,4,q
child,375329,377358,2029,Germany,G17,m,18,5,a
child,379372,399382,20010,Germany,G17,b,19,1,a
mother,396315,399079,2764,Germany,G17,c,19,2,a
child,401273,401974,701,Germany,G17,b,19,3,a
father,402084,403286,1202,Germany,G17,c,20,1,q
child,403618,405488,1870,Germany,G17,f,20,2,a
father,405521,406858,1337,Germany,G17,c,20,3,q
child,406844,407416,572,Germany,G17,f,20,4,a
father,407478,409906,2428,Germany,G17,c,20,5,a
mother,411560,413175,1615,Germany,G17,c,20,6,a
father,413882,416704,2822,Germany,G17,c,20,7,a
child,418670,419478,808,Germany,G17,b,20,8,a
father,420045,422445,2400,Germany,G17,c,20,9,a
mother,424464,426257,1793,Germany,G17,c,20,10,a
father,426247,433074,6827,Germany,G17,c,20,11,a
child,432598,434348,1750,Germany,G17,b,20,12,a
father,434348,435411,1063,Germany,G17,c,20,13,a
mother,438401,440084,1683,Germany,G17,c,20,14,q
child,440132,441050,918,Germany,G17,m,20,15,a
mother,441002,441627,625,Germany,G17,c,20,16,q
child,443757,444776,1019,Germany,G17,m,20,17,a
mother,444670,445377,707,Germany,G17,c,20,18,q
child,445632,445949,317,Germany,G17,m,20,19,a
mother,446113,446969,856,Germany,G17,c,20,20,q
child,453406,454545,1139,Germany,G17,m,20,21,a
mother,454916,456497,1581,Germany,G17,c,20,22,q
child,459002,460151,1149,Germany,G17,m,20,23,a
mother,461012,461603,591,Germany,G17,c,20,24,q
child,461892,462536,644,Germany,G17,m,20,25,a
mother,463632,464521,889,Germany,G17,c,20,26,q
child,464728,465079,351,Germany,G17,m,20,27,a
mother,465156,467012,1856,Germany,G17,c,20,28,a
mother,469853,472074,2221,Germany,G17,c,20,29,q
father,478156,479964,1808,Germany,G17,b,20,30,a
father,484416,485762,1346,Germany,G17,c,20,31,a
father,488704,490651,1947,Germany,G17,c,20,32,a
child,483032,484526,1494,Germany,G17,b,21,1,a
mother,491430,493199,1769,Germany,G17,f,22,1,a
father,492670,493973,1303,Germany,G17,m,22,2,a
child,504012,506608,2596,Germany,G17,b,23,1,a
mother,506521,509199,2678,Germany,G17,c,23,2,q
child,509142,509545,403,Germany,G17,m,23,3,a
mother,509478,521300,11822,Germany,G17,c,23,4,a
father,523598,525973,2375,Germany,G17,c,23,5,a
mother,526161,528906,2745,Germany,G17,b,23,6,a
father,529425,530483,1058,Germany,G17,c,23,7,a
mother,531223,532512,1289,Germany,G17,c,23,8,a
father,532545,533868,1323,Germany,G17,c,23,9,a
child,534170,536132,1962,Germany,G17,b,23,10,a
child,542973,544041,1068,Germany,G17,b,23,11,a
mother,544608,545420,812,Germany,G17,c,23,12,a
child,551054,552978,1924,Germany,G17,b,23,13,a
mother,553723,554430,707,Germany,G17,c,23,14,a
father,554882,556344,1462,Germany,G17,b,23,15,a
mother,557021,557887,866,Germany,G17,f,23,16,a
child,558449,559444,995,Germany,G17,b,23,17,a
mother,559334,561170,1836,Germany,G17,f,23,18,a
father,536651,543555,6904,Germany,G17,m,24,1,a
father,560786,562781,1995,Germany,G17,c,24,2,q
mother,563103,563594,491,Germany,G17,f,24,3,a
father,563574,564324,750,Germany,G17,m,24,4,q
mother,564372,564656,284,Germany,G17,f,24,5,a
child,565127,569113,3986,Germany,G17,f,24,6,a
father,566560,567065,505,Germany,G17,c,24,7,a
mother,568954,572714,3760,Germany,G17,c,24,8,a
child,573704,574502,798,Germany,G17,m,24,9,a
mother,574709,576094,1385,Germany,G17,c,25,1,a
child,577622,580834,3212,Germany,G17,b,25,2,a
mother,580839,582329,1490,Germany,G17,c,25,3,a
child,585194,587531,2337,Germany,G17,m,25,4,a
mother,591281,599493,8212,Germany,G17,b,25,5,a
mother,149464,150194,730,Germany,G17,c,30,1,q
mother,152156,152752,596,Germany,G17,c,30,2,q
silence,3242,4704,1462,Germany,G17,NA,NA,NA,NA
silence,5420,6747,1327,Germany,G17,NA,NA,NA,NA
silence,9319,9569,250,Germany,G17,NA,NA,NA,NA
silence,12094,13685,1591,Germany,G17,NA,NA,NA,NA
mother_gesture,15075,15452,377,Germany,G17,NA,NA,NA,NA
silence,16598,16603,5,Germany,G17,NA,NA,NA,NA
silence,18348,20041,1693,Germany,G17,NA,NA,NA,NA
silence,23408,23517,109,Germany,G17,NA,NA,NA,NA
silence,24012,29541,5529,Germany,G17,NA,NA,NA,NA
silence,31565,35228,3663,Germany,G17,NA,NA,NA,NA
silence,36300,36375,75,Germany,G17,NA,NA,NA,NA
silence,37863,38714,851,Germany,G17,NA,NA,NA,NA
silence,39459,41868,2409,Germany,G17,NA,NA,NA,NA
silence,43339,43401,62,Germany,G17,NA,NA,NA,NA
silence,44021,45853,1832,Germany,G17,NA,NA,NA,NA
silence,47802,48175,373,Germany,G17,NA,NA,NA,NA
silence,48723,48767,44,Germany,G17,NA,NA,NA,NA
silence,49694,50026,332,Germany,G17,NA,NA,NA,NA
mother_gesture,50980,51391,411,Germany,G17,NA,NA,NA,NA
silence,53747,64358,10611,Germany,G17,NA,NA,NA,NA
silence,67449,69262,1813,Germany,G17,NA,NA,NA,NA
silence,69978,70483,505,Germany,G17,NA,NA,NA,NA
silence,71795,73074,1279,Germany,G17,NA,NA,NA,NA
silence,75719,76094,375,Germany,G17,NA,NA,NA,NA
silence,81743,83305,1562,Germany,G17,NA,NA,NA,NA
silence,84247,87132,2885,Germany,G17,NA,NA,NA,NA
mother_gesture,87185,87903,718,Germany,G17,NA,NA,NA,NA
silence,88464,88555,91,Germany,G17,NA,NA,NA,NA
silence,89344,91339,1995,Germany,G17,NA,NA,NA,NA
silence,93550,94425,875,Germany,G17,NA,NA,NA,NA
silence,95161,95959,798,Germany,G17,NA,NA,NA,NA
silence,96598,97444,846,Germany,G17,NA,NA,NA,NA
silence,100334,100430,96,Germany,G17,NA,NA,NA,NA
silence,101618,101680,62,Germany,G17,NA,NA,NA,NA
silence,103363,103872,509,Germany,G17,NA,NA,NA,NA
silence,106834,107512,678,Germany,G17,NA,NA,NA,NA
silence,108940,109579,639,Germany,G17,NA,NA,NA,NA
mother_gesture,115609,116142,533,Germany,G17,NA,NA,NA,NA
silence,117031,117959,928,Germany,G17,NA,NA,NA,NA
silence,122983,123247,264,Germany,G17,NA,NA,NA,NA
silence,124271,125060,789,Germany,G17,NA,NA,NA,NA
silence,128815,128863,48,Germany,G17,NA,NA,NA,NA
father_gesture,129020,130092,1072,Germany,G17,NA,NA,NA,NA
mother_gesture,129810,130411,601,Germany,G17,NA,NA,NA,NA
silence,132642,135776,3134,Germany,G17,NA,NA,NA,NA
silence,138334,138411,77,Germany,G17,NA,NA,NA,NA
silence,141762,142820,1058,Germany,G17,NA,NA,NA,NA
silence,144954,145055,101,Germany,G17,NA,NA,NA,NA
silence,146031,146045,14,Germany,G17,NA,NA,NA,NA
silence,147440,149464,2024,Germany,G17,NA,NA,NA,NA
silence,150531,150805,274,Germany,G17,NA,NA,NA,NA
silence,151281,152156,875,Germany,G17,NA,NA,NA,NA
silence,152752,154622,1870,Germany,G17,NA,NA,NA,NA
silence,161853,161959,106,Germany,G17,NA,NA,NA,NA
father_gesture,162541,162844,303,Germany,G17,NA,NA,NA,NA
silence,164521,165478,957,Germany,G17,NA,NA,NA,NA
silence,169771,170194,423,Germany,G17,NA,NA,NA,NA
silence,170598,173243,2645,Germany,G17,NA,NA,NA,NA
silence,174103,177565,3462,Germany,G17,NA,NA,NA,NA
silence,179334,180368,1034,Germany,G17,NA,NA,NA,NA
silence,180815,180819,4,Germany,G17,NA,NA,NA,NA
silence,181579,181589,10,Germany,G17,NA,NA,NA,NA
silence,184988,186363,1375,Germany,G17,NA,NA,NA,NA
silence,187377,188161,784,Germany,G17,NA,NA,NA,NA
silence,191550,193569,2019,Germany,G17,NA,NA,NA,NA
silence,194574,194661,87,Germany,G17,NA,NA,NA,NA
silence,197363,197969,606,Germany,G17,NA,NA,NA,NA
silence,201295,216819,15524,Germany,G17,NA,NA,NA,NA
silence,218127,218622,495,Germany,G17,NA,NA,NA,NA
silence,221440,224137,2697,Germany,G17,NA,NA,NA,NA
mother_gesture,225586,226069,483,Germany,G17,NA,NA,NA,NA
mother_gesture,228829,229541,712,Germany,G17,NA,NA,NA,NA
silence,229651,230358,707,Germany,G17,NA,NA,NA,NA
silence,231267,231517,250,Germany,G17,NA,NA,NA,NA
mother_gesture,233284,233639,355,Germany,G17,NA,NA,NA,NA
silence,234295,238920,4625,Germany,G17,NA,NA,NA,NA
silence,239810,249805,9995,Germany,G17,NA,NA,NA,NA
silence,250786,273319,22533,Germany,G17,NA,NA,NA,NA
silence,275944,276324,380,Germany,G17,NA,NA,NA,NA
silence,277348,278488,1140,Germany,G17,NA,NA,NA,NA
silence,280517,280781,264,Germany,G17,NA,NA,NA,NA
silence,283271,284156,885,Germany,G17,NA,NA,NA,NA
silence,285425,285449,24,Germany,G17,NA,NA,NA,NA
silence,290151,290209,58,Germany,G17,NA,NA,NA,NA
silence,290901,291286,385,Germany,G17,NA,NA,NA,NA
silence,292050,294608,2558,Germany,G17,NA,NA,NA,NA
silence,299920,302545,2625,Germany,G17,NA,NA,NA,NA
silence,304271,313387,9116,Germany,G17,NA,NA,NA,NA
silence,313983,314401,418,Germany,G17,NA,NA,NA,NA
silence,315271,315473,202,Germany,G17,NA,NA,NA,NA
silence,317454,318627,1173,Germany,G17,NA,NA,NA,NA
silence,319372,323545,4173,Germany,G17,NA,NA,NA,NA
silence,324425,326267,1842,Germany,G17,NA,NA,NA,NA
silence,327661,328151,490,Germany,G17,NA,NA,NA,NA
silence,330166,330310,144,Germany,G17,NA,NA,NA,NA
silence,331473,331646,173,Germany,G17,NA,NA,NA,NA
silence,333944,337599,3655,Germany,G17,NA,NA,NA,NA
silence,338786,340541,1755,Germany,G17,NA,NA,NA,NA
silence,341295,342728,1433,Germany,G17,NA,NA,NA,NA
silence,348545,355868,7323,Germany,G17,NA,NA,NA,NA
silence,357824,358863,1039,Germany,G17,NA,NA,NA,NA
silence,361094,361363,269,Germany,G17,NA,NA,NA,NA
silence,362142,362738,596,Germany,G17,NA,NA,NA,NA
silence,365156,365728,572,Germany,G17,NA,NA,NA,NA
silence,368161,368166,5,Germany,G17,NA,NA,NA,NA
silence,370834,370906,72,Germany,G17,NA,NA,NA,NA
silence,373180,373209,29,Germany,G17,NA,NA,NA,NA
silence,373776,375329,1553,Germany,G17,NA,NA,NA,NA
silence,377358,379372,2014,Germany,G17,NA,NA,NA,NA
silence,399382,401273,1891,Germany,G17,NA,NA,NA,NA
silence,401974,402084,110,Germany,G17,NA,NA,NA,NA
silence,403286,403618,332,Germany,G17,NA,NA,NA,NA
silence,405488,405521,33,Germany,G17,NA,NA,NA,NA
silence,407416,407478,62,Germany,G17,NA,NA,NA,NA
silence,409906,411560,1654,Germany,G17,NA,NA,NA,NA
silence,413175,413882,707,Germany,G17,NA,NA,NA,NA
silence,416704,418670,1966,Germany,G17,NA,NA,NA,NA
silence,419478,420045,567,Germany,G17,NA,NA,NA,NA
silence,422445,424464,2019,Germany,G17,NA,NA,NA,NA
silence,435411,438401,2990,Germany,G17,NA,NA,NA,NA
silence,440084,440132,48,Germany,G17,NA,NA,NA,NA
silence,441627,443757,2130,Germany,G17,NA,NA,NA,NA
silence,445377,445632,255,Germany,G17,NA,NA,NA,NA
silence,445949,446113,164,Germany,G17,NA,NA,NA,NA
silence,446969,453406,6437,Germany,G17,NA,NA,NA,NA
silence,454545,454916,371,Germany,G17,NA,NA,NA,NA
silence,456497,459002,2505,Germany,G17,NA,NA,NA,NA
silence,460151,461012,861,Germany,G17,NA,NA,NA,NA
silence,461603,461892,289,Germany,G17,NA,NA,NA,NA
silence,462536,463632,1096,Germany,G17,NA,NA,NA,NA
silence,464521,464728,207,Germany,G17,NA,NA,NA,NA
silence,465079,465156,77,Germany,G17,NA,NA,NA,NA
silence,467012,469853,2841,Germany,G17,NA,NA,NA,NA
silence,472074,478156,6082,Germany,G17,NA,NA,NA,NA
silence,479964,483032,3068,Germany,G17,NA,NA,NA,NA
silence,485762,488704,2942,Germany,G17,NA,NA,NA,NA
silence,490651,491430,779,Germany,G17,NA,NA,NA,NA
silence,493973,504012,10039,Germany,G17,NA,NA,NA,NA
silence,521300,523598,2298,Germany,G17,NA,NA,NA,NA
silence,525973,526161,188,Germany,G17,NA,NA,NA,NA
silence,528906,529425,519,Germany,G17,NA,NA,NA,NA
silence,530483,531223,740,Germany,G17,NA,NA,NA,NA
silence,532512,532545,33,Germany,G17,NA,NA,NA,NA
silence,533868,534170,302,Germany,G17,NA,NA,NA,NA
silence,536132,536651,519,Germany,G17,NA,NA,NA,NA
silence,544041,544608,567,Germany,G17,NA,NA,NA,NA
silence,545420,551054,5634,Germany,G17,NA,NA,NA,NA
silence,552978,553723,745,Germany,G17,NA,NA,NA,NA
silence,554430,554882,452,Germany,G17,NA,NA,NA,NA
silence,556344,557021,677,Germany,G17,NA,NA,NA,NA
silence,557887,558449,562,Germany,G17,NA,NA,NA,NA
silence,562781,563103,322,Germany,G17,NA,NA,NA,NA
silence,564324,564372,48,Germany,G17,NA,NA,NA,NA
silence,564656,565127,471,Germany,G17,NA,NA,NA,NA
silence,572714,573704,990,Germany,G17,NA,NA,NA,NA
silence,574502,574709,207,Germany,G17,NA,NA,NA,NA
silence,576094,577622,1528,Germany,G17,NA,NA,NA,NA
silence,580834,580839,5,Germany,G17,NA,NA,NA,NA
silence,582329,585194,2865,Germany,G17,NA,NA,NA,NA
silence,587531,591281,3750,Germany,G17,NA,NA,NA,NA
mother,405,1111,706,Germany,G18,f,1,1,a
mother,3052,4155,1103,Germany,G18,c,2,1,a
father,5692,6935,1243,Germany,G18,b,2,2,a
father,7824,10655,2831,Germany,G18,c,2,3,q
child,11383,12832,1449,Germany,G18,f,3,1,a
father,13317,14339,1022,Germany,G18,c,3,2,a
mother,14001,15721,1720,Germany,G18,c,3,3,a
mother,18317,19574,1257,Germany,G18,f,4,1,q
child,26221,27214,993,Germany,G18,m,5,1,a
child,32398,32942,544,Germany,G18,b,6,1,a
mother,32413,34001,1588,Germany,G18,f,7,1,q
father,34530,35839,1309,Germany,G18,m,7,2,a
mother,36471,37560,1089,Germany,G18,f,7,3,a
father,42964,43788,824,Germany,G18,m,7,4,a
mother,42964,43994,1030,Germany,G18,f,8,1,q
father,44552,45177,625,Germany,G18,m,8,2,a
father,58119,63295,5176,Germany,G18,m,8,3,a
mother,63310,65302,1992,Germany,G18,f,8,4,a
father,65089,65736,647,Germany,G18,m,8,5,a
mother,67876,70339,2463,Germany,G18,c,8,6,a
father,70288,78971,8683,Germany,G18,m,8,7,a
mother,78898,79494,596,Germany,G18,f,8,8,q
father,80324,84942,4618,Germany,G18,m,8,9,a
mother,84111,85508,1397,Germany,G18,f,8,10,a
mother,87273,89163,1890,Germany,G18,f,8,11,a
father,87927,89699,1772,Germany,G18,m,8,12,a
mother,89714,92619,2905,Germany,G18,f,8,13,q
father,93729,94435,706,Germany,G18,m,8,14,a
mother,94346,94883,537,Germany,G18,f,8,15,q
mother,95310,96111,801,Germany,G18,c,8,16,a
child,103655,104721,1066,Germany,G18,m,9,1,a
mother,106133,107104,971,Germany,G18,c,9,2,a
father,109810,111574,1764,Germany,G18,m,10,1,a
mother,115096,116339,1243,Germany,G18,f,10,2,q
father,116832,117442,610,Germany,G18,m,10,3,a
mother,118067,118780,713,Germany,G18,f,10,4,a
father,119442,120817,1375,Germany,G18,m,10,5,a
mother,120038,122479,2441,Germany,G18,f,10,6,a
father,122008,127832,5824,Germany,G18,m,10,7,a
mother,130486,134420,3934,Germany,G18,f,10,8,a
mother,140633,141545,912,Germany,G18,c,11,1,a
father,142170,142927,757,Germany,G18,m,11,2,q
father,144935,149060,4125,Germany,G18,m,12,1,q
mother,150023,150994,971,Germany,G18,f,12,2,a
mother,154479,162471,7992,Germany,G18,f,12,3,a
father,161133,161707,574,Germany,G18,m,12,4,a
mother,167766,172663,4897,Germany,G18,f,13,1,a
father,174699,177832,3133,Germany,G18,m,13,2,a
mother,177663,179104,1441,Germany,G18,f,13,3,a
father,178295,179464,1169,Germany,G18,m,13,4,a
mother,180949,182685,1736,Germany,G18,f,13,5,a
father,182626,183133,507,Germany,G18,m,13,6,a
mother,194942,196810,1868,Germany,G18,f,14,1,a
father,206096,207802,1706,Germany,G18,m,15,1,q
mother,209244,219163,9919,Germany,G18,f,15,2,a
mother,221420,224788,3368,Germany,G18,f,15,3,a
father,235420,236310,890,Germany,G18,m,15,4,a
mother,236324,238714,2390,Germany,G18,c,16,1,a
child,238898,239913,1015,Germany,G18,m,16,2,a
mother,240214,241920,1706,Germany,G18,c,16,3,q
mother,244067,246523,2456,Germany,G18,c,16,4,a
father,242427,244148,1721,Germany,G18,m,17,1,a
father,246295,247876,1581,Germany,G18,m,17,2,a
mother,248376,250920,2544,Germany,G18,f,17,3,a
mother,270060,273986,3926,Germany,G18,f,18,1,a
father,274214,276567,2353,Germany,G18,m,18,2,a
mother,277126,278464,1338,Germany,G18,f,18,3,a
mother,282824,284038,1214,Germany,G18,f,18,4,a
father,285067,286141,1074,Germany,G18,m,18,5,a
mother,285207,285957,750,Germany,G18,f,18,6,a
mother,287383,289560,2177,Germany,G18,f,18,7,a
mother,291596,292942,1346,Germany,G18,f,18,8,a
mother,295008,304214,9206,Germany,G18,f,18,9,a
father,304383,305986,1603,Germany,G18,m,18,10,a
mother,306001,308935,2934,Germany,G18,f,18,11,a
mother,315457,317420,1963,Germany,G18,f,19,1,a
father,318288,319207,919,Germany,G18,m,19,2,q
mother,320192,321721,1529,Germany,G18,f,19,3,a
father,327067,329501,2434,Germany,G18,m,20,1,a
mother,330398,333891,3493,Germany,G18,f,20,2,q
father,332817,335560,2743,Germany,G18,m,20,3,a
mother,335994,336486,492,Germany,G18,f,20,4,a
father,338589,341317,2728,Germany,G18,m,20,5,a
mother,344295,345832,1537,Germany,G18,f,20,6,q
father,346339,346971,632,Germany,G18,m,20,7,q
mother,346824,347942,1118,Germany,G18,f,20,8,q
father,348089,349523,1434,Germany,G18,m,20,9,a
father,356685,357891,1206,Germany,G18,m,20,10,q
mother,351729,352721,992,Germany,G18,c,21,1,a
child,356979,357876,897,Germany,G18,b,21,2,a
mother,357861,363280,5419,Germany,G18,c,21,3,a
mother,365633,367332,1699,Germany,G18,c,21,4,a
child,365641,366464,823,Germany,G18,m,21,5,a
mother,370060,372052,1992,Germany,G18,c,21,6,q
child,373516,374604,1088,Germany,G18,m,21,7,a
mother,374567,376295,1728,Germany,G18,c,21,8,q
child,377126,378891,1765,Germany,G18,m,21,9,a
father,401405,404994,3589,Germany,G18,c,21,10,q
father,407994,411251,3257,Germany,G18,c,21,11,a
father,413508,414913,1405,Germany,G18,c,21,12,q
mother,419744,421802,2058,Germany,G18,f,22,1,q
father,422383,427317,4934,Germany,G18,m,22,2,a
mother,428244,429905,1661,Germany,G18,f,22,3,q
father,434883,436369,1486,Germany,G18,m,22,4,a
mother,436611,438795,2184,Germany,G18,f,22,5,a
mother,441141,443060,1919,Germany,G18,f,22,6,a
mother,445008,450773,5765,Germany,G18,f,22,7,a
father,451001,452435,1434,Germany,G18,m,22,8,a
child,424979,427310,2331,Germany,G18,m,23,1,a
child,431052,432258,1206,Germany,G18,m,23,2,a
mother,432266,433391,1125,Germany,G18,c,23,3,a
mother,454707,461530,6823,Germany,G18,f,23,4,a
father,462758,464994,2236,Germany,G18,m,23,5,a
mother,464655,466942,2287,Germany,G18,f,23,6,q
mother,469111,469861,750,Germany,G18,f,23,7,q
father,471633,472611,978,Germany,G18,m,23,8,a
mother,471861,479582,7721,Germany,G18,f,23,9,a
mother,482744,497802,15058,Germany,G18,f,24,1,a
father,498001,498729,728,Germany,G18,m,24,2,q
mother,498648,502126,3478,Germany,G18,f,24,3,a
mother,505288,506913,1625,Germany,G18,f,24,4,a
father,508427,509236,809,Germany,G18,m,24,5,a
child,523361,524744,1383,Germany,G18,f,25,1,a
father,524721,534927,10206,Germany,G18,c,25,2,q
father,537802,538567,765,Germany,G18,c,25,3,q
child,547854,548552,698,Germany,G18,o,26,1,a
mother,555008,560744,5736,Germany,G18,f,27,1,a
father,560560,561096,536,Germany,G18,m,27,2,q
mother,561111,564008,2897,Germany,G18,f,27,3,a
mother,570192,582795,12603,Germany,G18,f,27,4,a
father,583817,584611,794,Germany,G18,m,27,5,a
mother,584626,588729,4103,Germany,G18,f,27,6,a
father,589104,590405,1301,Germany,G18,m,27,7,a
mother,590413,594780,4367,Germany,G18,f,27,8,a
father,595758,596435,677,Germany,G18,m,27,9,q
mother,596949,598994,2045,Germany,G18,f,27,10,a
father,564229,565869,1640,Germany,G18,m,28,1,q
mother,565383,569758,4375,Germany,G18,f,28,2,a
child,235030,237435,2405,Germany,G18,m,30,1,a
child,518148,519045,897,Germany,G18,f,31,1,a
silence,1111,3052,1941,Germany,G18,NA,NA,NA,NA
silence,4155,5692,1537,Germany,G18,NA,NA,NA,NA
silence,6935,7824,889,Germany,G18,NA,NA,NA,NA
silence,10655,11383,728,Germany,G18,NA,NA,NA,NA
child_gesture,11702,12659,957,Germany,G18,NA,NA,NA,NA
silence,12832,13317,485,Germany,G18,NA,NA,NA,NA
silence,15721,18317,2596,Germany,G18,NA,NA,NA,NA
silence,19574,26221,6647,Germany,G18,NA,NA,NA,NA
silence,27214,32398,5184,Germany,G18,NA,NA,NA,NA
child_gesture,31217,32249,1032,Germany,G18,NA,NA,NA,NA
silence,34001,34530,529,Germany,G18,NA,NA,NA,NA
silence,35839,36471,632,Germany,G18,NA,NA,NA,NA
silence,37560,42964,5404,Germany,G18,NA,NA,NA,NA
silence,43994,44552,558,Germany,G18,NA,NA,NA,NA
silence,45177,58119,12942,Germany,G18,NA,NA,NA,NA
silence,63295,63310,15,Germany,G18,NA,NA,NA,NA
silence,65736,67876,2140,Germany,G18,NA,NA,NA,NA
silence,79494,80324,830,Germany,G18,NA,NA,NA,NA
silence,85508,87273,1765,Germany,G18,NA,NA,NA,NA
silence,89699,89714,15,Germany,G18,NA,NA,NA,NA
silence,92619,93729,1110,Germany,G18,NA,NA,NA,NA
silence,94883,95310,427,Germany,G18,NA,NA,NA,NA
silence,96111,103655,7544,Germany,G18,NA,NA,NA,NA
silence,104721,106133,1412,Germany,G18,NA,NA,NA,NA
silence,107104,109810,2706,Germany,G18,NA,NA,NA,NA
silence,111574,115096,3522,Germany,G18,NA,NA,NA,NA
silence,116339,116832,493,Germany,G18,NA,NA,NA,NA
silence,117442,118067,625,Germany,G18,NA,NA,NA,NA
silence,118780,119442,662,Germany,G18,NA,NA,NA,NA
silence,127832,130486,2654,Germany,G18,NA,NA,NA,NA
silence,134420,140633,6213,Germany,G18,NA,NA,NA,NA
silence,141545,142170,625,Germany,G18,NA,NA,NA,NA
silence,142927,144935,2008,Germany,G18,NA,NA,NA,NA
silence,149060,150023,963,Germany,G18,NA,NA,NA,NA
silence,150994,154479,3485,Germany,G18,NA,NA,NA,NA
silence,162471,167766,5295,Germany,G18,NA,NA,NA,NA
silence,172663,174699,2036,Germany,G18,NA,NA,NA,NA
silence,179464,180949,1485,Germany,G18,NA,NA,NA,NA
silence,183133,194942,11809,Germany,G18,NA,NA,NA,NA
mother_gesture,195383,196308,925,Germany,G18,NA,NA,NA,NA
silence,196810,206096,9286,Germany,G18,NA,NA,NA,NA
silence,207802,209244,1442,Germany,G18,NA,NA,NA,NA
silence,219163,221420,2257,Germany,G18,NA,NA,NA,NA
silence,224788,235030,10242,Germany,G18,NA,NA,NA,NA
child_gesture,234588,235419,831,Germany,G18,NA,NA,NA,NA
silence,238714,238898,184,Germany,G18,NA,NA,NA,NA
silence,239913,240214,301,Germany,G18,NA,NA,NA,NA
silence,241920,242427,507,Germany,G18,NA,NA,NA,NA
silence,247876,248376,500,Germany,G18,NA,NA,NA,NA
silence,250920,270060,19140,Germany,G18,NA,NA,NA,NA
silence,273986,274214,228,Germany,G18,NA,NA,NA,NA
silence,276567,277126,559,Germany,G18,NA,NA,NA,NA
silence,278464,282824,4360,Germany,G18,NA,NA,NA,NA
silence,284038,285067,1029,Germany,G18,NA,NA,NA,NA
silence,286141,287383,1242,Germany,G18,NA,NA,NA,NA
silence,289560,291596,2036,Germany,G18,NA,NA,NA,NA
silence,292942,295008,2066,Germany,G18,NA,NA,NA,NA
silence,304214,304383,169,Germany,G18,NA,NA,NA,NA
silence,305986,306001,15,Germany,G18,NA,NA,NA,NA
silence,308935,315457,6522,Germany,G18,NA,NA,NA,NA
silence,317420,318288,868,Germany,G18,NA,NA,NA,NA
silence,319207,320192,985,Germany,G18,NA,NA,NA,NA
silence,321721,327067,5346,Germany,G18,NA,NA,NA,NA
silence,329501,330398,897,Germany,G18,NA,NA,NA,NA
silence,335560,335994,434,Germany,G18,NA,NA,NA,NA
silence,336486,338589,2103,Germany,G18,NA,NA,NA,NA
silence,341317,344295,2978,Germany,G18,NA,NA,NA,NA
silence,345832,346339,507,Germany,G18,NA,NA,NA,NA
silence,347942,348089,147,Germany,G18,NA,NA,NA,NA
silence,349523,351729,2206,Germany,G18,NA,NA,NA,NA
silence,352721,356685,3964,Germany,G18,NA,NA,NA,NA
silence,363280,365633,2353,Germany,G18,NA,NA,NA,NA
silence,367332,370060,2728,Germany,G18,NA,NA,NA,NA
silence,372052,373516,1464,Germany,G18,NA,NA,NA,NA
silence,376295,377126,831,Germany,G18,NA,NA,NA,NA
silence,378891,401405,22514,Germany,G18,NA,NA,NA,NA
silence,404994,407994,3000,Germany,G18,NA,NA,NA,NA
silence,411251,413508,2257,Germany,G18,NA,NA,NA,NA
silence,414913,419744,4831,Germany,G18,NA,NA,NA,NA
silence,421802,422383,581,Germany,G18,NA,NA,NA,NA
child_gesture,424958,427187,2229,Germany,G18,NA,NA,NA,NA
silence,427317,428244,927,Germany,G18,NA,NA,NA,NA
silence,429905,431052,1147,Germany,G18,NA,NA,NA,NA
child_gesture,431458,432055,597,Germany,G18,NA,NA,NA,NA
silence,432258,432266,8,Germany,G18,NA,NA,NA,NA
silence,433391,434883,1492,Germany,G18,NA,NA,NA,NA
silence,436369,436611,242,Germany,G18,NA,NA,NA,NA
silence,438795,441141,2346,Germany,G18,NA,NA,NA,NA
silence,443060,445008,1948,Germany,G18,NA,NA,NA,NA
silence,450773,451001,228,Germany,G18,NA,NA,NA,NA
silence,452435,454707,2272,Germany,G18,NA,NA,NA,NA
mother_gesture,456861,457529,668,Germany,G18,NA,NA,NA,NA
mother_gesture,459697,461486,1789,Germany,G18,NA,NA,NA,NA
silence,461530,462758,1228,Germany,G18,NA,NA,NA,NA
silence,466942,469111,2169,Germany,G18,NA,NA,NA,NA
silence,469861,471633,1772,Germany,G18,NA,NA,NA,NA
silence,479582,482744,3162,Germany,G18,NA,NA,NA,NA
mother_gesture,483335,484415,1080,Germany,G18,NA,NA,NA,NA
silence,497802,498001,199,Germany,G18,NA,NA,NA,NA
silence,502126,505288,3162,Germany,G18,NA,NA,NA,NA
silence,506913,508427,1514,Germany,G18,NA,NA,NA,NA
silence,509236,518148,8912,Germany,G18,NA,NA,NA,NA
silence,519045,523361,4316,Germany,G18,NA,NA,NA,NA
silence,534927,537802,2875,Germany,G18,NA,NA,NA,NA
silence,538567,547854,9287,Germany,G18,NA,NA,NA,NA
silence,548552,555008,6456,Germany,G18,NA,NA,NA,NA
silence,561096,561111,15,Germany,G18,NA,NA,NA,NA
mother_gesture,563246,563831,585,Germany,G18,NA,NA,NA,NA
silence,564008,564229,221,Germany,G18,NA,NA,NA,NA
mother_gesture,565621,566242,621,Germany,G18,NA,NA,NA,NA
mother_gesture,567772,568212,440,Germany,G18,NA,NA,NA,NA
silence,569758,570192,434,Germany,G18,NA,NA,NA,NA
silence,582795,583817,1022,Germany,G18,NA,NA,NA,NA
silence,584611,584626,15,Germany,G18,NA,NA,NA,NA
silence,588729,589104,375,Germany,G18,NA,NA,NA,NA
silence,590405,590413,8,Germany,G18,NA,NA,NA,NA
silence,594780,595758,978,Germany,G18,NA,NA,NA,NA
silence,596435,596949,514,Germany,G18,NA,NA,NA,NA
silence,598994,599413,419,Germany,G18,NA,NA,NA,NA
mother,1499,2949,1450,Germany,G19,c,1,1,a
father,2319,5629,3310,Germany,G19,m,1,2,a
mother,5599,7519,1920,Germany,G19,f,1,3,a
child,11458,12470,1012,Germany,G19,m,1,4,a
father,14779,17539,2760,Germany,G19,m,1,5,a
father,19149,21169,2020,Germany,G19,c,1,6,q
child,21569,22089,520,Germany,G19,f,1,7,a
father,22229,24679,2450,Germany,G19,c,1,8,a
child,25009,26039,1030,Germany,G19,m,1,9,q
mother,26029,28889,2860,Germany,G19,c,1,10,a
father,28959,31209,2250,Germany,G19,m,1,11,a
father,33569,34629,1060,Germany,G19,m,1,12,a
father,38589,39479,890,Germany,G19,b,1,13,a
father,40869,44299,3430,Germany,G19,m,1,14,q
child,44279,48729,4450,Germany,G19,b,1,15,a
mother,46509,47499,990,Germany,G19,f,1,16,a
father,49119,58569,9450,Germany,G19,c,1,17,q
child,49879,51129,1250,Germany,G19,f,1,18,a
child,59409,61419,2010,Germany,G19,f,1,19,a
father,61439,62099,660,Germany,G19,c,1,20,a
father,65209,66269,1060,Germany,G19,c,2,1,a
father,68089,69599,1510,Germany,G19,m,3,1,a
father,70939,79869,8930,Germany,G19,m,4,1,a
father,85399,90229,4830,Germany,G19,m,5,1,a
mother,90889,91819,930,Germany,G19,f,5,2,a
child,92079,94349,2270,Germany,G19,b,6,1,a
mother,94459,97529,3070,Germany,G19,c,6,2,a
mother,97689,99069,1380,Germany,G19,f,7,1,q
father,100319,103129,2810,Germany,G19,m,7,2,a
mother,101509,105219,3710,Germany,G19,f,7,3,a
father,105099,106549,1450,Germany,G19,m,7,4,i
mother,108159,109689,1530,Germany,G19,f,7,5,a
father,112969,118639,5670,Germany,G19,m,7,6,i
child,123809,125389,1580,Germany,G19,m,8,1,a
father,126139,127789,1650,Germany,G19,c,8,2,a
mother,127779,129179,1400,Germany,G19,c,8,3,a
child,134809,135889,1080,Germany,G19,m,8,4,a
father,136399,137719,1320,Germany,G19,c,8,5,q
mother,137789,145539,7750,Germany,G19,c,8,6,a
child,145659,146179,520,Germany,G19,m,8,7,a
mother,146379,146979,600,Germany,G19,c,8,8,a
child,147349,147909,560,Germany,G19,m,8,9,a
mother,148339,149039,700,Germany,G19,c,8,10,a
child,152199,153739,1540,Germany,G19,m,8,11,a
mother,154889,155839,950,Germany,G19,c,8,12,q
child,156769,158449,1680,Germany,G19,m,8,13,a
mother,158749,160189,1440,Germany,G19,c,8,14,a
father,160689,161709,1020,Germany,G19,b,8,15,a
child,165109,166289,1180,Germany,G19,m,8,16,a
mother,168529,173009,4480,Germany,G19,c,8,17,a
father,176079,177299,1220,Germany,G19,c,9,1,a
mother,177389,178919,1530,Germany,G19,c,9,2,a
father,182129,182909,780,Germany,G19,c,9,3,q
child,184169,184759,590,Germany,G19,f,9,4,q
father,184199,185443,1244,Germany,G19,c,9,5,a
child,187529,188929,1400,Germany,G19,b,9,6,a
father,189159,189769,610,Germany,G19,c,9,7,a
child,190329,191629,1300,Germany,G19,m,10,1,a
child,198319,200469,2150,Germany,G19,m,10,2,a
mother,202529,206589,4060,Germany,G19,c,10,3,a
child,207269,208519,1250,Germany,G19,m,10,4,a
mother,208579,209519,940,Germany,G19,c,10,5,a
father,216869,217579,710,Germany,G19,c,10,6,a
child,218129,219179,1050,Germany,G19,m,10,7,q
father,220599,222079,1480,Germany,G19,c,10,8,a
child,222739,224009,1270,Germany,G19,b,10,9,a
father,224989,226179,1190,Germany,G19,c,10,10,a
father,193329,197869,4540,Germany,G19,b,11,1,a
father,242179,245899,3720,Germany,G19,m,12,1,a
mother,246589,247459,870,Germany,G19,f,12,2,a
father,250739,252789,2050,Germany,G19,m,12,3,a
child,262239,263689,1450,Germany,G19,b,13,1,a
father,263739,265089,1350,Germany,G19,m,13,2,a
mother,266669,268059,1390,Germany,G19,f,13,3,q
father,268059,268869,810,Germany,G19,m,13,4,a
father,268929,270689,1760,Germany,G19,c,13,5,a
child,288479,289299,820,Germany,G19,m,14,1,a
mother,289389,291529,2140,Germany,G19,c,14,2,a
child,293119,294199,1080,Germany,G19,m,14,3,a
mother,295239,296299,1060,Germany,G19,c,14,4,a
child,295709,296959,1250,Germany,G19,m,14,5,a
child,299119,300789,1670,Germany,G19,m,14,6,a
father,302309,304029,1720,Germany,G19,m,15,1,q
mother,304129,304549,420,Germany,G19,f,15,2,a
father,307469,311299,3830,Germany,G19,m,15,3,q
mother,313269,314989,1720,Germany,G19,f,15,4,q
father,322199,323319,1120,Germany,G19,m,15,5,a
mother,324219,325179,960,Germany,G19,f,15,6,a
mother,330399,331699,1300,Germany,G19,f,15,7,a
father,332179,336359,4180,Germany,G19,m,15,8,q
mother,336539,337429,890,Germany,G19,f,15,9,a
father,339959,345799,5840,Germany,G19,m,15,10,q
mother,348739,349829,1090,Germany,G19,f,15,11,a
father,350229,350899,670,Germany,G19,m,15,12,a
child,317629,319419,1790,Germany,G19,b,16,1,a
father,357109,357799,690,Germany,G19,c,17,1,q
child,360739,361539,800,Germany,G19,f,17,2,a
father,370129,371509,1380,Germany,G19,c,17,3,q
child,372439,374629,2190,Germany,G19,f,17,4,a
father,374799,375329,530,Germany,G19,c,17,5,a
child,376169,377299,1130,Germany,G19,f,17,6,q
father,378279,378909,630,Germany,G19,c,17,7,q
mother,380219,381369,1150,Germany,G19,f,17,8,q
father,382009,383659,1650,Germany,G19,c,17,9,a
child,385559,386459,900,Germany,G19,f,17,10,a
child,389619,391029,1410,Germany,G19,b,17,11,a
child,396139,397369,1230,Germany,G19,b,18,1,a
father,397789,398489,700,Germany,G19,c,18,2,q
child,399189,400229,1040,Germany,G19,f,18,3,a
father,403969,404989,1020,Germany,G19,c,18,4,q
child,412029,413039,1010,Germany,G19,f,19,1,a
father,414929,416299,1370,Germany,G19,c,19,2,q
child,417189,418869,1680,Germany,G19,f,19,3,a
father,418929,420269,1340,Germany,G19,c,19,4,q
child,420309,421919,1610,Germany,G19,f,19,5,a
father,421739,423249,1510,Germany,G19,c,19,6,q
child,424549,426299,1750,Germany,G19,f,19,7,a
mother,424699,425729,1030,Germany,G19,f,19,8,a
father,425899,430759,4860,Germany,G19,c,19,9,a
child,440529,441529,1000,Germany,G19,b,19,10,a
mother,442709,444479,1770,Germany,G19,c,19,11,a
father,446239,447419,1180,Germany,G19,m,19,12,q
mother,448129,449239,1110,Germany,G19,f,19,13,q
child,449469,451529,2060,Germany,G19,m,19,14,q
father,449659,451139,1480,Germany,G19,m,19,15,a
mother,451839,452949,1110,Germany,G19,c,19,16,a
child,453969,455809,1840,Germany,G19,m,19,17,q
father,452919,459859,6940,Germany,G19,m,20,1,a
mother,463029,464089,1060,Germany,G19,f,20,2,a
father,477289,482909,5620,Germany,G19,m,21,1,q
mother,483629,484469,840,Germany,G19,f,21,2,a
child,488999,491559,2560,Germany,G19,f,21,3,a
mother,492449,503749,11300,Germany,G19,f,22,1,a
mother,506699,508249,1550,Germany,G19,f,22,2,q
father,509119,511269,2150,Germany,G19,m,22,3,q
mother,512359,513349,990,Germany,G19,f,22,4,a
father,518079,523829,5750,Germany,G19,m,22,5,a
mother,525599,526919,1320,Germany,G19,f,22,6,q
father,529429,530329,900,Germany,G19,m,22,7,q
father,532079,535749,3670,Germany,G19,m,23,1,a
child,553799,555009,1210,Germany,G19,f,24,1,a
father,556689,559859,3170,Germany,G19,c,24,2,a
father,563049,567309,4260,Germany,G19,m,25,1,a
mother,569079,570389,1310,Germany,G19,f,25,2,a
father,570619,575039,4420,Germany,G19,m,25,3,a
mother,574809,576659,1850,Germany,G19,f,25,4,a
father,576539,581119,4580,Germany,G19,m,25,5,a
mother,580589,582539,1950,Germany,G19,f,25,6,a
father,582639,583419,780,Germany,G19,m,25,7,a
father,585309,586789,1480,Germany,G19,m,25,8,a
father,589529,593809,4280,Germany,G19,o,25,9,a
child,594289,599209,4920,Germany,G19,f,25,10,a
father,594729,598619,3890,Germany,G19,m,26,1,a
silence,7519,11458,3939,Germany,G19,NA,NA,NA,NA
silence,12470,14779,2309,Germany,G19,NA,NA,NA,NA
silence,17539,19149,1610,Germany,G19,NA,NA,NA,NA
silence,21169,21569,400,Germany,G19,NA,NA,NA,NA
silence,22089,22229,140,Germany,G19,NA,NA,NA,NA
silence,24679,25009,330,Germany,G19,NA,NA,NA,NA
mother_gesture,25677,26945,1268,Germany,G19,NA,NA,NA,NA
silence,28889,28959,70,Germany,G19,NA,NA,NA,NA
silence,31209,33569,2360,Germany,G19,NA,NA,NA,NA
silence,34629,38589,3960,Germany,G19,NA,NA,NA,NA
silence,39479,40869,1390,Germany,G19,NA,NA,NA,NA
silence,48729,49119,390,Germany,G19,NA,NA,NA,NA
child_gesture,58498,61573,3075,Germany,G19,NA,NA,NA,NA
silence,58569,59409,840,Germany,G19,NA,NA,NA,NA
silence,61419,61439,20,Germany,G19,NA,NA,NA,NA
silence,62099,65209,3110,Germany,G19,NA,NA,NA,NA
silence,66269,68089,1820,Germany,G19,NA,NA,NA,NA
silence,69599,70939,1340,Germany,G19,NA,NA,NA,NA
silence,79869,85399,5530,Germany,G19,NA,NA,NA,NA
silence,90229,90889,660,Germany,G19,NA,NA,NA,NA
silence,91819,92079,260,Germany,G19,NA,NA,NA,NA
mother_gesture,93751,98654,4903,Germany,G19,NA,NA,NA,NA
silence,94349,94459,110,Germany,G19,NA,NA,NA,NA
silence,97529,97689,160,Germany,G19,NA,NA,NA,NA
silence,99069,100319,1250,Germany,G19,NA,NA,NA,NA
silence,106549,108159,1610,Germany,G19,NA,NA,NA,NA
silence,109689,112969,3280,Germany,G19,NA,NA,NA,NA
silence,118639,123809,5170,Germany,G19,NA,NA,NA,NA
silence,125389,126139,750,Germany,G19,NA,NA,NA,NA
silence,129179,134809,5630,Germany,G19,NA,NA,NA,NA
silence,135889,136399,510,Germany,G19,NA,NA,NA,NA
silence,137719,137789,70,Germany,G19,NA,NA,NA,NA
silence,145539,145659,120,Germany,G19,NA,NA,NA,NA
silence,146179,146379,200,Germany,G19,NA,NA,NA,NA
silence,146979,147349,370,Germany,G19,NA,NA,NA,NA
silence,147909,148339,430,Germany,G19,NA,NA,NA,NA
silence,149039,152199,3160,Germany,G19,NA,NA,NA,NA
silence,153739,154889,1150,Germany,G19,NA,NA,NA,NA
silence,155839,156769,930,Germany,G19,NA,NA,NA,NA
silence,158449,158749,300,Germany,G19,NA,NA,NA,NA
silence,160189,160689,500,Germany,G19,NA,NA,NA,NA
silence,161709,165109,3400,Germany,G19,NA,NA,NA,NA
silence,166289,168529,2240,Germany,G19,NA,NA,NA,NA
silence,173009,176079,3070,Germany,G19,NA,NA,NA,NA
silence,177299,177389,90,Germany,G19,NA,NA,NA,NA
silence,178919,182129,3210,Germany,G19,NA,NA,NA,NA
silence,182909,184169,1260,Germany,G19,NA,NA,NA,NA
silence,185443,187529,2086,Germany,G19,NA,NA,NA,NA
silence,188929,189159,230,Germany,G19,NA,NA,NA,NA
silence,189769,190329,560,Germany,G19,NA,NA,NA,NA
silence,191629,193329,1700,Germany,G19,NA,NA,NA,NA
silence,197869,198319,450,Germany,G19,NA,NA,NA,NA
silence,200469,202529,2060,Germany,G19,NA,NA,NA,NA
silence,206589,207269,680,Germany,G19,NA,NA,NA,NA
silence,208519,208579,60,Germany,G19,NA,NA,NA,NA
silence,209519,216869,7350,Germany,G19,NA,NA,NA,NA
silence,217579,218129,550,Germany,G19,NA,NA,NA,NA
silence,219179,220599,1420,Germany,G19,NA,NA,NA,NA
silence,222079,222739,660,Germany,G19,NA,NA,NA,NA
silence,224009,224989,980,Germany,G19,NA,NA,NA,NA
silence,226179,242179,16000,Germany,G19,NA,NA,NA,NA
silence,245899,246589,690,Germany,G19,NA,NA,NA,NA
silence,247459,250739,3280,Germany,G19,NA,NA,NA,NA
silence,252789,262239,9450,Germany,G19,NA,NA,NA,NA
silence,263689,263739,50,Germany,G19,NA,NA,NA,NA
silence,265089,266669,1580,Germany,G19,NA,NA,NA,NA
silence,268869,268929,60,Germany,G19,NA,NA,NA,NA
silence,270689,288479,17790,Germany,G19,NA,NA,NA,NA
child_gesture,288771,289663,892,Germany,G19,NA,NA,NA,NA
silence,289299,289389,90,Germany,G19,NA,NA,NA,NA
silence,291529,293119,1590,Germany,G19,NA,NA,NA,NA
silence,294199,295239,1040,Germany,G19,NA,NA,NA,NA
silence,296959,299119,2160,Germany,G19,NA,NA,NA,NA
silence,300789,302309,1520,Germany,G19,NA,NA,NA,NA
silence,304029,304129,100,Germany,G19,NA,NA,NA,NA
silence,304549,307469,2920,Germany,G19,NA,NA,NA,NA
silence,311299,313269,1970,Germany,G19,NA,NA,NA,NA
silence,314989,317629,2640,Germany,G19,NA,NA,NA,NA
silence,319419,322199,2780,Germany,G19,NA,NA,NA,NA
silence,323319,324219,900,Germany,G19,NA,NA,NA,NA
silence,325179,330399,5220,Germany,G19,NA,NA,NA,NA
silence,331699,332179,480,Germany,G19,NA,NA,NA,NA
silence,336359,336539,180,Germany,G19,NA,NA,NA,NA
silence,337429,339959,2530,Germany,G19,NA,NA,NA,NA
silence,345799,348739,2940,Germany,G19,NA,NA,NA,NA
silence,349829,350229,400,Germany,G19,NA,NA,NA,NA
silence,350899,357109,6210,Germany,G19,NA,NA,NA,NA
child_gesture,351143,352158,1015,Germany,G19,NA,NA,NA,NA
child_gesture,355320,356458,1138,Germany,G19,NA,NA,NA,NA
silence,357799,360739,2940,Germany,G19,NA,NA,NA,NA
silence,361539,370129,8590,Germany,G19,NA,NA,NA,NA
child_gesture,366267,371464,5197,Germany,G19,NA,NA,NA,NA
silence,371509,372439,930,Germany,G19,NA,NA,NA,NA
silence,374629,374799,170,Germany,G19,NA,NA,NA,NA
silence,375329,376169,840,Germany,G19,NA,NA,NA,NA
silence,377299,378279,980,Germany,G19,NA,NA,NA,NA
silence,378909,380219,1310,Germany,G19,NA,NA,NA,NA
silence,381369,382009,640,Germany,G19,NA,NA,NA,NA
silence,383659,385559,1900,Germany,G19,NA,NA,NA,NA
silence,386459,389619,3160,Germany,G19,NA,NA,NA,NA
child_gesture,386740,388217,1477,Germany,G19,NA,NA,NA,NA
silence,391029,396139,5110,Germany,G19,NA,NA,NA,NA
silence,397369,397789,420,Germany,G19,NA,NA,NA,NA
silence,398489,399189,700,Germany,G19,NA,NA,NA,NA
silence,400229,403969,3740,Germany,G19,NA,NA,NA,NA
silence,404989,412029,7040,Germany,G19,NA,NA,NA,NA
silence,413039,414929,1890,Germany,G19,NA,NA,NA,NA
silence,416299,417189,890,Germany,G19,NA,NA,NA,NA
silence,418869,418929,60,Germany,G19,NA,NA,NA,NA
silence,420269,420309,40,Germany,G19,NA,NA,NA,NA
silence,423249,424549,1300,Germany,G19,NA,NA,NA,NA
silence,430759,440529,9770,Germany,G19,NA,NA,NA,NA
silence,441529,442709,1180,Germany,G19,NA,NA,NA,NA
silence,444479,446239,1760,Germany,G19,NA,NA,NA,NA
silence,447419,448129,710,Germany,G19,NA,NA,NA,NA
silence,449239,449469,230,Germany,G19,NA,NA,NA,NA
silence,451529,451839,310,Germany,G19,NA,NA,NA,NA
silence,459859,463029,3170,Germany,G19,NA,NA,NA,NA
silence,464089,477289,13200,Germany,G19,NA,NA,NA,NA
silence,482909,483629,720,Germany,G19,NA,NA,NA,NA
silence,484469,488999,4530,Germany,G19,NA,NA,NA,NA
silence,491559,492449,890,Germany,G19,NA,NA,NA,NA
silence,503749,506699,2950,Germany,G19,NA,NA,NA,NA
silence,508249,509119,870,Germany,G19,NA,NA,NA,NA
silence,511269,512359,1090,Germany,G19,NA,NA,NA,NA
silence,513349,518079,4730,Germany,G19,NA,NA,NA,NA
silence,523829,525599,1770,Germany,G19,NA,NA,NA,NA
silence,526919,529429,2510,Germany,G19,NA,NA,NA,NA
silence,530329,532079,1750,Germany,G19,NA,NA,NA,NA
silence,535749,553799,18050,Germany,G19,NA,NA,NA,NA
silence,555009,556689,1680,Germany,G19,NA,NA,NA,NA
silence,559859,563049,3190,Germany,G19,NA,NA,NA,NA
silence,567309,569079,1770,Germany,G19,NA,NA,NA,NA
silence,570389,570619,230,Germany,G19,NA,NA,NA,NA
silence,582539,582639,100,Germany,G19,NA,NA,NA,NA
silence,583419,585309,1890,Germany,G19,NA,NA,NA,NA
silence,586789,589529,2740,Germany,G19,NA,NA,NA,NA
silence,593809,594289,480,Germany,G19,NA,NA,NA,NA
child,1549,3541,1992,Germany,G20,b,1,1,a
father,4443,5806,1363,Germany,G20,c,1,2,a
father,8142,9700,1558,Germany,G20,c,1,3,q
mother,14432,20514,6082,Germany,G20,f,1,4,a
father,20443,21107,664,Germany,G20,m,1,5,a
mother,24957,28153,3196,Germany,G20,c,1,6,a
mother,21080,22153,1073,Germany,G20,f,2,1,a
child,26815,28319,1504,Germany,G20,m,3,1,a
mother,29629,30514,885,Germany,G20,c,4,1,q
child,32664,35921,3257,Germany,G20,b,5,1,q
mother,37350,38596,1246,Germany,G20,f,6,1,q
father,39461,43089,3628,Germany,G20,m,6,2,a
mother,43133,43857,724,Germany,G20,f,6,3,q
father,43948,57841,13893,Germany,G20,m,6,4,a
mother,55898,58459,2561,Germany,G20,f,6,5,q
father,58735,65018,6283,Germany,G20,m,6,6,a
mother,65765,66959,1194,Germany,G20,f,6,7,q
father,70231,71116,885,Germany,G20,m,6,8,a
mother,72456,75711,3255,Germany,G20,f,6,9,a
father,76178,81505,5327,Germany,G20,c,6,10,q
mother,82211,82902,691,Germany,G20,f,6,11,q
father,82841,91408,8567,Germany,G20,m,6,12,a
father,93107,97293,4186,Germany,G20,c,6,13,a
father,104045,104594,549,Germany,G20,m,6,14,a
child,39434,39974,540,Germany,G20,b,7,1,a
child,45806,46549,743,Germany,G20,m,8,1,a
mother,104241,106086,1845,Germany,G20,f,9,1,q
father,106134,110974,4840,Germany,G20,m,9,2,a
mother,110733,113160,2427,Germany,G20,f,9,3,q
father,113346,116178,2832,Germany,G20,m,9,4,a
child,107762,109249,1487,Germany,G20,b,10,1,a
child,114939,116107,1168,Germany,G20,f,11,1,a
child,117337,120917,3580,Germany,G20,f,11,2,a
father,116726,117771,1045,Germany,G20,m,12,1,a
mother,119948,120557,609,Germany,G20,f,12,2,q
father,120859,121629,770,Germany,G20,m,12,3,a
child,122714,123470,756,Germany,G20,b,13,1,a
father,123461,125603,2142,Germany,G20,m,14,1,a
father,127903,129629,1726,Germany,G20,m,14,2,a
child,130632,131226,594,Germany,G20,m,15,1,q
mother,132572,133160,588,Germany,G20,c,15,2,q
child,134120,134730,610,Germany,G20,m,15,3,a
mother,135263,136204,941,Germany,G20,c,15,4,a
child,136706,139966,3260,Germany,G20,m,15,5,a
father,136532,140895,4363,Germany,G20,m,16,1,a
mother,140877,143763,2886,Germany,G20,f,16,2,q
father,143620,167603,23983,Germany,G20,m,16,3,a
mother,145535,146005,470,Germany,G20,f,16,4,a
child,164332,169259,4927,Germany,G20,b,17,1,a
father,168780,176576,7796,Germany,G20,c,17,2,a
mother,169682,170579,897,Germany,G20,c,17,3,q
child,169706,172153,2447,Germany,G20,b,17,4,a
mother,171299,175873,4574,Germany,G20,c,17,5,a
child,172624,176706,4082,Germany,G20,b,17,6,a
mother,179351,181572,2221,Germany,G20,c,18,1,q
father,180452,186603,6151,Germany,G20,m,19,1,a
mother,187491,188366,875,Germany,G20,f,19,2,q
father,188496,192930,4434,Germany,G20,m,19,3,a
child,182950,184063,1113,Germany,G20,b,20,1,a
child,190193,195803,5610,Germany,G20,f,21,1,a
father,196762,197558,796,Germany,G20,c,21,2,a
child,197673,198364,691,Germany,G20,f,21,3,a
father,198726,199325,599,Germany,G20,c,21,4,a
child,200754,204819,4065,Germany,G20,f,22,1,a
father,205691,206160,469,Germany,G20,c,22,2,q
mother,205947,208902,2955,Germany,G20,f,23,1,q
father,209178,220709,11531,Germany,G20,m,23,2,a
mother,221733,222572,839,Germany,G20,f,23,3,q
father,222426,224417,1991,Germany,G20,m,23,4,a
mother,224344,227160,2816,Germany,G20,f,23,5,a
father,226434,233673,7239,Germany,G20,m,23,6,a
mother,233645,235094,1449,Germany,G20,f,23,7,a
father,234850,236328,1478,Germany,G20,m,23,8,a
child,233933,237177,3244,Germany,G20,f,24,1,a
father,238187,240930,2743,Germany,G20,c,24,2,q
mother,239108,240189,1081,Germany,G20,c,24,3,q
mother,241910,245226,3316,Germany,G20,c,24,4,q
father,242647,245700,3053,Germany,G20,c,24,5,a
child,246072,246909,837,Germany,G20,f,25,1,q
father,246983,249364,2381,Germany,G20,c,25,2,a
child,249787,250226,439,Germany,G20,f,25,3,a
mother,249844,250785,941,Germany,G20,c,25,4,q
child,251551,252291,740,Germany,G20,m,25,5,a
mother,252263,252998,735,Germany,G20,c,25,6,a
father,254142,255806,1664,Germany,G20,c,25,7,q
mother,256138,257197,1059,Germany,G20,f,25,8,i
child,260787,262706,1919,Germany,G20,b,26,1,a
mother,263645,264285,640,Germany,G20,c,26,2,a
child,267348,269966,2618,Germany,G20,b,26,3,a
mother,273976,276285,2309,Germany,G20,c,26,4,q
father,277249,278611,1362,Germany,G20,m,27,1,q
child,285405,289307,3902,Germany,G20,m,28,1,a
mother,286101,288836,2735,Germany,G20,f,29,1,a
father,289275,289886,611,Germany,G20,m,29,2,q
mother,290064,290880,816,Germany,G20,f,29,3,a
child,290462,291567,1105,Germany,G20,m,30,1,a
mother,292116,294822,2706,Germany,G20,f,31,1,a
mother,297792,298454,662,Germany,G20,f,31,2,a
child,298421,300632,2211,Germany,G20,f,32,1,a
father,301647,306045,4398,Germany,G20,c,32,2,q
child,302145,302941,796,Germany,G20,f,32,3,a
mother,306888,308277,1389,Germany,G20,c,32,4,q
father,309638,313718,4080,Germany,G20,c,32,5,a
child,310754,311519,765,Germany,G20,f,32,6,a
child,313819,320535,6716,Germany,G20,f,32,7,a
child,322787,323787,1000,Germany,G20,f,32,8,a
father,322930,328638,5708,Germany,G20,c,32,9,q
mother,328299,332189,3890,Germany,G20,f,32,10,q
father,333399,334372,973,Germany,G20,m,32,11,a
mother,333961,337579,3618,Germany,G20,f,32,12,q
father,336284,338390,2106,Germany,G20,m,32,13,a
mother,337777,340226,2449,Germany,G20,f,32,14,a
father,340718,343576,2858,Germany,G20,m,32,15,NA
mother,343491,345454,1963,Germany,G20,f,32,16,a
father,345443,346142,699,Germany,G20,m,32,17,a
mother,348888,349792,904,Germany,G20,c,32,18,q
child,350803,351389,586,Germany,G20,m,32,19,q
mother,352373,353961,1588,Germany,G20,c,32,20,q
child,354860,356616,1756,Germany,G20,f,32,21,a
father,356603,359656,3053,Germany,G20,c,32,22,q
child,360600,361738,1138,Germany,G20,f,32,23,a
father,362080,362735,655,Germany,G20,c,32,24,q
child,363259,363844,585,Germany,G20,f,32,25,a
father,364496,365195,699,Germany,G20,c,32,26,a
mother,319792,325211,5419,Germany,G20,f,33,1,a
child,325657,326372,715,Germany,G20,f,34,1,q
child,343754,344624,870,Germany,G20,f,34,2,a
mother,365388,366064,676,Germany,G20,f,35,1,a
mother,368189,389252,21063,Germany,G20,f,35,2,a
child,373673,374275,602,Germany,G20,b,36,1,a
child,381876,388494,6618,Germany,G20,b,36,2,a
father,389134,390514,1380,Germany,G20,c,36,3,a
father,391656,392240,584,Germany,G20,m,37,1,q
mother,393008,395816,2808,Germany,G20,f,37,2,q
father,395983,397381,1398,Germany,G20,m,37,3,a
mother,397401,406720,9319,Germany,G20,f,37,4,a
father,398682,399718,1036,Germany,G20,m,37,5,a
father,401771,402576,805,Germany,G20,m,37,6,a
father,407558,409381,1823,Germany,G20,m,37,7,a
mother,408774,418029,9255,Germany,G20,f,37,8,a
father,413753,414187,434,Germany,G20,m,37,9,a
father,418054,419027,973,Germany,G20,m,37,10,a
mother,418359,430199,11840,Germany,G20,f,37,11,a
father,430134,438664,8530,Germany,G20,m,37,12,a
mother,438603,442880,4277,Germany,G20,f,37,13,a
mother,449486,450976,1490,Germany,G20,f,37,14,a
child,436462,437608,1146,Germany,G20,f,38,1,a
child,441023,442072,1049,Germany,G20,f,38,2,a
father,447257,448151,894,Germany,G20,c,39,1,a
mother,454731,458614,3883,Germany,G20,c,39,2,a
mother,459763,461359,1596,Germany,G20,f,39,3,a
father,461311,462372,1061,Germany,G20,m,39,4,a
mother,462667,467050,4383,Germany,G20,c,39,5,q
father,468089,468771,682,Germany,G20,c,39,6,a
mother,470316,471114,798,Germany,G20,c,40,1,q
child,471511,472275,764,Germany,G20,m,40,2,q
mother,472348,473157,809,Germany,G20,c,40,3,a
father,472903,474107,1204,Germany,G20,c,40,4,a
mother,476699,480593,3894,Germany,G20,c,41,1,q
child,480072,482722,2650,Germany,G20,m,42,1,a
mother,482774,483391,617,Germany,G20,c,42,2,q
child,483632,484567,935,Germany,G20,m,42,3,a
father,484930,485470,540,Germany,G20,c,42,4,q
child,485925,487454,1529,Germany,G20,m,42,5,a
mother,488008,489667,1659,Germany,G20,c,42,6,a
child,490332,491072,740,Germany,G20,m,42,7,a
father,491417,492603,1186,Germany,G20,c,42,8,q
mother,491593,492072,479,Germany,G20,c,42,9,q
child,494673,495283,610,Germany,G20,m,42,10,a
father,495408,496372,964,Germany,G20,c,42,11,a
mother,495465,496252,787,Germany,G20,c,42,12,a
child,496665,498852,2187,Germany,G20,m,42,13,a
father,499222,500868,1646,Germany,G20,c,42,14,a
mother,499306,500135,829,Germany,G20,c,42,15,a
child,500901,501324,423,Germany,G20,f,42,16,a
father,501868,502797,929,Germany,G20,c,42,17,a
child,502868,503535,667,Germany,G20,f,42,18,a
father,503585,505629,2044,Germany,G20,c,42,19,a
child,504941,505494,553,Germany,G20,f,42,20,a
child,506389,507112,723,Germany,G20,f,42,21,a
father,506939,514195,7256,Germany,G20,q,42,22,a
child,514389,515543,1154,Germany,G20,f,42,23,a
father,515080,515895,815,Germany,G20,c,42,24,a
child,515966,517047,1081,Germany,G20,f,43,1,a
father,517488,521780,4292,Germany,G20,c,43,2,q
child,517714,518128,414,Germany,G20,f,43,3,a
mother,523699,525040,1341,Germany,G20,f,43,4,a
mother,525901,528199,2298,Germany,G20,c,44,1,q
child,529218,530177,959,Germany,G20,f,44,2,a
father,530169,535249,5080,Germany,G20,c,44,3,a
mother,530316,533274,2958,Germany,G20,c,44,4,a
mother,534752,535518,766,Germany,G20,c,44,5,a
mother,536072,539316,3244,Germany,G20,c,44,6,q
child,539665,542771,3106,Germany,G20,m,44,7,a
mother,543103,543731,628,Germany,G20,c,44,8,q
child,544250,544958,708,Germany,G20,m,44,9,a
mother,545316,547572,2256,Germany,G20,c,44,10,q
child,547527,548153,626,Germany,G20,m,44,11,a
mother,548380,550103,1723,Germany,G20,c,44,12,a
mother,552252,552912,660,Germany,G20,c,44,13,q
child,553267,554259,992,Germany,G20,m,44,14,a
mother,553912,554986,1074,Germany,G20,c,44,15,a
mother,557359,558455,1096,Germany,G20,c,44,16,q
mother,561838,563327,1489,Germany,G20,c,44,17,q
child,563511,566096,2585,Germany,G20,m,44,18,a
mother,564763,568082,3319,Germany,G20,c,44,19,q
child,568706,569462,756,Germany,G20,m,44,20,a
father,571682,572744,1062,Germany,G20,c,44,21,a
child,571909,572763,854,Germany,G20,b,44,22,a
mother,573455,576742,3287,Germany,G20,c,44,23,q
mother,579452,582762,3310,Germany,G20,b,44,24,a
child,582055,584348,2293,Germany,G20,b,44,25,a
mother,583780,595134,11354,Germany,G20,f,44,26,a
child,593860,594429,569,Germany,G20,f,44,27,a
father,593957,596735,2778,Germany,G20,c,44,28,q
child,598665,600063,1398,Germany,G20,b,44,29,a
child,534681,538315,3634,Germany,G20,b,45,1,a
silence,3541,4443,902,Germany,G20,NA,NA,NA,NA
silence,5806,8142,2336,Germany,G20,NA,NA,NA,NA
silence,9700,14432,4732,Germany,G20,NA,NA,NA,NA
silence,22153,24957,2804,Germany,G20,NA,NA,NA,NA
child_gesture,27091,28724,1633,Germany,G20,NA,NA,NA,NA
silence,28319,29629,1310,Germany,G20,NA,NA,NA,NA
silence,30514,32664,2150,Germany,G20,NA,NA,NA,NA
silence,35921,37350,1429,Germany,G20,NA,NA,NA,NA
silence,38596,39434,838,Germany,G20,NA,NA,NA,NA
silence,43089,43133,44,Germany,G20,NA,NA,NA,NA
silence,43857,43948,91,Germany,G20,NA,NA,NA,NA
father_gesture,54628,55891,1263,Germany,G20,NA,NA,NA,NA
silence,58459,58735,276,Germany,G20,NA,NA,NA,NA
father_gesture,61107,62725,1618,Germany,G20,NA,NA,NA,NA
silence,65018,65765,747,Germany,G20,NA,NA,NA,NA
silence,66959,70231,3272,Germany,G20,NA,NA,NA,NA
silence,71116,72456,1340,Germany,G20,NA,NA,NA,NA
silence,75711,76178,467,Germany,G20,NA,NA,NA,NA
silence,81505,82211,706,Germany,G20,NA,NA,NA,NA
father_gesture,90527,92900,2373,Germany,G20,NA,NA,NA,NA
silence,91408,93107,1699,Germany,G20,NA,NA,NA,NA
silence,97293,104045,6752,Germany,G20,NA,NA,NA,NA
silence,106086,106134,48,Germany,G20,NA,NA,NA,NA
silence,113160,113346,186,Germany,G20,NA,NA,NA,NA
silence,116178,116726,548,Germany,G20,NA,NA,NA,NA
silence,121629,122714,1085,Germany,G20,NA,NA,NA,NA
silence,125603,127903,2300,Germany,G20,NA,NA,NA,NA
silence,129629,130632,1003,Germany,G20,NA,NA,NA,NA
silence,131226,132572,1346,Germany,G20,NA,NA,NA,NA
silence,133160,134120,960,Germany,G20,NA,NA,NA,NA
silence,134730,135263,533,Germany,G20,NA,NA,NA,NA
silence,136204,136532,328,Germany,G20,NA,NA,NA,NA
silence,176706,179351,2645,Germany,G20,NA,NA,NA,NA
silence,186603,187491,888,Germany,G20,NA,NA,NA,NA
silence,188366,188496,130,Germany,G20,NA,NA,NA,NA
child_gesture,195519,198755,3236,Germany,G20,NA,NA,NA,NA
silence,195803,196762,959,Germany,G20,NA,NA,NA,NA
silence,197558,197673,115,Germany,G20,NA,NA,NA,NA
silence,198364,198726,362,Germany,G20,NA,NA,NA,NA
silence,199325,200754,1429,Germany,G20,NA,NA,NA,NA
silence,204819,205691,872,Germany,G20,NA,NA,NA,NA
silence,208902,209178,276,Germany,G20,NA,NA,NA,NA
silence,220709,221733,1024,Germany,G20,NA,NA,NA,NA
child_gesture,234209,238398,4189,Germany,G20,NA,NA,NA,NA
silence,237177,238187,1010,Germany,G20,NA,NA,NA,NA
silence,240930,241910,980,Germany,G20,NA,NA,NA,NA
silence,245700,246072,372,Germany,G20,NA,NA,NA,NA
silence,246909,246983,74,Germany,G20,NA,NA,NA,NA
silence,249364,249787,423,Germany,G20,NA,NA,NA,NA
silence,250785,251551,766,Germany,G20,NA,NA,NA,NA
silence,252998,254142,1144,Germany,G20,NA,NA,NA,NA
silence,255806,256138,332,Germany,G20,NA,NA,NA,NA
silence,257197,260787,3590,Germany,G20,NA,NA,NA,NA
child_gesture,262259,265016,2757,Germany,G20,NA,NA,NA,NA
silence,262706,263645,939,Germany,G20,NA,NA,NA,NA
silence,264285,267348,3063,Germany,G20,NA,NA,NA,NA
silence,269966,273976,4010,Germany,G20,NA,NA,NA,NA
silence,276285,277249,964,Germany,G20,NA,NA,NA,NA
silence,278611,285405,6794,Germany,G20,NA,NA,NA,NA
child_gesture,286807,290625,3818,Germany,G20,NA,NA,NA,NA
silence,289886,290064,178,Germany,G20,NA,NA,NA,NA
silence,291567,292116,549,Germany,G20,NA,NA,NA,NA
silence,294822,297792,2970,Germany,G20,NA,NA,NA,NA
child_gesture,300072,301855,1783,Germany,G20,NA,NA,NA,NA
silence,300632,301647,1015,Germany,G20,NA,NA,NA,NA
child_gesture,302605,304036,1431,Germany,G20,NA,NA,NA,NA
silence,306045,306888,843,Germany,G20,NA,NA,NA,NA
silence,308277,309638,1361,Germany,G20,NA,NA,NA,NA
child_gesture,310691,312051,1360,Germany,G20,NA,NA,NA,NA
child_gesture,313134,317354,4220,Germany,G20,NA,NA,NA,NA
silence,313718,313819,101,Germany,G20,NA,NA,NA,NA
child_gesture,318925,320860,1935,Germany,G20,NA,NA,NA,NA
silence,332189,333399,1210,Germany,G20,NA,NA,NA,NA
silence,340226,340718,492,Germany,G20,NA,NA,NA,NA
silence,346142,348888,2746,Germany,G20,NA,NA,NA,NA
silence,349792,350803,1011,Germany,G20,NA,NA,NA,NA
silence,351389,352373,984,Germany,G20,NA,NA,NA,NA
silence,353961,354860,899,Germany,G20,NA,NA,NA,NA
silence,359656,360600,944,Germany,G20,NA,NA,NA,NA
silence,361738,362080,342,Germany,G20,NA,NA,NA,NA
silence,362735,363259,524,Germany,G20,NA,NA,NA,NA
silence,363844,364496,652,Germany,G20,NA,NA,NA,NA
silence,365195,365388,193,Germany,G20,NA,NA,NA,NA
silence,366064,368189,2125,Germany,G20,NA,NA,NA,NA
child_gesture,382037,386258,4221,Germany,G20,NA,NA,NA,NA
silence,390514,391656,1142,Germany,G20,NA,NA,NA,NA
silence,392240,393008,768,Germany,G20,NA,NA,NA,NA
silence,395816,395983,167,Germany,G20,NA,NA,NA,NA
mother_gesture,396502,399143,2641,Germany,G20,NA,NA,NA,NA
silence,397381,397401,20,Germany,G20,NA,NA,NA,NA
mother_gesture,400630,403361,2731,Germany,G20,NA,NA,NA,NA
silence,406720,407558,838,Germany,G20,NA,NA,NA,NA
silence,418029,418054,25,Germany,G20,NA,NA,NA,NA
silence,442880,447257,4377,Germany,G20,NA,NA,NA,NA
silence,448151,449486,1335,Germany,G20,NA,NA,NA,NA
silence,450976,454731,3755,Germany,G20,NA,NA,NA,NA
silence,458614,459763,1149,Germany,G20,NA,NA,NA,NA
silence,462372,462667,295,Germany,G20,NA,NA,NA,NA
silence,467050,468089,1039,Germany,G20,NA,NA,NA,NA
silence,468771,470316,1545,Germany,G20,NA,NA,NA,NA
silence,471114,471511,397,Germany,G20,NA,NA,NA,NA
silence,472275,472348,73,Germany,G20,NA,NA,NA,NA
father_gesture,473219,474468,1249,Germany,G20,NA,NA,NA,NA
silence,474107,476699,2592,Germany,G20,NA,NA,NA,NA
child_gesture,480410,485259,4849,Germany,G20,NA,NA,NA,NA
silence,482722,482774,52,Germany,G20,NA,NA,NA,NA
silence,483391,483632,241,Germany,G20,NA,NA,NA,NA
silence,484567,484930,363,Germany,G20,NA,NA,NA,NA
silence,485470,485925,455,Germany,G20,NA,NA,NA,NA
silence,487454,488008,554,Germany,G20,NA,NA,NA,NA
silence,489667,490332,665,Germany,G20,NA,NA,NA,NA
silence,491072,491417,345,Germany,G20,NA,NA,NA,NA
silence,492603,494673,2070,Germany,G20,NA,NA,NA,NA
child_gesture,494927,496033,1106,Germany,G20,NA,NA,NA,NA
silence,495283,495408,125,Germany,G20,NA,NA,NA,NA
silence,496372,496665,293,Germany,G20,NA,NA,NA,NA
silence,498852,499222,370,Germany,G20,NA,NA,NA,NA
silence,500868,500901,33,Germany,G20,NA,NA,NA,NA
silence,501324,501868,544,Germany,G20,NA,NA,NA,NA
silence,502797,502868,71,Germany,G20,NA,NA,NA,NA
silence,503535,503585,50,Germany,G20,NA,NA,NA,NA
silence,505629,506389,760,Germany,G20,NA,NA,NA,NA
silence,514195,514389,194,Germany,G20,NA,NA,NA,NA
silence,515895,515966,71,Germany,G20,NA,NA,NA,NA
silence,517047,517488,441,Germany,G20,NA,NA,NA,NA
silence,521780,523699,1919,Germany,G20,NA,NA,NA,NA
silence,525040,525901,861,Germany,G20,NA,NA,NA,NA
silence,528199,529218,1019,Germany,G20,NA,NA,NA,NA
child_gesture,536954,538545,1591,Germany,G20,NA,NA,NA,NA
silence,539316,539665,349,Germany,G20,NA,NA,NA,NA
silence,542771,543103,332,Germany,G20,NA,NA,NA,NA
silence,543731,544250,519,Germany,G20,NA,NA,NA,NA
silence,544958,545316,358,Germany,G20,NA,NA,NA,NA
silence,548153,548380,227,Germany,G20,NA,NA,NA,NA
silence,550103,552252,2149,Germany,G20,NA,NA,NA,NA
silence,552912,553267,355,Germany,G20,NA,NA,NA,NA
silence,554986,557359,2373,Germany,G20,NA,NA,NA,NA
silence,558455,561838,3383,Germany,G20,NA,NA,NA,NA
silence,563327,563511,184,Germany,G20,NA,NA,NA,NA
silence,568082,568706,624,Germany,G20,NA,NA,NA,NA
silence,569462,571682,2220,Germany,G20,NA,NA,NA,NA
silence,572763,573455,692,Germany,G20,NA,NA,NA,NA
silence,576742,579452,2710,Germany,G20,NA,NA,NA,NA
silence,596735,597780,1045,Germany,G20,NA,NA,NA,NA
father,104,4150,4046,Germany,G21,c,1,1,i
father,4222,5523,1301,Germany,G21,m,2,1,q
father,6803,7317,514,Germany,G21,m,2,2,q
mother,7330,8010,680,Germany,G21,f,2,3,a
child,5126,5920,794,Germany,G21,b,3,1,a
father,18163,18788,625,Germany,G21,c,4,1,q
child,20987,24670,3683,Germany,G21,b,5,1,a
mother,26130,29120,2990,Germany,G21,c,5,2,a
child,29428,31163,1735,Germany,G21,b,5,3,a
child,35288,38891,3603,Germany,G21,b,5,4,a
father,44163,44913,750,Germany,G21,c,6,1,q
child,45626,47273,1647,Germany,G21,b,6,2,a
father,46898,48038,1140,Germany,G21,c,6,3,q
child,48545,49567,1022,Germany,G21,b,6,4,a
mother,49430,50250,820,Germany,G21,c,6,5,a
father,49597,51215,1618,Germany,G21,c,6,6,a
child,51170,52369,1199,Germany,G21,f,6,7,a
mother,52300,53840,1540,Germany,G21,c,6,8,a
father,52854,54590,1736,Germany,G21,c,6,9,a
child,54104,55612,1508,Germany,G21,b,6,10,a
mother,55640,56310,670,Germany,G21,c,6,11,a
father,56134,56582,448,Germany,G21,c,6,12,a
mother,57200,58440,1240,Germany,G21,c,6,13,a
father,58840,61406,2566,Germany,G21,c,6,14,i
child,59420,66737,7317,Germany,G21,b,6,15,a
father,65869,66170,301,Germany,G21,c,6,16,a
mother,67340,68230,890,Germany,G21,c,6,17,q
child,68045,69479,1434,Germany,G21,m,6,18,a
mother,70030,70770,740,Germany,G21,c,6,19,q
father,70229,72384,2155,Germany,G21,b,6,20,a
child,71119,72884,1765,Germany,G21,b,6,21,a
mother,76300,79780,3480,Germany,G21,c,7,1,a
father,78803,80237,1434,Germany,G21,c,7,2,a
child,79678,81420,1742,Germany,G21,m,7,3,a
father,80928,81575,647,Germany,G21,c,7,4,a
mother,81300,85180,3880,Germany,G21,c,7,5,a
father,82516,86112,3596,Germany,G21,m,7,6,q
mother,86650,88320,1670,Germany,G21,c,7,7,a
child,87325,90817,3492,Germany,G21,m,7,8,a
father,90112,92869,2757,Germany,G21,c,8,1,a
child,94001,95523,1522,Germany,G21,m,8,2,a
father,95560,105876,10316,Germany,G21,c,8,3,i
child,105942,108722,2780,Germany,G21,m,9,1,a
mother,108750,111560,2810,Germany,G21,c,9,2,a
father,109185,110516,1331,Germany,G21,c,9,3,a
child,110751,116531,5780,Germany,G21,b,9,4,a
mother,115340,116160,820,Germany,G21,c,9,5,a
father,116435,117376,941,Germany,G21,c,9,6,a
child,117641,118494,853,Germany,G21,b,9,7,a
child,121685,123670,1985,Germany,G21,b,9,8,a
mother,124780,125490,710,Germany,G21,c,9,9,a
child,127354,128237,883,Germany,G21,f,9,10,a
mother,128180,130950,2770,Germany,G21,c,9,11,a
child,135516,143876,8360,Germany,G21,f,9,12,a
mother,144120,145240,1120,Germany,G21,c,9,13,a
child,145398,146244,846,Germany,G21,b,9,14,a
mother,147290,148360,1070,Germany,G21,c,9,15,a
child,149097,150288,1191,Germany,G21,b,9,16,a
mother,149920,150610,690,Germany,G21,c,9,17,a
father,150722,156413,5691,Germany,G21,c,9,18,a
child,153987,157634,3647,Germany,G21,b,9,19,a
mother,157660,159870,2210,Germany,G21,c,9,20,q
child,159906,160979,1073,Germany,G21,b,9,21,a
mother,160980,161680,700,Germany,G21,c,9,22,a
child,165575,166538,963,Germany,G21,m,9,23,a
father,171207,173222,2015,Germany,G21,c,10,1,a
child,180244,181126,882,Germany,G21,b,11,1,a
child,181957,182942,985,Germany,G21,b,11,2,a
mother,182580,183300,720,Germany,G21,c,11,3,a
father,183656,185567,1911,Germany,G21,c,11,4,a
child,183729,184509,780,Germany,G21,b,11,5,a
mother,180300,182020,1720,Germany,G21,c,12,1,q
child,188825,190803,1978,Germany,G21,m,12,2,a
mother,190980,191580,600,Germany,G21,c,12,3,a
child,195663,196582,919,Germany,G21,m,12,4,a
mother,197480,198810,1330,Germany,G21,c,12,5,a
child,199913,201031,1118,Germany,G21,b,13,1,a
mother,200870,201470,600,Germany,G21,c,13,2,a
father,212935,213862,927,Germany,G21,c,14,1,a
child,222479,224303,1824,Germany,G21,b,15,1,a
mother,224621,225292,671,Germany,G21,c,15,2,a
child,234001,235442,1441,Germany,G21,b,15,3,a
mother,235079,235760,681,Germany,G21,c,15,4,a
child,240670,255340,14670,Germany,G21,b,15,5,a
mother,256015,257824,1809,Germany,G21,c,15,6,q
child,259273,260582,1309,Germany,G21,m,15,7,a
mother,260451,261121,670,Germany,G21,c,15,8,q
child,266023,272942,6919,Germany,G21,b,15,9,a
child,275648,277920,2272,Germany,G21,b,15,10,a
mother,276824,278675,1851,Germany,G21,c,15,11,a
child,282075,284942,2867,Germany,G21,b,15,12,a
child,288788,292781,3993,Germany,G21,m,15,13,a
mother,292504,293122,618,Germany,G21,c,15,14,a
child,295545,314090,18545,Germany,G21,b,15,15,a
child,314104,322384,8280,Germany,G21,m,16,1,a
mother,322632,325696,3064,Germany,G21,c,16,2,a
child,326170,327185,1015,Germany,G21,b,16,3,a
child,328016,331626,3610,Germany,G21,b,17,1,a
mother,329239,329983,744,Germany,G21,c,17,2,a
mother,331632,334898,3266,Germany,G21,c,17,3,a
father,332148,332759,611,Germany,G21,c,17,4,a
father,335126,336781,1655,Germany,G21,c,17,5,a
mother,336760,337473,713,Germany,G21,f,17,6,a
child,337001,338009,1008,Germany,G21,b,18,1,a
father,338590,341156,2566,Germany,G21,c,18,2,a
mother,339536,341728,2192,Germany,G21,c,18,3,a
child,351957,354282,2325,Germany,G21,o,19,1,a
mother,359919,362111,2192,Germany,G21,f,20,1,a
father,364009,365023,1014,Germany,G21,m,20,2,q
mother,365058,366058,1000,Germany,G21,f,20,3,a
father,368134,369465,1331,Germany,G21,m,20,4,q
mother,370207,371483,1276,Germany,G21,f,20,5,a
mother,378653,379951,1298,Germany,G21,c,20,6,q
child,382200,389251,7051,Germany,G21,b,20,7,a
mother,382222,382759,537,Germany,G21,c,20,8,a
child,360751,364241,3490,Germany,G21,b,21,1,a
child,366148,368126,1978,Germany,G21,b,21,2,a
child,373398,378788,5390,Germany,G21,m,21,3,a
child,390229,392435,2206,Germany,G21,b,22,1,a
child,394781,396340,1559,Germany,G21,m,22,2,a
mother,396664,397302,638,Germany,G21,c,22,3,a
child,404406,405957,1551,Germany,G21,m,22,4,a
mother,406047,406866,819,Germany,G21,c,22,5,a
child,406692,408273,1581,Germany,G21,m,22,6,a
mother,409047,410058,1011,Germany,G21,c,22,7,a
child,410781,412266,1485,Germany,G21,m,22,8,a
mother,412047,414973,2926,Germany,G21,c,22,9,a
father,401420,403840,2420,Germany,G21,m,23,1,q
mother,403749,404749,1000,Germany,G21,f,23,2,a
child,417097,418898,1801,Germany,G21,m,24,1,a
child,422957,425134,2177,Germany,G21,m,25,1,a
child,427920,431972,4052,Germany,G21,m,25,2,a
child,437994,442795,4801,Germany,G21,m,25,3,a
child,444898,445862,964,Germany,G21,m,26,1,a
child,462053,463104,1051,Germany,G21,m,27,1,a
child,468178,469516,1338,Germany,G21,m,27,2,a
mother,469547,470122,575,Germany,G21,c,27,3,a
child,474038,475465,1427,Germany,G21,m,28,1,a
child,476156,481942,5786,Germany,G21,m,29,1,a
child,484670,490773,6103,Germany,G21,m,29,2,a
mother,490237,495795,5558,Germany,G21,c,29,3,a
child,492626,493545,919,Germany,G21,m,29,4,a
child,496582,497575,993,Germany,G21,m,29,5,a
mother,498685,505112,6427,Germany,G21,c,29,6,a
child,502134,502715,581,Germany,G21,m,29,7,a
child,505112,506192,1080,Germany,G21,m,29,8,a
mother,506170,507259,1089,Germany,G21,c,29,9,a
child,507597,511045,3448,Germany,G21,b,29,10,a
father,507920,510538,2618,Germany,G21,o,30,1,a
child,514273,515847,1574,Germany,G21,m,31,1,a
mother,517597,518538,941,Germany,G21,c,31,2,q
child,519906,524317,4411,Germany,G21,m,31,3,a
mother,524707,525273,566,Germany,G21,c,31,4,a
father,524384,525148,764,Germany,G21,c,32,1,a
child,525553,529803,4250,Germany,G21,f,33,1,a
father,530487,532612,2125,Germany,G21,c,33,2,a
child,532626,533442,816,Germany,G21,b,33,3,a
mother,534531,537023,2492,Germany,G21,c,33,4,a
child,536192,539862,3670,Germany,G21,b,33,5,a
father,539097,544112,5015,Germany,G21,c,33,6,a
child,544163,548148,3985,Germany,G21,f,33,7,a
child,554023,555340,1317,Germany,G21,f,33,8,a
mother,555626,560185,4559,Germany,G21,c,33,9,a
child,557251,558215,964,Germany,G21,b,33,10,a
father,558332,560134,1802,Germany,G21,c,33,11,a
child,560582,563435,2853,Germany,G21,b,33,12,a
father,562200,563332,1132,Germany,G21,c,33,13,a
mother,563384,564156,772,Germany,G21,c,33,14,a
child,564560,575692,11132,Germany,G21,m,33,15,a
mother,576281,578354,2073,Germany,G21,c,33,16,a
father,577288,578200,912,Germany,G21,c,33,17,a
mother,579509,580244,735,Germany,G21,c,33,18,a
child,580604,582935,2331,Germany,G21,m,33,19,a
mother,582898,583648,750,Germany,G21,c,33,20,a
child,587545,590913,3368,Germany,G21,b,33,21,a
child,597590,599362,1772,Germany,G21,o,34,1,a
silence,4150,4222,72,Germany,G21,NA,NA,NA,NA
silence,5920,6803,883,Germany,G21,NA,NA,NA,NA
silence,7317,7330,13,Germany,G21,NA,NA,NA,NA
silence,8010,18163,10153,Germany,G21,NA,NA,NA,NA
silence,18788,20987,2199,Germany,G21,NA,NA,NA,NA
silence,24670,26130,1460,Germany,G21,NA,NA,NA,NA
silence,29120,29428,308,Germany,G21,NA,NA,NA,NA
silence,31163,35288,4125,Germany,G21,NA,NA,NA,NA
silence,38891,44163,5272,Germany,G21,NA,NA,NA,NA
silence,44913,45626,713,Germany,G21,NA,NA,NA,NA
child_gesture,46063,46910,847,Germany,G21,NA,NA,NA,NA
silence,48038,48545,507,Germany,G21,NA,NA,NA,NA
silence,55612,55640,28,Germany,G21,NA,NA,NA,NA
silence,56582,57200,618,Germany,G21,NA,NA,NA,NA
silence,58440,58840,400,Germany,G21,NA,NA,NA,NA
child_gesture,59962,65445,5483,Germany,G21,NA,NA,NA,NA
child_gesture,65892,67167,1275,Germany,G21,NA,NA,NA,NA
silence,66737,67340,603,Germany,G21,NA,NA,NA,NA
silence,69479,70030,551,Germany,G21,NA,NA,NA,NA
silence,72884,76300,3416,Germany,G21,NA,NA,NA,NA
silence,86112,86650,538,Germany,G21,NA,NA,NA,NA
silence,92869,94001,1132,Germany,G21,NA,NA,NA,NA
silence,95523,95560,37,Germany,G21,NA,NA,NA,NA
silence,105876,105942,66,Germany,G21,NA,NA,NA,NA
child_gesture,107972,109049,1077,Germany,G21,NA,NA,NA,NA
silence,108722,108750,28,Germany,G21,NA,NA,NA,NA
mother_gesture,109898,111281,1383,Germany,G21,NA,NA,NA,NA
child_gesture,111017,112903,1886,Germany,G21,NA,NA,NA,NA
father_gesture,116232,117499,1267,Germany,G21,NA,NA,NA,NA
silence,117376,117641,265,Germany,G21,NA,NA,NA,NA
silence,118494,121685,3191,Germany,G21,NA,NA,NA,NA
silence,123670,124780,1110,Germany,G21,NA,NA,NA,NA
silence,125490,127354,1864,Germany,G21,NA,NA,NA,NA
child_gesture,127897,128870,973,Germany,G21,NA,NA,NA,NA
silence,130950,135516,4566,Germany,G21,NA,NA,NA,NA
silence,143876,144120,244,Germany,G21,NA,NA,NA,NA
silence,145240,145398,158,Germany,G21,NA,NA,NA,NA
silence,146244,147290,1046,Germany,G21,NA,NA,NA,NA
mother_gesture,147650,148735,1085,Germany,G21,NA,NA,NA,NA
silence,148360,149097,737,Germany,G21,NA,NA,NA,NA
child_gesture,149771,150840,1069,Germany,G21,NA,NA,NA,NA
silence,150610,150722,112,Germany,G21,NA,NA,NA,NA
father_gesture,151758,152745,987,Germany,G21,NA,NA,NA,NA
father_gesture,153271,153829,558,Germany,G21,NA,NA,NA,NA
father_gesture,154815,155749,934,Germany,G21,NA,NA,NA,NA
father_gesture,156196,157102,906,Germany,G21,NA,NA,NA,NA
silence,157634,157660,26,Germany,G21,NA,NA,NA,NA
silence,159870,159906,36,Germany,G21,NA,NA,NA,NA
silence,160979,160980,1,Germany,G21,NA,NA,NA,NA
silence,161680,165575,3895,Germany,G21,NA,NA,NA,NA
silence,166538,171207,4669,Germany,G21,NA,NA,NA,NA
silence,173222,180244,7022,Germany,G21,NA,NA,NA,NA
silence,183300,183656,356,Germany,G21,NA,NA,NA,NA
silence,185567,188825,3258,Germany,G21,NA,NA,NA,NA
silence,190803,190980,177,Germany,G21,NA,NA,NA,NA
silence,191580,195663,4083,Germany,G21,NA,NA,NA,NA
silence,196582,197480,898,Germany,G21,NA,NA,NA,NA
silence,198810,199913,1103,Germany,G21,NA,NA,NA,NA
silence,201470,212935,11465,Germany,G21,NA,NA,NA,NA
silence,213862,222479,8617,Germany,G21,NA,NA,NA,NA
silence,224303,224621,318,Germany,G21,NA,NA,NA,NA
silence,225292,234001,8709,Germany,G21,NA,NA,NA,NA
silence,235760,240670,4910,Germany,G21,NA,NA,NA,NA
silence,255340,256015,675,Germany,G21,NA,NA,NA,NA
silence,257824,259273,1449,Germany,G21,NA,NA,NA,NA
silence,261121,266023,4902,Germany,G21,NA,NA,NA,NA
silence,272942,275648,2706,Germany,G21,NA,NA,NA,NA
silence,278675,282075,3400,Germany,G21,NA,NA,NA,NA
silence,284942,288788,3846,Germany,G21,NA,NA,NA,NA
silence,293122,295545,2423,Germany,G21,NA,NA,NA,NA
silence,314090,314104,14,Germany,G21,NA,NA,NA,NA
child_gesture,321622,322689,1067,Germany,G21,NA,NA,NA,NA
silence,322384,322632,248,Germany,G21,NA,NA,NA,NA
silence,325696,326170,474,Germany,G21,NA,NA,NA,NA
silence,327185,328016,831,Germany,G21,NA,NA,NA,NA
child_gesture,329002,329722,720,Germany,G21,NA,NA,NA,NA
child_gesture,330405,331527,1122,Germany,G21,NA,NA,NA,NA
silence,331626,331632,6,Germany,G21,NA,NA,NA,NA
silence,334898,335126,228,Germany,G21,NA,NA,NA,NA
child_gesture,337434,338596,1162,Germany,G21,NA,NA,NA,NA
silence,338009,338590,581,Germany,G21,NA,NA,NA,NA
silence,341728,351957,10229,Germany,G21,NA,NA,NA,NA
silence,354282,359919,5637,Germany,G21,NA,NA,NA,NA
silence,365023,365058,35,Germany,G21,NA,NA,NA,NA
silence,366058,366148,90,Germany,G21,NA,NA,NA,NA
silence,368126,368134,8,Germany,G21,NA,NA,NA,NA
father_gesture,369230,369881,651,Germany,G21,NA,NA,NA,NA
silence,369465,370207,742,Germany,G21,NA,NA,NA,NA
silence,371483,373398,1915,Germany,G21,NA,NA,NA,NA
silence,379951,382200,2249,Germany,G21,NA,NA,NA,NA
silence,389251,390229,978,Germany,G21,NA,NA,NA,NA
silence,392435,394781,2346,Germany,G21,NA,NA,NA,NA
silence,396340,396664,324,Germany,G21,NA,NA,NA,NA
silence,397302,401420,4118,Germany,G21,NA,NA,NA,NA
silence,405957,406047,90,Germany,G21,NA,NA,NA,NA
silence,408273,409047,774,Germany,G21,NA,NA,NA,NA
silence,410058,410781,723,Germany,G21,NA,NA,NA,NA
child_gesture,411097,412349,1252,Germany,G21,NA,NA,NA,NA
silence,414973,417097,2124,Germany,G21,NA,NA,NA,NA
silence,418898,422957,4059,Germany,G21,NA,NA,NA,NA
silence,425134,427920,2786,Germany,G21,NA,NA,NA,NA
silence,431972,437994,6022,Germany,G21,NA,NA,NA,NA
silence,442795,444898,2103,Germany,G21,NA,NA,NA,NA
silence,445862,462053,16191,Germany,G21,NA,NA,NA,NA
silence,463104,468178,5074,Germany,G21,NA,NA,NA,NA
silence,469516,469547,31,Germany,G21,NA,NA,NA,NA
silence,470122,474038,3916,Germany,G21,NA,NA,NA,NA
silence,475465,476156,691,Germany,G21,NA,NA,NA,NA
silence,481942,484670,2728,Germany,G21,NA,NA,NA,NA
silence,495795,496582,787,Germany,G21,NA,NA,NA,NA
silence,497575,498685,1110,Germany,G21,NA,NA,NA,NA
silence,507259,507597,338,Germany,G21,NA,NA,NA,NA
silence,511045,514273,3228,Germany,G21,NA,NA,NA,NA
silence,515847,517597,1750,Germany,G21,NA,NA,NA,NA
silence,518538,519906,1368,Germany,G21,NA,NA,NA,NA
silence,524317,524384,67,Germany,G21,NA,NA,NA,NA
silence,525273,525553,280,Germany,G21,NA,NA,NA,NA
child_gesture,529079,529717,638,Germany,G21,NA,NA,NA,NA
silence,529803,530487,684,Germany,G21,NA,NA,NA,NA
father_gesture,530932,533438,2506,Germany,G21,NA,NA,NA,NA
silence,532612,532626,14,Germany,G21,NA,NA,NA,NA
silence,533442,534531,1089,Germany,G21,NA,NA,NA,NA
child_gesture,536824,537873,1049,Germany,G21,NA,NA,NA,NA
silence,544112,544163,51,Germany,G21,NA,NA,NA,NA
silence,548148,554023,5875,Germany,G21,NA,NA,NA,NA
child_gesture,553840,555850,2010,Germany,G21,NA,NA,NA,NA
silence,555340,555626,286,Germany,G21,NA,NA,NA,NA
child_gesture,557704,559144,1440,Germany,G21,NA,NA,NA,NA
father_gesture,559280,560264,984,Germany,G21,NA,NA,NA,NA
silence,560185,560582,397,Germany,G21,NA,NA,NA,NA
silence,564156,564560,404,Germany,G21,NA,NA,NA,NA
silence,575692,576281,589,Germany,G21,NA,NA,NA,NA
child_gesture,577645,580189,2544,Germany,G21,NA,NA,NA,NA
silence,578354,579509,1155,Germany,G21,NA,NA,NA,NA
silence,580244,580604,360,Germany,G21,NA,NA,NA,NA
silence,583648,587545,3897,Germany,G21,NA,NA,NA,NA
silence,590913,597590,6677,Germany,G21,NA,NA,NA,NA
child,244,2344,2100,Germany,G22,b,1,1,a
mother,1904,6354,4450,Germany,G22,c,2,1,q
child,6734,8344,1610,Germany,G22,b,2,2,a
mother,9364,10944,1580,Germany,G22,c,2,3,q
child,11064,11624,560,Germany,G22,m,2,4,a
mother,12284,13084,800,Germany,G22,c,2,5,i
child,13874,14444,570,Germany,G22,m,2,6,a
mother,14284,18144,3860,Germany,G22,c,2,7,q
child,19154,22134,2980,Germany,G22,b,2,8,a
mother,20434,21034,600,Germany,G22,c,2,9,a
father,22084,23124,1040,Germany,G22,c,2,10,q
child,23634,24174,540,Germany,G22,b,2,11,a
mother,23744,24364,620,Germany,G22,c,2,12,q
child,24794,25324,530,Germany,G22,m,2,13,a
mother,25524,29134,3610,Germany,G22,c,2,14,a
child,29094,31444,2350,Germany,G22,m,2,15,a
mother,31984,37154,5170,Germany,G22,c,2,16,a
child,36974,39314,2340,Germany,G22,m,2,17,a
mother,39174,45144,5970,Germany,G22,c,2,18,a
child,45104,46864,1760,Germany,G22,m,2,19,a
mother,47584,49184,1600,Germany,G22,c,2,20,a
child,49224,51324,2100,Germany,G22,m,2,21,a
mother,51444,52304,860,Germany,G22,c,2,22,q
father,49974,50764,790,Germany,G22,b,3,1,a
mother,52374,54224,1850,Germany,G22,b,4,1,q
mother,56554,57334,780,Germany,G22,c,4,2,q
father,57414,57954,540,Germany,G22,c,4,3,q
father,59044,59844,800,Germany,G22,c,4,4,q
child,60594,61074,480,Germany,G22,f,4,5,a
father,61004,61604,600,Germany,G22,c,4,6,q
child,62544,63014,470,Germany,G22,f,4,7,a
mother,63194,64674,1480,Germany,G22,f,4,8,a
father,64354,65274,920,Germany,G22,c,4,9,q
child,65534,66594,1060,Germany,G22,m,4,10,a
mother,67324,67724,400,Germany,G22,c,4,11,a
father,69424,75094,5670,Germany,G22,b,4,12,a
mother,69494,75124,5630,Germany,G22,b,4,13,a
child,70104,73954,3850,Germany,G22,b,4,14,a
father,75424,76064,640,Germany,G22,c,4,15,a
child,58154,58814,660,Germany,G22,b,5,1,a
child,76514,77474,960,Germany,G22,f,5,2,a
father,77464,79774,2310,Germany,G22,c,5,3,i
child,80234,82034,1800,Germany,G22,f,5,4,a
mother,78044,78784,740,Germany,G22,f,6,1,a
father,80934,82134,1200,Germany,G22,m,6,2,a
mother,81344,85504,4160,Germany,G22,f,7,1,a
father,88954,90714,1760,Germany,G22,m,7,2,a
mother,91584,93604,2020,Germany,G22,f,7,3,a
father,92714,97694,4980,Germany,G22,m,7,4,a
mother,95254,95874,620,Germany,G22,f,7,5,q
child,82244,85064,2820,Germany,G22,o,8,1,a
child,91544,92684,1140,Germany,G22,b,9,1,a
mother,96964,101164,4200,Germany,G22,c,10,1,q
child,102324,103194,870,Germany,G22,m,10,2,a
mother,103384,104134,750,Germany,G22,c,10,3,q
child,104314,106364,2050,Germany,G22,m,10,4,a
mother,105294,106284,990,Germany,G22,c,10,5,a
child,107854,110464,2610,Germany,G22,m,11,1,a
mother,110334,113154,2820,Germany,G22,c,11,2,q
child,111864,112824,960,Germany,G22,m,11,3,a
child,113444,113974,530,Germany,G22,m,11,4,a
mother,113904,114944,1040,Germany,G22,c,11,5,a
father,115044,115994,950,Germany,G22,b,12,1,a
mother,117094,118014,920,Germany,G22,f,12,2,a
father,124134,124724,590,Germany,G22,b,13,1,a
child,124584,126904,2320,Germany,G22,m,14,1,a
child,130044,130844,800,Germany,G22,m,14,2,a
mother,131394,131974,580,Germany,G22,c,14,3,a
child,132014,132814,800,Germany,G22,m,14,4,a
mother,132794,134884,2090,Germany,G22,c,14,5,a
child,135124,135584,460,Germany,G22,m,14,6,a
mother,135634,136954,1320,Germany,G22,c,14,7,a
mother,127904,129174,1270,Germany,G22,f,15,1,a
mother,137694,139154,1460,Germany,G22,f,16,1,q
father,139144,139564,420,Germany,G22,m,16,2,a
child,141824,142634,810,Germany,G22,m,17,1,a
mother,142604,143204,600,Germany,G22,c,17,2,q
child,143214,144374,1160,Germany,G22,m,17,3,q
mother,144594,146334,1740,Germany,G22,c,17,4,q
mother,147024,148884,1860,Germany,G22,f,18,1,a
child,151294,154154,2860,Germany,G22,m,19,1,a
mother,155624,156214,590,Germany,G22,c,19,2,q
child,156404,157564,1160,Germany,G22,m,19,3,a
child,160694,164884,4190,Germany,G22,m,19,4,a
mother,166444,171064,4620,Germany,G22,c,19,5,a
child,171424,171994,570,Germany,G22,m,19,6,a
mother,172764,173344,580,Germany,G22,c,19,7,a
child,173974,175074,1100,Germany,G22,b,19,8,q
father,177854,178524,670,Germany,G22,c,19,9,q
mother,178094,183724,5630,Germany,G22,c,19,10,q
child,184104,184654,550,Germany,G22,m,19,11,a
child,186424,187504,1080,Germany,G22,b,19,12,a
father,187404,188204,800,Germany,G22,c,19,13,a
father,157574,159564,1990,Germany,G22,m,20,1,a
mother,173494,174814,1320,Germany,G22,c,20,2,q
mother,186244,188584,2340,Germany,G22,c,21,1,q
child,188954,191394,2440,Germany,G22,m,21,2,a
child,196734,197884,1150,Germany,G22,m,21,3,a
child,200034,200804,770,Germany,G22,b,22,1,q
father,200584,201874,1290,Germany,G22,c,22,2,a
mother,201394,202124,730,Germany,G22,c,22,3,a
child,202694,205304,2610,Germany,G22,b,22,4,a
child,209304,212624,3320,Germany,G22,b,22,5,a
child,218774,219794,1020,Germany,G22,b,22,6,a
mother,219034,220904,1870,Germany,G22,c,22,7,q
child,220934,222424,1490,Germany,G22,m,22,8,a
mother,222764,223814,1050,Germany,G22,c,22,9,q
child,224034,225164,1130,Germany,G22,m,22,10,a
mother,225224,226394,1170,Germany,G22,c,22,11,q
child,227134,229554,2420,Germany,G22,m,22,12,a
mother,229654,232804,3150,Germany,G22,c,22,13,a
mother,234724,245264,10540,Germany,G22,c,22,14,q
child,245304,245704,400,Germany,G22,m,22,15,a
mother,245714,246354,640,Germany,G22,c,22,16,a
child,246364,246944,580,Germany,G22,m,22,17,a
mother,246944,249824,2880,Germany,G22,c,22,18,a
father,248934,250444,1510,Germany,G22,c,22,19,a
mother,250354,253604,3250,Germany,G22,c,22,20,q
child,253784,254574,790,Germany,G22,m,22,21,a
mother,254474,260584,6110,Germany,G22,c,22,22,q
child,261414,262114,700,Germany,G22,m,22,23,a
mother,262104,263024,920,Germany,G22,c,22,24,q
child,263124,264064,940,Germany,G22,m,22,25,a
mother,264064,264794,730,Germany,G22,c,22,26,q
child,264854,265404,550,Germany,G22,m,22,27,a
mother,265664,269474,3810,Germany,G22,c,22,28,a
child,269914,271054,1140,Germany,G22,m,22,29,q
mother,272994,285084,12090,Germany,G22,c,22,30,q
child,286344,286934,590,Germany,G22,m,22,31,a
mother,287034,292004,4970,Germany,G22,c,22,32,a
mother,294934,301314,6380,Germany,G22,c,22,33,a
child,301344,301914,570,Germany,G22,m,22,34,a
mother,301894,302684,790,Germany,G22,c,22,35,a
child,304674,305354,680,Germany,G22,m,22,36,a
mother,305214,305794,580,Germany,G22,c,22,37,a
child,307674,308274,600,Germany,G22,m,22,38,a
mother,308444,315164,6720,Germany,G22,c,22,39,a
father,311524,312194,670,Germany,G22,b,22,40,a
child,315094,316434,1340,Germany,G22,m,22,41,a
mother,316464,323464,7000,Germany,G22,c,22,42,a
child,321054,323744,2690,Germany,G22,m,22,43,a
mother,323754,328684,4930,Germany,G22,c,22,44,a
father,323754,325414,1660,Germany,G22,m,22,45,a
child,328084,328904,820,Germany,G22,m,22,46,a
mother,330754,336584,5830,Germany,G22,c,22,47,a
child,330894,331414,520,Germany,G22,m,22,48,a
child,336024,337594,1570,Germany,G22,m,22,49,a
father,202544,203434,890,Germany,G22,m,23,1,q
father,207814,208434,620,Germany,G22,m,23,2,q
mother,210694,212504,1810,Germany,G22,f,23,3,a
father,212774,213554,780,Germany,G22,m,23,4,a
father,231234,233114,1880,Germany,G22,f,24,1,a
child,348544,350654,2110,Germany,G22,b,25,1,a
mother,350434,351624,1190,Germany,G22,f,26,1,q
father,351874,352404,530,Germany,G22,m,26,2,a
mother,352934,353364,430,Germany,G22,f,26,3,q
father,353114,353974,860,Germany,G22,m,26,4,a
mother,354914,355784,870,Germany,G22,f,26,5,q
father,355544,364754,9210,Germany,G22,m,26,6,a
mother,360434,361074,640,Germany,G22,f,26,7,a
mother,365744,370874,5130,Germany,G22,f,26,8,q
father,370244,376254,6010,Germany,G22,m,26,9,a
mother,372544,373194,650,Germany,G22,f,26,10,a
mother,376484,377964,1480,Germany,G22,f,26,11,q
father,380194,383654,3460,Germany,G22,m,26,12,a
mother,383574,385594,2020,Germany,G22,f,26,13,q
father,386094,387164,1070,Germany,G22,m,26,14,a
mother,388274,392114,3840,Germany,G22,f,26,15,a
father,388764,389514,750,Germany,G22,m,26,16,a
father,392814,395444,2630,Germany,G22,m,26,17,a
mother,396954,397664,710,Germany,G22,f,26,18,q
father,397534,400234,2700,Germany,G22,m,26,19,a
mother,400944,402344,1400,Germany,G22,f,26,20,a
child,360384,361174,790,Germany,G22,b,27,1,a
child,377464,378074,610,Germany,G22,b,28,1,a
child,401704,402364,660,Germany,G22,b,29,1,a
mother,407894,414134,6240,Germany,G22,f,30,1,a
mother,419554,423494,3940,Germany,G22,f,30,2,a
father,421634,423754,2120,Germany,G22,m,30,3,a
father,426774,431814,5040,Germany,G22,m,30,4,a
mother,435504,439734,4230,Germany,G22,c,31,1,i
father,440164,443164,3000,Germany,G22,c,31,2,a
mother,440674,452284,11610,Germany,G22,c,31,3,i
child,452544,453354,810,Germany,G22,m,31,4,a
mother,453654,455714,2060,Germany,G22,c,31,5,i
child,456524,460834,4310,Germany,G22,m,31,6,a
mother,461574,463004,1430,Germany,G22,c,31,7,a
child,463954,464674,720,Germany,G22,m,31,8,a
mother,464634,470674,6040,Germany,G22,c,31,9,a
child,470514,471424,910,Germany,G22,m,31,10,a
mother,471514,479414,7900,Germany,G22,c,31,11,a
child,479184,479754,570,Germany,G22,m,31,12,a
mother,480504,489784,9280,Germany,G22,c,31,13,i
child,489274,489994,720,Germany,G22,m,31,14,a
child,492104,492844,740,Germany,G22,m,31,15,a
father,455624,457964,2340,Germany,G22,m,32,1,a
mother,457854,459854,2000,Germany,G22,f,32,2,a
father,492394,497404,5010,Germany,G22,c,33,1,a
child,496684,497394,710,Germany,G22,f,33,2,a
mother,497334,501494,4160,Germany,G22,f,33,3,a
father,499584,501914,2330,Germany,G22,m,33,4,a
father,505814,507264,1450,Germany,G22,c,34,1,a
mother,510254,515164,4910,Germany,G22,c,34,2,a
child,514144,515754,1610,Germany,G22,m,34,3,a
mother,516414,524144,7730,Germany,G22,c,34,4,a
child,522014,522524,510,Germany,G22,m,34,5,a
father,511734,512274,540,Germany,G22,o,35,1,a
father,523544,524174,630,Germany,G22,o,36,1,a
child,533174,534624,1450,Germany,G22,m,37,1,a
mother,534764,536014,1250,Germany,G22,c,37,2,q
child,536754,538504,1750,Germany,G22,m,37,3,a
child,548144,549004,860,Germany,G22,m,37,4,q
mother,548884,550534,1650,Germany,G22,c,37,5,a
child,549994,553174,3180,Germany,G22,m,37,6,q
mother,553134,553884,750,Germany,G22,c,37,7,a
child,554374,554934,560,Germany,G22,m,37,8,a
child,558974,560404,1430,Germany,G22,b,37,9,q
mother,560684,563014,2330,Germany,G22,c,37,10,a
child,563314,563784,470,Germany,G22,m,37,11,a
mother,564064,568314,4250,Germany,G22,c,37,12,a
child,571734,576494,4760,Germany,G22,m,37,13,a
father,566774,571184,4410,Germany,G22,m,38,1,a
father,573374,576444,3070,Germany,G22,m,38,2,a
mother,576254,595294,19040,Germany,G22,f,39,1,a
father,578974,579624,650,Germany,G22,m,39,2,a
father,595084,596054,970,Germany,G22,m,39,3,a
father,597764,599894,2130,Germany,G22,m,39,4,a
child,582804,589244,6440,Germany,G22,b,40,1,a
child,593214,594474,1260,Germany,G22,b,40,2,a
child,596174,598324,2150,Germany,G22,b,40,3,a
silence,6354,6734,380,Germany,G22,NA,NA,NA,NA
silence,8344,9364,1020,Germany,G22,NA,NA,NA,NA
mother_gesture,10616,11594,978,Germany,G22,NA,NA,NA,NA
silence,10944,11064,120,Germany,G22,NA,NA,NA,NA
silence,11624,12284,660,Germany,G22,NA,NA,NA,NA
mother_gesture,12712,13185,473,Germany,G22,NA,NA,NA,NA
silence,13084,13874,790,Germany,G22,NA,NA,NA,NA
silence,18144,19154,1010,Germany,G22,NA,NA,NA,NA
silence,23124,23634,510,Germany,G22,NA,NA,NA,NA
mother_gesture,24005,25242,1237,Germany,G22,NA,NA,NA,NA
silence,24364,24794,430,Germany,G22,NA,NA,NA,NA
silence,25324,25524,200,Germany,G22,NA,NA,NA,NA
silence,31444,31984,540,Germany,G22,NA,NA,NA,NA
silence,46864,47584,720,Germany,G22,NA,NA,NA,NA
silence,49184,49224,40,Germany,G22,NA,NA,NA,NA
silence,51324,51444,120,Germany,G22,NA,NA,NA,NA
silence,52304,52374,70,Germany,G22,NA,NA,NA,NA
silence,54224,56554,2330,Germany,G22,NA,NA,NA,NA
silence,57334,57414,80,Germany,G22,NA,NA,NA,NA
silence,57954,58154,200,Germany,G22,NA,NA,NA,NA
silence,58814,59044,230,Germany,G22,NA,NA,NA,NA
silence,59844,60594,750,Germany,G22,NA,NA,NA,NA
silence,61604,62544,940,Germany,G22,NA,NA,NA,NA
silence,63014,63194,180,Germany,G22,NA,NA,NA,NA
father_gesture,64067,64903,836,Germany,G22,NA,NA,NA,NA
silence,65274,65534,260,Germany,G22,NA,NA,NA,NA
child_gesture,65918,66824,906,Germany,G22,NA,NA,NA,NA
silence,66594,67324,730,Germany,G22,NA,NA,NA,NA
silence,67724,69424,1700,Germany,G22,NA,NA,NA,NA
silence,75124,75424,300,Germany,G22,NA,NA,NA,NA
silence,76064,76514,450,Germany,G22,NA,NA,NA,NA
child_gesture,76809,77622,813,Germany,G22,NA,NA,NA,NA
father_gesture,77663,78365,702,Germany,G22,NA,NA,NA,NA
father_gesture,78389,79615,1226,Germany,G22,NA,NA,NA,NA
silence,79774,80234,460,Germany,G22,NA,NA,NA,NA
silence,85504,88954,3450,Germany,G22,NA,NA,NA,NA
silence,90714,91544,830,Germany,G22,NA,NA,NA,NA
father_gesture,96752,97277,525,Germany,G22,NA,NA,NA,NA
silence,101164,102324,1160,Germany,G22,NA,NA,NA,NA
silence,103194,103384,190,Germany,G22,NA,NA,NA,NA
silence,104134,104314,180,Germany,G22,NA,NA,NA,NA
silence,106364,107854,1490,Germany,G22,NA,NA,NA,NA
silence,113154,113444,290,Germany,G22,NA,NA,NA,NA
silence,114944,115044,100,Germany,G22,NA,NA,NA,NA
silence,115994,117094,1100,Germany,G22,NA,NA,NA,NA
silence,118014,124134,6120,Germany,G22,NA,NA,NA,NA
silence,126904,127904,1000,Germany,G22,NA,NA,NA,NA
silence,129174,130044,870,Germany,G22,NA,NA,NA,NA
silence,130844,131394,550,Germany,G22,NA,NA,NA,NA
silence,131974,132014,40,Germany,G22,NA,NA,NA,NA
silence,134884,135124,240,Germany,G22,NA,NA,NA,NA
silence,135584,135634,50,Germany,G22,NA,NA,NA,NA
silence,136954,137694,740,Germany,G22,NA,NA,NA,NA
mother_gesture,137903,138818,915,Germany,G22,NA,NA,NA,NA
silence,139564,141824,2260,Germany,G22,NA,NA,NA,NA
child_gesture,143101,144269,1168,Germany,G22,NA,NA,NA,NA
silence,143204,143214,10,Germany,G22,NA,NA,NA,NA
silence,144374,144594,220,Germany,G22,NA,NA,NA,NA
silence,146334,147024,690,Germany,G22,NA,NA,NA,NA
silence,148884,151294,2410,Germany,G22,NA,NA,NA,NA
silence,154154,155624,1470,Germany,G22,NA,NA,NA,NA
silence,156214,156404,190,Germany,G22,NA,NA,NA,NA
silence,157564,157574,10,Germany,G22,NA,NA,NA,NA
silence,159564,160694,1130,Germany,G22,NA,NA,NA,NA
child_gesture,162331,164199,1868,Germany,G22,NA,NA,NA,NA
silence,164884,166444,1560,Germany,G22,NA,NA,NA,NA
silence,171064,171424,360,Germany,G22,NA,NA,NA,NA
silence,171994,172764,770,Germany,G22,NA,NA,NA,NA
silence,173344,173494,150,Germany,G22,NA,NA,NA,NA
child_gesture,174251,175423,1172,Germany,G22,NA,NA,NA,NA
silence,175074,177854,2780,Germany,G22,NA,NA,NA,NA
silence,183724,184104,380,Germany,G22,NA,NA,NA,NA
silence,184654,186244,1590,Germany,G22,NA,NA,NA,NA
silence,188584,188954,370,Germany,G22,NA,NA,NA,NA
silence,191394,196734,5340,Germany,G22,NA,NA,NA,NA
silence,197884,200034,2150,Germany,G22,NA,NA,NA,NA
silence,202124,202544,420,Germany,G22,NA,NA,NA,NA
child_gesture,203077,205292,2215,Germany,G22,NA,NA,NA,NA
silence,205304,207814,2510,Germany,G22,NA,NA,NA,NA
silence,208434,209304,870,Germany,G22,NA,NA,NA,NA
child_gesture,209529,211444,1915,Germany,G22,NA,NA,NA,NA
silence,212624,212774,150,Germany,G22,NA,NA,NA,NA
silence,213554,218774,5220,Germany,G22,NA,NA,NA,NA
child_gesture,218970,219981,1011,Germany,G22,NA,NA,NA,NA
mother_gesture,219294,220455,1161,Germany,G22,NA,NA,NA,NA
silence,220904,220934,30,Germany,G22,NA,NA,NA,NA
silence,222424,222764,340,Germany,G22,NA,NA,NA,NA
silence,223814,224034,220,Germany,G22,NA,NA,NA,NA
silence,225164,225224,60,Germany,G22,NA,NA,NA,NA
silence,226394,227134,740,Germany,G22,NA,NA,NA,NA
silence,229554,229654,100,Germany,G22,NA,NA,NA,NA
silence,233114,234724,1610,Germany,G22,NA,NA,NA,NA
silence,245264,245304,40,Germany,G22,NA,NA,NA,NA
silence,245704,245714,10,Germany,G22,NA,NA,NA,NA
silence,246354,246364,10,Germany,G22,NA,NA,NA,NA
silence,253604,253784,180,Germany,G22,NA,NA,NA,NA
silence,260584,261414,830,Germany,G22,NA,NA,NA,NA
silence,263024,263124,100,Germany,G22,NA,NA,NA,NA
silence,264794,264854,60,Germany,G22,NA,NA,NA,NA
silence,265404,265664,260,Germany,G22,NA,NA,NA,NA
silence,269474,269914,440,Germany,G22,NA,NA,NA,NA
silence,271054,272994,1940,Germany,G22,NA,NA,NA,NA
silence,285084,286344,1260,Germany,G22,NA,NA,NA,NA
silence,286934,287034,100,Germany,G22,NA,NA,NA,NA
silence,292004,294934,2930,Germany,G22,NA,NA,NA,NA
silence,301314,301344,30,Germany,G22,NA,NA,NA,NA
silence,302684,304674,1990,Germany,G22,NA,NA,NA,NA
silence,305794,307674,1880,Germany,G22,NA,NA,NA,NA
silence,308274,308444,170,Germany,G22,NA,NA,NA,NA
mother_gesture,308760,309995,1235,Germany,G22,NA,NA,NA,NA
silence,316434,316464,30,Germany,G22,NA,NA,NA,NA
mother_gesture,322053,323086,1033,Germany,G22,NA,NA,NA,NA
silence,323744,323754,10,Germany,G22,NA,NA,NA,NA
mother_gesture,324442,327134,2692,Germany,G22,NA,NA,NA,NA
silence,328904,330754,1850,Germany,G22,NA,NA,NA,NA
mother_gesture,331568,332970,1402,Germany,G22,NA,NA,NA,NA
mother_gesture,333455,335056,1601,Germany,G22,NA,NA,NA,NA
child_gesture,336552,338151,1599,Germany,G22,NA,NA,NA,NA
silence,337594,348544,10950,Germany,G22,NA,NA,NA,NA
silence,351624,351874,250,Germany,G22,NA,NA,NA,NA
silence,352404,352934,530,Germany,G22,NA,NA,NA,NA
silence,353974,354914,940,Germany,G22,NA,NA,NA,NA
silence,364754,365744,990,Germany,G22,NA,NA,NA,NA
silence,376254,376484,230,Germany,G22,NA,NA,NA,NA
silence,378074,380194,2120,Germany,G22,NA,NA,NA,NA
father_gesture,383081,384603,1522,Germany,G22,NA,NA,NA,NA
silence,385594,386094,500,Germany,G22,NA,NA,NA,NA
silence,387164,388274,1110,Germany,G22,NA,NA,NA,NA
silence,392114,392814,700,Germany,G22,NA,NA,NA,NA
silence,395444,396954,1510,Germany,G22,NA,NA,NA,NA
silence,400234,400944,710,Germany,G22,NA,NA,NA,NA
silence,402364,407894,5530,Germany,G22,NA,NA,NA,NA
silence,414134,419554,5420,Germany,G22,NA,NA,NA,NA
silence,423754,426774,3020,Germany,G22,NA,NA,NA,NA
silence,431814,435504,3690,Germany,G22,NA,NA,NA,NA
silence,439734,440164,430,Germany,G22,NA,NA,NA,NA
silence,452284,452544,260,Germany,G22,NA,NA,NA,NA
silence,453354,453654,300,Germany,G22,NA,NA,NA,NA
silence,460834,461574,740,Germany,G22,NA,NA,NA,NA
mother_gesture,462157,464866,2709,Germany,G22,NA,NA,NA,NA
silence,463004,463954,950,Germany,G22,NA,NA,NA,NA
mother_gesture,469439,470529,1090,Germany,G22,NA,NA,NA,NA
silence,471424,471514,90,Germany,G22,NA,NA,NA,NA
mother_gesture,476836,478002,1166,Germany,G22,NA,NA,NA,NA
silence,479754,480504,750,Germany,G22,NA,NA,NA,NA
mother_gesture,480974,482054,1080,Germany,G22,NA,NA,NA,NA
mother_gesture,482124,483514,1390,Germany,G22,NA,NA,NA,NA
mother_gesture,488944,489811,867,Germany,G22,NA,NA,NA,NA
silence,489994,492104,2110,Germany,G22,NA,NA,NA,NA
silence,501914,505814,3900,Germany,G22,NA,NA,NA,NA
silence,507264,510254,2990,Germany,G22,NA,NA,NA,NA
mother_gesture,511257,513715,2458,Germany,G22,NA,NA,NA,NA
silence,515754,516414,660,Germany,G22,NA,NA,NA,NA
mother_gesture,516595,520596,4001,Germany,G22,NA,NA,NA,NA
mother_gesture,522119,523520,1401,Germany,G22,NA,NA,NA,NA
silence,524174,533174,9000,Germany,G22,NA,NA,NA,NA
silence,534624,534764,140,Germany,G22,NA,NA,NA,NA
silence,536014,536754,740,Germany,G22,NA,NA,NA,NA
silence,538504,548144,9640,Germany,G22,NA,NA,NA,NA
child_gesture,552248,553392,1144,Germany,G22,NA,NA,NA,NA
silence,553884,554374,490,Germany,G22,NA,NA,NA,NA
silence,554934,558974,4040,Germany,G22,NA,NA,NA,NA
silence,560404,560684,280,Germany,G22,NA,NA,NA,NA
silence,563014,563314,300,Germany,G22,NA,NA,NA,NA
silence,563784,564064,280,Germany,G22,NA,NA,NA,NA
mother_gesture,564487,565527,1040,Germany,G22,NA,NA,NA,NA
silence,571184,571734,550,Germany,G22,NA,NA,NA,NA
silence,596054,596174,120,Germany,G22,NA,NA,NA,NA
silence,599894,599964,70,Germany,G22,NA,NA,NA,NA
child,3925,5114,1189,Germany,G23,m,1,1,a
mother,6697,10428,3731,Germany,G23,c,1,2,a
child,10087,13627,3540,Germany,G23,b,1,3,a
father,18577,19621,1044,Germany,G23,c,1,4,a
child,20100,26397,6297,Germany,G23,b,1,5,a
mother,29495,31323,1828,Germany,G23,c,1,6,q
child,32250,33673,1423,Germany,G23,m,1,7,a
father,33312,36064,2752,Germany,G23,c,1,8,a
father,5523,8401,2878,Germany,G23,o,2,1,a
father,10639,12489,1850,Germany,G23,m,3,1,q
mother,12826,13428,602,Germany,G23,f,3,2,a
mother,35471,37219,1748,Germany,G23,f,4,1,a
father,37391,42188,4797,Germany,G23,m,4,2,a
mother,39593,41286,1693,Germany,G23,f,4,3,a
mother,43066,43894,828,Germany,G23,f,4,4,a
child,42599,45489,2890,Germany,G23,m,5,1,a
mother,45667,47556,1889,Germany,G23,c,5,2,q
child,47556,48317,761,Germany,G23,m,5,3,a
child,48771,50059,1288,Germany,G23,m,6,1,a
mother,49501,50869,1368,Germany,G23,c,6,2,a
father,49506,51515,2009,Germany,G23,c,6,3,i
child,51673,53194,1521,Germany,G23,f,6,4,a
father,53692,54170,478,Germany,G23,c,6,5,a
child,54495,55845,1350,Germany,G23,f,6,6,i
father,57020,59253,2233,Germany,G23,c,6,7,a
child,60421,62839,2418,Germany,G23,f,6,8,a
father,59326,61132,1806,Germany,G23,m,7,1,q
mother,62593,64986,2393,Germany,G23,f,7,2,a
father,65586,67719,2133,Germany,G23,m,7,3,a
child,79513,82397,2884,Germany,G23,f,8,1,a
mother,79587,81802,2215,Germany,G23,f,9,1,q
father,83347,84090,743,Germany,G23,m,9,2,a
mother,85017,87875,2858,Germany,G23,f,9,3,a
father,87967,89471,1504,Germany,G23,m,9,4,a
mother,99391,102753,3362,Germany,G23,f,9,5,a
father,103453,107276,3823,Germany,G23,m,9,6,a
child,105035,105925,890,Germany,G23,b,10,1,a
mother,106728,108397,1669,Germany,G23,f,11,1,q
father,108446,111058,2612,Germany,G23,m,11,2,a
father,111652,116514,4862,Germany,G23,m,12,1,a
father,119037,125860,6823,Germany,G23,m,12,2,a
father,127400,129020,1620,Germany,G23,m,12,3,a
father,132586,134905,2319,Germany,G23,m,12,4,q
mother,140673,143624,2951,Germany,G23,f,12,5,q
father,143015,155418,12403,Germany,G23,m,12,6,a
father,156290,160490,4200,Germany,G23,m,12,7,a
father,116655,117536,881,Germany,G23,c,13,1,i
child,122888,126771,3883,Germany,G23,f,14,1,a
mother,125759,127348,1589,Germany,G23,c,14,2,a
child,127826,134059,6233,Germany,G23,m,14,3,a
child,143464,145581,2117,Germany,G23,m,14,4,a
mother,145311,146704,1393,Germany,G23,c,14,5,a
child,155802,159090,3288,Germany,G23,m,14,6,a
mother,158483,163802,5319,Germany,G23,c,14,7,a
child,173851,176305,2454,Germany,G23,m,14,8,a
child,184360,185599,1239,Germany,G23,m,14,9,a
mother,170790,175078,4288,Germany,G23,c,15,1,a
father,176190,180240,4050,Germany,G23,m,16,1,q
mother,180201,180740,539,Germany,G23,f,16,2,a
mother,184385,185317,932,Germany,G23,f,16,3,a
father,186790,187990,1200,Germany,G23,m,16,4,q
mother,189814,193949,4135,Germany,G23,f,16,5,a
father,194865,197065,2200,Germany,G23,m,16,6,q
mother,197513,198133,620,Germany,G23,f,16,7,a
father,199665,204390,4725,Germany,G23,m,16,8,a
mother,206710,211348,4638,Germany,G23,f,16,9,a
father,209240,213115,3875,Germany,G23,m,16,10,a
mother,199004,200262,1258,Germany,G23,f,17,1,a
child,201869,203299,1430,Germany,G23,b,18,1,a
child,209967,213023,3056,Germany,G23,m,18,2,i
mother,212176,213740,1564,Germany,G23,c,18,3,i
child,220066,221323,1257,Germany,G23,m,19,1,a
mother,221139,223667,2528,Germany,G23,c,19,2,a
child,228262,239145,10883,Germany,G23,b,20,1,a
mother,229931,232305,2374,Germany,G23,f,21,1,a
father,233640,235915,2275,Germany,G23,m,21,2,a
mother,240980,242961,1981,Germany,G23,f,21,3,a
father,244560,247627,3067,Germany,G23,m,21,4,q
child,244477,248875,4398,Germany,G23,b,22,1,a
mother,249900,251458,1558,Germany,G23,f,23,1,a
father,252790,254317,1527,Germany,G23,m,23,2,q
mother,254293,254704,411,Germany,G23,f,23,3,a
mother,256133,257323,1190,Germany,G23,c,23,4,q
child,259059,261937,2878,Germany,G23,m,23,5,a
mother,262354,262949,595,Germany,G23,c,23,6,q
father,259235,267668,8433,Germany,G23,m,24,1,a
mother,265685,266145,460,Germany,G23,f,24,2,a
mother,268679,271630,2951,Germany,G23,f,24,3,a
father,271303,288438,17135,Germany,G23,m,24,4,a
mother,289317,290618,1301,Germany,G23,c,25,1,q
mother,292777,296538,3761,Germany,G23,c,26,1,a
father,297276,298762,1486,Germany,G23,c,26,2,a
father,305600,307114,1514,Germany,G23,c,26,3,i
mother,310053,311937,1884,Germany,G23,f,27,1,q
father,312046,312735,689,Germany,G23,m,27,2,a
father,317938,330708,12770,Germany,G23,m,27,3,a
child,313170,315170,2000,Germany,G23,b,28,1,a
mother,331415,332053,638,Germany,G23,c,29,1,q
mother,336029,337268,1239,Germany,G23,c,29,2,i
child,338317,339127,810,Germany,G23,m,29,3,a
child,341765,342642,877,Germany,G23,m,29,4,a
father,358290,360614,2324,Germany,G23,m,30,1,a
father,372276,373006,730,Germany,G23,m,31,1,a
child,375974,379501,3527,Germany,G23,b,32,1,a
mother,380458,381722,1264,Germany,G23,c,33,1,q
child,382164,382679,515,Germany,G23,m,33,2,a
father,382627,384560,1933,Germany,G23,m,33,3,a
mother,385078,386556,1478,Germany,G23,f,33,4,q
father,386681,389006,2325,Germany,G23,m,33,5,a
mother,388348,392152,3804,Germany,G23,f,33,6,a
father,391276,392790,1514,Germany,G23,m,33,7,i
child,392753,397691,4938,Germany,G23,m,33,8,a
mother,397673,400287,2614,Germany,G23,c,33,9,a
father,413641,414992,1351,Germany,G23,m,34,1,a
mother,414158,415391,1233,Germany,G23,f,34,2,q
father,415249,415857,608,Germany,G23,m,34,3,a
child,415875,416489,614,Germany,G23,m,34,4,a
child,418869,422060,3191,Germany,G23,m,35,1,a
father,425127,427060,1933,Germany,G23,m,36,1,q
mother,426826,427360,534,Germany,G23,f,36,2,a
father,428627,429722,1095,Germany,G23,m,36,3,a
mother,431078,432434,1356,Germany,G23,c,37,1,a
mother,444434,447152,2718,Germany,G23,f,38,1,a
father,447600,449790,2190,Germany,G23,m,38,2,a
father,452398,455708,3310,Germany,G23,m,38,3,a
child,450434,452912,2478,Germany,G23,m,39,1,a
mother,452888,454072,1184,Germany,G23,c,39,2,q
child,454507,456875,2368,Germany,G23,m,39,3,a
mother,456428,457372,944,Germany,G23,c,39,4,a
child,457925,459513,1588,Germany,G23,m,39,5,a
mother,458612,463513,4901,Germany,G23,c,39,6,a
child,469974,472115,2141,Germany,G23,m,39,7,a
mother,471477,473882,2405,Germany,G23,c,39,8,a
father,461127,462573,1446,Germany,G23,m,40,1,q
mother,465268,465740,472,Germany,G23,f,40,2,a
mother,480673,491391,10718,Germany,G23,c,41,1,a
father,491668,493195,1527,Germany,G23,c,41,2,a
child,493213,493918,705,Germany,G23,b,41,3,a
mother,495053,498162,3109,Germany,G23,c,41,4,q
child,497078,498894,1816,Germany,G23,m,41,5,a
mother,498888,500102,1214,Germany,G23,c,41,6,q
father,502235,503465,1230,Germany,G23,c,41,7,q
child,503986,505446,1460,Germany,G23,m,41,8,a
mother,504820,506188,1368,Germany,G23,c,41,9,q
child,506316,506716,400,Germany,G23,m,41,10,a
child,514385,522139,7754,Germany,G23,m,42,1,a
mother,522808,525152,2344,Germany,G23,c,42,2,q
child,526808,533219,6411,Germany,G23,m,42,3,a
mother,533078,534274,1196,Germany,G23,c,42,4,q
child,535139,537630,2491,Germany,G23,m,42,5,a
mother,538262,541501,3239,Germany,G23,c,42,6,q
child,541495,542336,841,Germany,G23,m,42,7,a
mother,542796,544072,1276,Germany,G23,c,42,8,q
child,544311,545041,730,Germany,G23,m,42,9,a
child,550066,552630,2564,Germany,G23,m,42,10,a
mother,552655,554274,1619,Germany,G23,c,42,11,q
child,554360,554967,607,Germany,G23,m,42,12,a
mother,555323,556115,792,Germany,G23,c,42,13,q
child,557575,558894,1319,Germany,G23,m,42,14,a
mother,559109,559839,730,Germany,G23,c,42,15,q
child,561360,563869,2509,Germany,G23,m,42,16,a
mother,563839,566127,2288,Germany,G23,c,42,17,q
child,566556,570606,4050,Germany,G23,m,42,18,a
mother,570526,572152,1626,Germany,G23,c,42,19,a
child,572900,574967,2067,Germany,G23,m,42,20,a
mother,574569,578514,3945,Germany,G23,c,42,21,a
father,528181,530871,2690,Germany,G23,m,43,1,a
father,534303,535154,851,Germany,G23,m,43,2,a
mother,535698,536201,503,Germany,G23,f,43,3,a
father,581222,583357,2135,Germany,G23,o,44,1,a
father,590344,591208,864,Germany,G23,o,44,2,a
mother,592544,594201,1657,Germany,G23,f,45,1,a
father,594749,595965,1216,Germany,G23,m,45,2,a
silence,5114,5523,409,Germany,G23,NA,NA,NA,NA
silence,13627,18577,4950,Germany,G23,NA,NA,NA,NA
silence,19621,20100,479,Germany,G23,NA,NA,NA,NA
silence,26397,29495,3098,Germany,G23,NA,NA,NA,NA
silence,31323,32250,927,Germany,G23,NA,NA,NA,NA
silence,37219,37391,172,Germany,G23,NA,NA,NA,NA
silence,42188,42599,411,Germany,G23,NA,NA,NA,NA
child_gesture,42845,44645,1800,Germany,G23,NA,NA,NA,NA
silence,45489,45667,178,Germany,G23,NA,NA,NA,NA
silence,48317,48771,454,Germany,G23,NA,NA,NA,NA
silence,51515,51673,158,Germany,G23,NA,NA,NA,NA
silence,53194,53692,498,Germany,G23,NA,NA,NA,NA
silence,54170,54495,325,Germany,G23,NA,NA,NA,NA
silence,55845,57020,1175,Germany,G23,NA,NA,NA,NA
silence,59253,59326,73,Germany,G23,NA,NA,NA,NA
silence,64986,65586,600,Germany,G23,NA,NA,NA,NA
silence,67719,79513,11794,Germany,G23,NA,NA,NA,NA
child_gesture,81273,82257,984,Germany,G23,NA,NA,NA,NA
silence,82397,83347,950,Germany,G23,NA,NA,NA,NA
silence,84090,85017,927,Germany,G23,NA,NA,NA,NA
silence,87875,87967,92,Germany,G23,NA,NA,NA,NA
silence,89471,99391,9920,Germany,G23,NA,NA,NA,NA
silence,102753,103453,700,Germany,G23,NA,NA,NA,NA
silence,108397,108446,49,Germany,G23,NA,NA,NA,NA
silence,111058,111652,594,Germany,G23,NA,NA,NA,NA
silence,116514,116655,141,Germany,G23,NA,NA,NA,NA
silence,117536,119037,1501,Germany,G23,NA,NA,NA,NA
silence,127348,127400,52,Germany,G23,NA,NA,NA,NA
silence,134905,140673,5768,Germany,G23,NA,NA,NA,NA
silence,155418,155802,384,Germany,G23,NA,NA,NA,NA
silence,163802,170790,6988,Germany,G23,NA,NA,NA,NA
silence,180740,184360,3620,Germany,G23,NA,NA,NA,NA
silence,185599,186790,1191,Germany,G23,NA,NA,NA,NA
silence,187990,189814,1824,Germany,G23,NA,NA,NA,NA
silence,193949,194865,916,Germany,G23,NA,NA,NA,NA
silence,197065,197513,448,Germany,G23,NA,NA,NA,NA
silence,198133,199004,871,Germany,G23,NA,NA,NA,NA
silence,204390,206710,2320,Germany,G23,NA,NA,NA,NA
silence,213740,220066,6326,Germany,G23,NA,NA,NA,NA
silence,223667,228262,4595,Germany,G23,NA,NA,NA,NA
silence,239145,240980,1835,Germany,G23,NA,NA,NA,NA
silence,242961,244477,1516,Germany,G23,NA,NA,NA,NA
silence,248875,249900,1025,Germany,G23,NA,NA,NA,NA
silence,251458,252790,1332,Germany,G23,NA,NA,NA,NA
silence,254704,256133,1429,Germany,G23,NA,NA,NA,NA
silence,257323,259059,1736,Germany,G23,NA,NA,NA,NA
silence,267668,268679,1011,Germany,G23,NA,NA,NA,NA
silence,288438,289317,879,Germany,G23,NA,NA,NA,NA
silence,290618,292777,2159,Germany,G23,NA,NA,NA,NA
silence,296538,297276,738,Germany,G23,NA,NA,NA,NA
silence,298762,305600,6838,Germany,G23,NA,NA,NA,NA
silence,307114,310053,2939,Germany,G23,NA,NA,NA,NA
silence,311937,312046,109,Germany,G23,NA,NA,NA,NA
silence,312735,313170,435,Germany,G23,NA,NA,NA,NA
silence,315170,317938,2768,Germany,G23,NA,NA,NA,NA
father_gesture,329551,330526,975,Germany,G23,NA,NA,NA,NA
silence,330708,331415,707,Germany,G23,NA,NA,NA,NA
silence,332053,336029,3976,Germany,G23,NA,NA,NA,NA
silence,337268,338317,1049,Germany,G23,NA,NA,NA,NA
silence,339127,341765,2638,Germany,G23,NA,NA,NA,NA
silence,342642,358290,15648,Germany,G23,NA,NA,NA,NA
silence,360614,372276,11662,Germany,G23,NA,NA,NA,NA
silence,373006,375974,2968,Germany,G23,NA,NA,NA,NA
silence,379501,380458,957,Germany,G23,NA,NA,NA,NA
silence,381722,382164,442,Germany,G23,NA,NA,NA,NA
silence,384560,385078,518,Germany,G23,NA,NA,NA,NA
father_gesture,384852,385918,1066,Germany,G23,NA,NA,NA,NA
silence,386556,386681,125,Germany,G23,NA,NA,NA,NA
child_gesture,392994,399407,6413,Germany,G23,NA,NA,NA,NA
silence,400287,413641,13354,Germany,G23,NA,NA,NA,NA
father_gesture,413897,414788,891,Germany,G23,NA,NA,NA,NA
silence,415857,415875,18,Germany,G23,NA,NA,NA,NA
silence,416489,418869,2380,Germany,G23,NA,NA,NA,NA
silence,422060,425127,3067,Germany,G23,NA,NA,NA,NA
silence,427360,428627,1267,Germany,G23,NA,NA,NA,NA
silence,429722,431078,1356,Germany,G23,NA,NA,NA,NA
silence,432434,444434,12000,Germany,G23,NA,NA,NA,NA
silence,447152,447600,448,Germany,G23,NA,NA,NA,NA
silence,449790,450434,644,Germany,G23,NA,NA,NA,NA
child_gesture,450799,452946,2147,Germany,G23,NA,NA,NA,NA
child_gesture,455071,456742,1671,Germany,G23,NA,NA,NA,NA
silence,457372,457925,553,Germany,G23,NA,NA,NA,NA
silence,463513,465268,1755,Germany,G23,NA,NA,NA,NA
silence,465740,469974,4234,Germany,G23,NA,NA,NA,NA
child_gesture,470394,472968,2574,Germany,G23,NA,NA,NA,NA
mother_gesture,472300,473110,810,Germany,G23,NA,NA,NA,NA
silence,473882,480673,6791,Germany,G23,NA,NA,NA,NA
silence,491391,491668,277,Germany,G23,NA,NA,NA,NA
silence,493195,493213,18,Germany,G23,NA,NA,NA,NA
silence,493918,495053,1135,Germany,G23,NA,NA,NA,NA
silence,500102,502235,2133,Germany,G23,NA,NA,NA,NA
silence,503465,503986,521,Germany,G23,NA,NA,NA,NA
silence,506188,506316,128,Germany,G23,NA,NA,NA,NA
silence,506716,514385,7669,Germany,G23,NA,NA,NA,NA
silence,522139,522808,669,Germany,G23,NA,NA,NA,NA
silence,525152,526808,1656,Germany,G23,NA,NA,NA,NA
silence,534274,534303,29,Germany,G23,NA,NA,NA,NA
child_gesture,535192,538259,3067,Germany,G23,NA,NA,NA,NA
silence,537630,538262,632,Germany,G23,NA,NA,NA,NA
silence,542336,542796,460,Germany,G23,NA,NA,NA,NA
silence,544072,544311,239,Germany,G23,NA,NA,NA,NA
silence,545041,550066,5025,Germany,G23,NA,NA,NA,NA
silence,552630,552655,25,Germany,G23,NA,NA,NA,NA
silence,554274,554360,86,Germany,G23,NA,NA,NA,NA
silence,554967,555323,356,Germany,G23,NA,NA,NA,NA
silence,556115,557575,1460,Germany,G23,NA,NA,NA,NA
silence,558894,559109,215,Germany,G23,NA,NA,NA,NA
silence,559839,561360,1521,Germany,G23,NA,NA,NA,NA
silence,566127,566556,429,Germany,G23,NA,NA,NA,NA
silence,572152,572900,748,Germany,G23,NA,NA,NA,NA
silence,578514,581222,2708,Germany,G23,NA,NA,NA,NA
silence,583357,590344,6987,Germany,G23,NA,NA,NA,NA
silence,591208,592544,1336,Germany,G23,NA,NA,NA,NA
silence,594201,594749,548,Germany,G23,NA,NA,NA,NA
mother,1748,3690,1942,Germany,G24,c,1,1,q
child,4181,5580,1399,Germany,G24,m,1,2,a
mother,5616,6327,711,Germany,G24,c,1,3,a
mother,7000,9616,2616,Germany,G24,c,2,1,a
mother,11674,12469,795,Germany,G24,c,2,2,i
father,11995,13042,1047,Germany,G24,m,2,3,i
child,13708,14440,732,Germany,G24,NA,2,4,NA
mother,15700,16295,595,Germany,G24,c,2,5,q
father,17811,18584,773,Germany,G24,c,2,6,q
father,20953,21579,626,Germany,G24,c,2,7,q
child,22693,24135,1442,Germany,G24,m,2,8,a
child,27519,28574,1055,Germany,G24,m,2,9,a
mother,31353,35584,4231,Germany,G24,b,3,1,a
mother,36106,42463,6357,Germany,G24,c,4,1,q
father,53527,55627,2100,Germany,G24,c,5,1,a
child,56809,57740,931,Germany,G24,f,5,2,a
father,57532,58632,1100,Germany,G24,c,5,3,q
child,58664,59816,1152,Germany,G24,f,5,4,a
father,60748,61969,1221,Germany,G24,c,5,5,q
child,63933,64540,607,Germany,G24,f,5,6,a
father,64716,68500,3784,Germany,G24,c,5,7,a
mother,71132,73227,2095,Germany,G24,c,6,1,a
mother,77863,83563,5700,Germany,G24,f,7,1,a
mother,86384,88821,2437,Germany,G24,c,7,2,q
father,86779,90684,3905,Germany,G24,c,8,1,i
mother,90648,94032,3384,Germany,G24,c,8,2,a
father,101648,102532,884,Germany,G24,m,9,1,q
father,104611,105227,616,Germany,G24,c,10,1,a
child,106250,107416,1166,Germany,G24,f,10,2,a
child,108009,108940,931,Germany,G24,b,10,3,a
father,109063,110021,958,Germany,G24,c,10,4,a
mother,109058,110690,1632,Germany,G24,f,11,1,q
father,110816,111616,800,Germany,G24,m,11,2,a
father,113574,114611,1037,Germany,G24,m,11,3,a
mother,115416,117300,1884,Germany,G24,c,12,1,q
father,117000,118811,1811,Germany,G24,m,12,2,a
mother,118174,118953,779,Germany,G24,f,12,3,a
mother,124000,125716,1716,Germany,G24,f,13,1,a
mother,130306,131790,1484,Germany,G24,f,14,1,q
father,137679,138742,1063,Germany,G24,c,15,1,q
child,138906,139843,937,Germany,G24,b,15,2,a
mother,138942,139837,895,Germany,G24,c,15,3,a
child,140457,141374,917,Germany,G24,m,15,4,a
mother,142795,143395,600,Germany,G24,c,15,5,q
child,143506,144064,558,Germany,G24,c,15,6,a
mother,144116,145869,1753,Germany,G24,c,16,1,q
child,146933,147616,683,Germany,G24,m,16,2,a
mother,147753,148148,395,Germany,G24,c,16,3,q
mother,155153,160163,5010,Germany,G24,c,17,1,q
child,158823,159250,427,Germany,G24,m,17,2,q
child,163237,163871,634,Germany,G24,b,17,3,a
mother,164037,164721,684,Germany,G24,c,17,4,q
father,167069,168669,1600,Germany,G24,c,18,1,q
child,170243,170968,725,Germany,G24,f,18,2,a
father,171311,171963,652,Germany,G24,c,18,3,q
child,172740,173561,821,Germany,G24,f,18,4,a
mother,174958,176511,1553,Germany,G24,c,19,1,q
mother,177806,179237,1431,Germany,G24,c,20,1,q
child,181168,182126,958,Germany,G24,m,20,2,a
mother,182227,183648,1421,Germany,G24,c,20,3,q
child,183637,184423,786,Germany,G24,c,20,4,q
mother,184069,185621,1552,Germany,G24,c,20,5,q
child,186140,186947,807,Germany,G24,c,20,6,a
mother,187727,188653,926,Germany,G24,c,20,7,q
mother,191421,192263,842,Germany,G24,c,20,8,a
mother,196490,200921,4431,Germany,G24,f,21,1,q
father,200279,201937,1658,Germany,G24,m,21,2,a
mother,201611,205074,3463,Germany,G24,f,21,3,q
child,215671,216692,1021,Germany,G24,b,22,1,a
father,217700,218642,942,Germany,G24,c,22,2,a
mother,220206,221779,1573,Germany,G24,c,22,3,q
father,222011,222606,595,Germany,G24,m,22,4,q
mother,223690,225000,1310,Germany,G24,f,22,5,a
mother,230484,235632,5148,Germany,G24,c,23,1,q
child,236609,237209,600,Germany,G24,b,23,2,a
mother,237611,242616,5005,Germany,G24,f,24,1,a
father,242674,243163,489,Germany,G24,m,24,2,a
mother,254063,258011,3948,Germany,G24,f,25,1,a
father,259063,260074,1011,Germany,G24,m,25,2,q
mother,259974,260527,553,Germany,G24,f,25,3,a
father,261021,261853,832,Germany,G24,m,25,4,q
mother,261974,265674,3700,Germany,G24,f,25,5,a
mother,270432,272306,1874,Germany,G24,f,25,6,a
father,273621,274884,1263,Germany,G24,m,25,7,q
mother,275321,279863,4542,Germany,G24,f,25,8,a
father,282948,284363,1415,Germany,G24,c,26,1,q
child,287119,287995,876,Germany,G24,f,26,2,a
father,288006,288527,521,Germany,G24,c,26,3,q
father,290063,290769,706,Germany,G24,c,26,4,q
child,291671,292388,717,Germany,G24,b,26,5,a
child,294581,295202,621,Germany,G24,b,27,1,a
mother,295221,296348,1127,Germany,G24,c,27,2,q
child,295506,296243,737,Germany,G24,f,27,3,a
mother,298763,300611,1848,Germany,G24,c,27,4,q
father,314800,315490,690,Germany,G24,c,28,1,a
father,319521,320353,832,Germany,G24,c,28,2,a
child,320885,322340,1455,Germany,G24,f,28,3,a
father,322737,323932,1195,Germany,G24,c,28,4,q
mother,323958,325337,1379,Germany,G24,c,28,5,q
child,325912,326802,890,Germany,G24,m,28,6,a
child,331264,333602,2338,Germany,G24,b,28,7,a
mother,333658,335511,1853,Germany,G24,c,28,8,a
child,338250,340781,2531,Germany,G24,m,28,9,a
mother,340169,342048,1879,Germany,G24,c,28,10,a
child,342830,344112,1282,Germany,G24,m,28,11,a
mother,343953,345053,1100,Germany,G24,c,28,12,q
child,345202,345906,704,Germany,G24,m,28,13,a
mother,347306,347690,384,Germany,G24,c,28,14,a
father,347237,348221,984,Germany,G24,c,29,1,q
mother,351284,352411,1127,Germany,G24,c,29,2,a
child,352623,353623,1000,Germany,G24,c,29,3,a
mother,353558,354916,1358,Germany,G24,c,29,4,q
child,355264,356071,807,Germany,G24,m,29,5,a
mother,356311,358737,2426,Germany,G24,c,29,6,a
father,358295,358779,484,Germany,G24,m,29,7,q
mother,358984,360163,1179,Germany,G24,f,29,8,a
father,360311,360742,431,Germany,G24,m,29,9,q
father,363769,364779,1010,Germany,G24,c,29,10,q
child,365561,366140,579,Germany,G24,f,29,11,a
child,369250,369954,704,Germany,G24,m,30,1,a
mother,374763,375611,848,Germany,G24,c,30,2,a
mother,379832,381121,1289,Germany,G24,c,30,3,q
child,381271,381947,676,Germany,G24,m,30,4,a
mother,382006,385569,3563,Germany,G24,c,30,5,a
mother,397100,397732,632,Germany,G24,c,30,6,a
father,413179,414337,1158,Germany,G24,m,31,1,q
mother,416032,416995,963,Germany,G24,c,32,1,q
child,417954,418678,724,Germany,G24,m,32,2,a
father,420406,421411,1005,Germany,G24,c,32,3,a
mother,421632,424048,2416,Germany,G24,f,33,1,q
mother,427800,429132,1332,Germany,G24,f,33,2,q
mother,430963,431521,558,Germany,G24,f,33,3,a
father,431137,433533,2396,Germany,G24,m,33,4,q
mother,433606,434595,989,Germany,G24,f,33,5,a
father,435148,436769,1621,Germany,G24,m,33,6,a
mother,436863,439474,2611,Germany,G24,f,33,7,a
father,441821,443679,1858,Germany,G24,m,33,8,a
mother,445874,457342,11468,Germany,G24,f,33,9,a
father,462084,463079,995,Germany,G24,m,33,10,a
father,466616,467737,1121,Germany,G24,m,33,11,a
father,468479,472463,3984,Germany,G24,m,34,1,q
mother,471779,473932,2153,Germany,G24,f,34,2,q
father,473969,474590,621,Germany,G24,m,34,3,q
mother,475021,475590,569,Germany,G24,f,34,4,a
father,475542,476342,800,Germany,G24,m,34,5,q
mother,476416,479963,3547,Germany,G24,f,34,6,a
child,478947,480126,1179,Germany,G24,m,35,1,a
mother,480616,484442,3826,Germany,G24,c,35,2,a
child,485388,489457,4069,Germany,G24,m,35,3,a
mother,489406,490432,1026,Germany,G24,c,35,4,q
child,490230,491064,834,Germany,G24,m,35,5,a
child,493568,494740,1172,Germany,G24,m,35,6,a
mother,494506,495616,1110,Germany,G24,c,35,7,q
child,495712,496995,1283,Germany,G24,b,35,8,a
mother,497758,501090,3332,Germany,G24,b,35,9,a
child,501740,502616,876,Germany,G24,f,35,10,a
father,505174,506063,889,Germany,G24,b,36,1,a
mother,506711,507953,1242,Germany,G24,f,37,1,a
father,508027,509537,1510,Germany,G24,m,38,1,q
mother,509584,511600,2016,Germany,G24,f,38,2,a
father,512711,514827,2116,Germany,G24,m,38,3,a
mother,513927,516448,2521,Germany,G24,f,38,4,a
child,517257,518064,807,Germany,G24,m,39,1,a
mother,518516,519290,774,Germany,G24,c,39,2,a
child,521823,523016,1193,Germany,G24,b,39,3,a
child,524402,527947,3545,Germany,G24,m,39,4,a
mother,528879,530727,1848,Germany,G24,c,39,5,q
child,529050,530485,1435,Germany,G24,m,39,6,a
child,531112,532264,1152,Germany,G24,m,39,7,a
mother,531811,532948,1137,Germany,G24,c,39,8,q
child,532981,534140,1159,Germany,G24,m,39,9,a
mother,535358,536163,805,Germany,G24,c,39,10,a
child,537499,538464,965,Germany,G24,m,39,11,a
father,527637,528753,1116,Germany,G24,m,40,1,a
mother,540216,543390,3174,Germany,G24,f,40,2,a
father,543469,544284,815,Germany,G24,m,40,3,a
child,543340,546333,2993,Germany,G24,b,41,1,a
father,544642,548758,4116,Germany,G24,m,42,1,a
mother,550569,551832,1263,Germany,G24,f,42,2,q
father,552232,553369,1137,Germany,G24,m,42,3,q
mother,559984,561321,1337,Germany,G24,f,42,4,a
father,561274,562142,868,Germany,G24,m,42,5,a
mother,571669,573816,2147,Germany,G24,f,43,1,a
father,574458,574969,511,Germany,G24,m,43,2,a
mother,577206,580553,3347,Germany,G24,f,43,3,a
mother,582458,583606,1148,Germany,G24,f,44,1,q
father,585300,586821,1521,Germany,G24,m,44,2,a
mother,586716,587506,790,Germany,G24,f,44,3,a
father,588490,589342,852,Germany,G24,m,44,4,a
silence,3690,4181,491,Germany,G24,NA,NA,NA,NA
silence,5580,5616,36,Germany,G24,NA,NA,NA,NA
silence,6327,7000,673,Germany,G24,NA,NA,NA,NA
silence,9616,11674,2058,Germany,G24,NA,NA,NA,NA
father_gesture,12652,13033,381,Germany,G24,NA,NA,NA,NA
silence,13042,13708,666,Germany,G24,NA,NA,NA,NA
silence,14440,15700,1260,Germany,G24,NA,NA,NA,NA
silence,16295,17811,1516,Germany,G24,NA,NA,NA,NA
silence,18584,20953,2369,Germany,G24,NA,NA,NA,NA
silence,21579,22693,1114,Germany,G24,NA,NA,NA,NA
silence,24135,27519,3384,Germany,G24,NA,NA,NA,NA
silence,28574,31353,2779,Germany,G24,NA,NA,NA,NA
silence,35584,36106,522,Germany,G24,NA,NA,NA,NA
silence,42463,53527,11064,Germany,G24,NA,NA,NA,NA
silence,55627,56809,1182,Germany,G24,NA,NA,NA,NA
silence,58632,58664,32,Germany,G24,NA,NA,NA,NA
silence,59816,60748,932,Germany,G24,NA,NA,NA,NA
silence,61969,63933,1964,Germany,G24,NA,NA,NA,NA
child_gesture,64101,64480,379,Germany,G24,NA,NA,NA,NA
silence,64540,64716,176,Germany,G24,NA,NA,NA,NA
father_gesture,65384,66075,691,Germany,G24,NA,NA,NA,NA
silence,68500,71132,2632,Germany,G24,NA,NA,NA,NA
silence,73227,77863,4636,Germany,G24,NA,NA,NA,NA
silence,83563,86384,2821,Germany,G24,NA,NA,NA,NA
silence,94032,101648,7616,Germany,G24,NA,NA,NA,NA
father_gesture,101996,102498,502,Germany,G24,NA,NA,NA,NA
silence,102532,104611,2079,Germany,G24,NA,NA,NA,NA
silence,105227,106250,1023,Germany,G24,NA,NA,NA,NA
silence,107416,108009,593,Germany,G24,NA,NA,NA,NA
silence,108940,109058,118,Germany,G24,NA,NA,NA,NA
silence,110690,110816,126,Germany,G24,NA,NA,NA,NA
silence,111616,113574,1958,Germany,G24,NA,NA,NA,NA
silence,114611,115416,805,Germany,G24,NA,NA,NA,NA
father_gesture,117387,118357,970,Germany,G24,NA,NA,NA,NA
silence,118953,124000,5047,Germany,G24,NA,NA,NA,NA
silence,125716,130306,4590,Germany,G24,NA,NA,NA,NA
silence,131790,137679,5889,Germany,G24,NA,NA,NA,NA
silence,138742,138906,164,Germany,G24,NA,NA,NA,NA
silence,139843,140457,614,Germany,G24,NA,NA,NA,NA
father_gesture,141209,141963,754,Germany,G24,NA,NA,NA,NA
silence,141374,142795,1421,Germany,G24,NA,NA,NA,NA
silence,143395,143506,111,Germany,G24,NA,NA,NA,NA
silence,144064,144116,52,Germany,G24,NA,NA,NA,NA
silence,145869,146933,1064,Germany,G24,NA,NA,NA,NA
silence,147616,147753,137,Germany,G24,NA,NA,NA,NA
silence,148148,155153,7005,Germany,G24,NA,NA,NA,NA
silence,160163,163237,3074,Germany,G24,NA,NA,NA,NA
silence,163871,164037,166,Germany,G24,NA,NA,NA,NA
silence,164721,167069,2348,Germany,G24,NA,NA,NA,NA
silence,168669,170243,1574,Germany,G24,NA,NA,NA,NA
silence,170968,171311,343,Germany,G24,NA,NA,NA,NA
silence,171963,172740,777,Germany,G24,NA,NA,NA,NA
silence,173561,174958,1397,Germany,G24,NA,NA,NA,NA
silence,176511,177806,1295,Germany,G24,NA,NA,NA,NA
silence,179237,181168,1931,Germany,G24,NA,NA,NA,NA
silence,182126,182227,101,Germany,G24,NA,NA,NA,NA
silence,185621,186140,519,Germany,G24,NA,NA,NA,NA
silence,186947,187727,780,Germany,G24,NA,NA,NA,NA
silence,188653,191421,2768,Germany,G24,NA,NA,NA,NA
silence,192263,196490,4227,Germany,G24,NA,NA,NA,NA
silence,205074,215671,10597,Germany,G24,NA,NA,NA,NA
silence,216692,217700,1008,Germany,G24,NA,NA,NA,NA
silence,218642,220206,1564,Germany,G24,NA,NA,NA,NA
silence,221779,222011,232,Germany,G24,NA,NA,NA,NA
silence,222606,223690,1084,Germany,G24,NA,NA,NA,NA
silence,225000,230484,5484,Germany,G24,NA,NA,NA,NA
mother_gesture,233967,234933,966,Germany,G24,NA,NA,NA,NA
silence,235632,236609,977,Germany,G24,NA,NA,NA,NA
silence,237209,237611,402,Germany,G24,NA,NA,NA,NA
silence,242616,242674,58,Germany,G24,NA,NA,NA,NA
silence,243163,254063,10900,Germany,G24,NA,NA,NA,NA
silence,258011,259063,1052,Germany,G24,NA,NA,NA,NA
silence,260527,261021,494,Germany,G24,NA,NA,NA,NA
silence,261853,261974,121,Germany,G24,NA,NA,NA,NA
silence,265674,270432,4758,Germany,G24,NA,NA,NA,NA
silence,272306,273621,1315,Germany,G24,NA,NA,NA,NA
silence,274884,275321,437,Germany,G24,NA,NA,NA,NA
silence,279863,282948,3085,Germany,G24,NA,NA,NA,NA
silence,284363,287119,2756,Germany,G24,NA,NA,NA,NA
silence,287995,288006,11,Germany,G24,NA,NA,NA,NA
silence,288527,290063,1536,Germany,G24,NA,NA,NA,NA
silence,290769,291671,902,Germany,G24,NA,NA,NA,NA
silence,292388,294581,2193,Germany,G24,NA,NA,NA,NA
child_gesture,294703,295216,513,Germany,G24,NA,NA,NA,NA
silence,295202,295221,19,Germany,G24,NA,NA,NA,NA
silence,296348,298763,2415,Germany,G24,NA,NA,NA,NA
silence,300611,314800,14189,Germany,G24,NA,NA,NA,NA
silence,315490,319521,4031,Germany,G24,NA,NA,NA,NA
silence,320353,320885,532,Germany,G24,NA,NA,NA,NA
child_gesture,320988,322181,1193,Germany,G24,NA,NA,NA,NA
silence,322340,322737,397,Germany,G24,NA,NA,NA,NA
silence,323932,323958,26,Germany,G24,NA,NA,NA,NA
silence,325337,325912,575,Germany,G24,NA,NA,NA,NA
silence,326802,331264,4462,Germany,G24,NA,NA,NA,NA
child_gesture,332772,333661,889,Germany,G24,NA,NA,NA,NA
silence,333602,333658,56,Germany,G24,NA,NA,NA,NA
mother_gesture,334123,334742,619,Germany,G24,NA,NA,NA,NA
silence,335511,338250,2739,Germany,G24,NA,NA,NA,NA
child_gesture,339440,340390,950,Germany,G24,NA,NA,NA,NA
silence,342048,342830,782,Germany,G24,NA,NA,NA,NA
child_gesture,343130,344289,1159,Germany,G24,NA,NA,NA,NA
silence,345053,345202,149,Germany,G24,NA,NA,NA,NA
silence,345906,347237,1331,Germany,G24,NA,NA,NA,NA
father_gesture,347671,348395,724,Germany,G24,NA,NA,NA,NA
silence,348221,351284,3063,Germany,G24,NA,NA,NA,NA
silence,352411,352623,212,Germany,G24,NA,NA,NA,NA
silence,354916,355264,348,Germany,G24,NA,NA,NA,NA
silence,356071,356311,240,Germany,G24,NA,NA,NA,NA
silence,358779,358984,205,Germany,G24,NA,NA,NA,NA
silence,360163,360311,148,Germany,G24,NA,NA,NA,NA
silence,360742,363769,3027,Germany,G24,NA,NA,NA,NA
father_gesture,364387,364914,527,Germany,G24,NA,NA,NA,NA
silence,364779,365561,782,Germany,G24,NA,NA,NA,NA
silence,366140,369250,3110,Germany,G24,NA,NA,NA,NA
child_gesture,369406,370030,624,Germany,G24,NA,NA,NA,NA
silence,369954,374763,4809,Germany,G24,NA,NA,NA,NA
silence,375611,379832,4221,Germany,G24,NA,NA,NA,NA
silence,381121,381271,150,Germany,G24,NA,NA,NA,NA
silence,381947,382006,59,Germany,G24,NA,NA,NA,NA
silence,385569,397100,11531,Germany,G24,NA,NA,NA,NA
silence,397732,413179,15447,Germany,G24,NA,NA,NA,NA
silence,414337,416032,1695,Germany,G24,NA,NA,NA,NA
silence,416995,417954,959,Germany,G24,NA,NA,NA,NA
silence,418678,420406,1728,Germany,G24,NA,NA,NA,NA
silence,421411,421632,221,Germany,G24,NA,NA,NA,NA
silence,424048,427800,3752,Germany,G24,NA,NA,NA,NA
silence,429132,430963,1831,Germany,G24,NA,NA,NA,NA
silence,433533,433606,73,Germany,G24,NA,NA,NA,NA
silence,434595,435148,553,Germany,G24,NA,NA,NA,NA
silence,436769,436863,94,Germany,G24,NA,NA,NA,NA
silence,439474,441821,2347,Germany,G24,NA,NA,NA,NA
silence,443679,445874,2195,Germany,G24,NA,NA,NA,NA
mother_gesture,455404,456184,780,Germany,G24,NA,NA,NA,NA
silence,457342,462084,4742,Germany,G24,NA,NA,NA,NA
silence,463079,466616,3537,Germany,G24,NA,NA,NA,NA
silence,467737,468479,742,Germany,G24,NA,NA,NA,NA
silence,473932,473969,37,Germany,G24,NA,NA,NA,NA
silence,474590,475021,431,Germany,G24,NA,NA,NA,NA
silence,476342,476416,74,Germany,G24,NA,NA,NA,NA
child_gesture,479360,480049,689,Germany,G24,NA,NA,NA,NA
silence,480126,480616,490,Germany,G24,NA,NA,NA,NA
silence,484442,485388,946,Germany,G24,NA,NA,NA,NA
child_gesture,488805,489402,597,Germany,G24,NA,NA,NA,NA
silence,491064,493568,2504,Germany,G24,NA,NA,NA,NA
child_gesture,494493,495592,1099,Germany,G24,NA,NA,NA,NA
silence,495616,495712,96,Germany,G24,NA,NA,NA,NA
silence,496995,497758,763,Germany,G24,NA,NA,NA,NA
mother_gesture,500114,500665,551,Germany,G24,NA,NA,NA,NA
silence,501090,501740,650,Germany,G24,NA,NA,NA,NA
silence,502616,505174,2558,Germany,G24,NA,NA,NA,NA
silence,506063,506711,648,Germany,G24,NA,NA,NA,NA
silence,507953,508027,74,Germany,G24,NA,NA,NA,NA
silence,509537,509584,47,Germany,G24,NA,NA,NA,NA
silence,511600,512711,1111,Germany,G24,NA,NA,NA,NA
silence,516448,517257,809,Germany,G24,NA,NA,NA,NA
child_gesture,517199,518321,1122,Germany,G24,NA,NA,NA,NA
silence,518064,518516,452,Germany,G24,NA,NA,NA,NA
silence,519290,521823,2533,Germany,G24,NA,NA,NA,NA
silence,523016,524402,1386,Germany,G24,NA,NA,NA,NA
silence,528753,528879,126,Germany,G24,NA,NA,NA,NA
silence,530727,531112,385,Germany,G24,NA,NA,NA,NA
silence,532948,532981,33,Germany,G24,NA,NA,NA,NA
silence,534140,535358,1218,Germany,G24,NA,NA,NA,NA
silence,536163,537499,1336,Germany,G24,NA,NA,NA,NA
silence,538464,540216,1752,Germany,G24,NA,NA,NA,NA
silence,548758,550569,1811,Germany,G24,NA,NA,NA,NA
silence,551832,552232,400,Germany,G24,NA,NA,NA,NA
silence,553369,559984,6615,Germany,G24,NA,NA,NA,NA
silence,562142,571669,9527,Germany,G24,NA,NA,NA,NA
silence,573816,574458,642,Germany,G24,NA,NA,NA,NA
silence,574969,577206,2237,Germany,G24,NA,NA,NA,NA
silence,580553,582458,1905,Germany,G24,NA,NA,NA,NA
silence,583606,585300,1694,Germany,G24,NA,NA,NA,NA
father_gesture,585700,586193,493,Germany,G24,NA,NA,NA,NA
silence,587506,588490,984,Germany,G24,NA,NA,NA,NA
silence,589342,598548,9206,Germany,G24,NA,NA,NA,NA
mother,1347,2335,988,Japan,J01,b,1,1,a
father,1859,2843,984,Japan,J01,b,1,2,a
child,2800,5100,2300,Japan,J01,m,2,1,a
child,6306,7200,894,Japan,J01,m,2,2,a
mother,7197,7601,404,Japan,J01,c,2,3,a
child,8110,9242,1132,Japan,J01,m,2,4,i
mother,9595,10413,818,Japan,J01,c,2,5,q
mother,12523,14994,2471,Japan,J01,c,3,1,a
father,15634,16877,1243,Japan,J01,c,3,2,a
child,17800,20010,2210,Japan,J01,b,3,3,a
mother,20120,20816,696,Japan,J01,c,3,4,q
child,23020,24240,1220,Japan,J01,m,3,5,a
mother,24496,24987,491,Japan,J01,c,3,6,a
mother,33507,34037,530,Japan,J01,c,3,7,q
mother,34660,35657,997,Japan,J01,c,3,8,q
child,36270,37540,1270,Japan,J01,m,3,9,a
mother,37800,38747,947,Japan,J01,c,3,10,q
child,38853,39183,330,Japan,J01,m,3,11,a
child,40430,41064,634,Japan,J01,c,3,12,i
mother,41452,44545,3093,Japan,J01,c,3,13,a
child,44530,46684,2154,Japan,J01,m,3,14,a
father,44849,45120,271,Japan,J01,m,3,15,a
mother,47678,51982,4304,Japan,J01,c,3,16,a
father,48440,49007,567,Japan,J01,c,3,17,a
father,57092,57523,431,Japan,J01,c,5,1,a
father,58468,58800,332,Japan,J01,c,5,2,i
mother,59777,61242,1465,Japan,J01,f,6,1,q
father,61286,61584,298,Japan,J01,m,6,2,a
mother,62917,63827,910,Japan,J01,f,6,3,a
father,63191,66805,3614,Japan,J01,m,6,4,a
mother,65376,66081,705,Japan,J01,f,6,5,q
mother,66822,68414,1592,Japan,J01,f,6,6,a
father,69258,69750,492,Japan,J01,m,6,7,a
mother,70663,70972,309,Japan,J01,f,6,8,q
father,72247,74010,1763,Japan,J01,m,6,9,a
mother,74286,74650,364,Japan,J01,f,6,10,a
father,75103,76111,1008,Japan,J01,m,6,11,a
mother,76313,76827,514,Japan,J01,f,6,12,q
father,76512,78197,1685,Japan,J01,m,6,13,a
mother,78800,79568,768,Japan,J01,f,6,14,a
mother,85816,90192,4376,Japan,J01,f,6,15,q
father,91137,91545,408,Japan,J01,m,6,16,a
mother,92098,92871,773,Japan,J01,o,6,17,q
father,92628,96523,3895,Japan,J01,m,6,18,a
mother,96026,97927,1901,Japan,J01,f,6,19,q
father,97952,98423,471,Japan,J01,m,6,20,a
mother,99236,101534,2298,Japan,J01,f,6,21,q
father,100976,103264,2288,Japan,J01,m,6,22,a
mother,103650,104678,1028,Japan,J01,f,6,23,a
father,104777,105445,668,Japan,J01,m,6,24,q
mother,109247,111084,1837,Japan,J01,f,6,25,q
father,112534,115551,3017,Japan,J01,m,6,26,a
mother,113540,113795,255,Japan,J01,f,6,27,a
mother,114540,115734,1194,Japan,J01,f,6,28,a
mother,119196,120523,1327,Japan,J01,c,6,29,q
father,122131,126253,4122,Japan,J01,m,6,30,a
mother,124932,127231,2299,Japan,J01,f,6,31,q
father,127523,132998,5475,Japan,J01,m,6,32,a
mother,132777,133783,1006,Japan,J01,f,6,33,q
father,136905,138937,2032,Japan,J01,m,6,34,a
mother,139871,141127,1256,Japan,J01,f,6,35,a
father,142331,145624,3293,Japan,J01,m,6,36,a
child,142551,143253,702,Japan,J01,m,7,1,a
mother,143424,144568,1144,Japan,J01,c,7,2,q
child,146040,147190,1150,Japan,J01,f,7,3,a
father,147917,150214,2297,Japan,J01,c,7,4,q
child,152000,153160,1160,Japan,J01,m,7,5,i
mother,152789,156137,3348,Japan,J01,c,7,6,q
child,156320,156760,440,Japan,J01,m,7,7,a
mother,156888,158324,1436,Japan,J01,c,7,8,q
child,158450,163850,5400,Japan,J01,m,7,9,a
mother,164137,165451,1314,Japan,J01,c,7,10,q
mother,166568,167019,451,Japan,J01,c,7,11,a
father,168019,168935,916,Japan,J01,c,7,12,a
mother,169380,169766,386,Japan,J01,c,7,13,a
mother,170971,172347,1376,Japan,J01,c,7,14,NA
father,172402,172923,521,Japan,J01,b,7,15,a
father,176777,177840,1063,Japan,J01,b,7,16,a
mother,178214,178973,759,Japan,J01,c,8,1,q
mother,183871,185269,1398,Japan,J01,c,8,2,a
child,185568,185816,248,Japan,J01,m,8,3,a
father,189733,190165,432,Japan,J01,c,8,4,a
mother,191463,191695,232,Japan,J01,c,8,5,a
child,193292,193775,483,Japan,J01,m,9,1,a
mother,193932,194335,403,Japan,J01,m,9,2,q
mother,197644,198103,459,Japan,J01,m,9,3,q
child,197906,198396,490,Japan,J01,m,9,4,a
mother,198617,199186,569,Japan,J01,c,9,5,q
child,200072,200637,565,Japan,J01,m,9,6,a
mother,200689,201252,563,Japan,J01,c,9,7,q
mother,203827,204385,558,Japan,J01,c,9,8,q
child,205092,208430,3338,Japan,J01,m,9,9,i
mother,208695,211844,3149,Japan,J01,c,9,10,q
child,211906,212561,655,Japan,J01,m,9,11,a
mother,212772,215258,2486,Japan,J01,c,9,12,q
mother,218811,219109,298,Japan,J01,c,10,1,a
child,222800,223882,1082,Japan,J01,m,10,2,a
mother,223899,225927,2028,Japan,J01,c,10,3,i
father,224103,224457,354,Japan,J01,NA,10,4,a
child,226437,227860,1423,Japan,J01,m,10,5,a
mother,227059,230623,3564,Japan,J01,c,10,6,a
father,230864,231295,431,Japan,J01,c,10,7,a
mother,231755,233291,1536,Japan,J01,f,11,1,q
father,233507,237523,4016,Japan,J01,m,11,2,a
father,242085,245811,3726,Japan,J01,m,11,3,a
mother,245971,247032,1061,Japan,J01,f,11,4,q
father,247347,247695,348,Japan,J01,m,11,5,q
mother,248764,249879,1115,Japan,J01,o,11,6,a
mother,251772,254374,2602,Japan,J01,f,11,7,q
father,256877,260479,3602,Japan,J01,m,11,8,a
mother,257711,258015,304,Japan,J01,f,11,9,a
child,243437,245154,1717,Japan,J01,m,12,1,a
mother,243777,244032,255,Japan,J01,c,12,2,a
child,260844,265879,5035,Japan,J01,m,13,1,a
mother,260871,261347,476,Japan,J01,c,13,2,q
mother,267015,268645,1630,Japan,J01,c,13,3,a
child,267816,270951,3135,Japan,J01,m,13,4,a
mother,276076,276717,641,Japan,J01,NA,13,5,i
mother,282026,286651,4625,Japan,J01,c,13,6,a
child,288051,289699,1648,Japan,J01,m,13,7,a
mother,290065,290606,541,Japan,J01,c,13,8,a
mother,293258,294435,1177,Japan,J01,c,13,9,a
child,294534,295930,1396,Japan,J01,m,13,10,a
father,300639,301717,1078,Japan,J01,c,13,11,q
child,302175,302980,805,Japan,J01,f,13,12,a
child,304644,307347,2703,Japan,J01,m,13,13,a
mother,279330,280733,1403,Japan,J01,o,14,1,a
mother,296789,297744,955,Japan,J01,f,15,1,a
mother,308568,309611,1043,Japan,J01,c,16,1,q
child,312637,313037,400,Japan,J01,m,16,2,a
mother,313330,314936,1606,Japan,J01,c,16,3,a
mother,316347,319965,3618,Japan,J01,c,16,4,a
father,321397,323390,1993,Japan,J01,m,17,1,q
mother,324286,325043,757,Japan,J01,f,17,2,a
father,325131,325921,790,Japan,J01,m,17,3,q
mother,326551,328551,2000,Japan,J01,f,17,4,a
father,328418,330616,2198,Japan,J01,m,17,5,a
mother,331197,331789,592,Japan,J01,f,17,6,a
father,332838,333197,359,Japan,J01,c,18,1,q
mother,334982,336208,1226,Japan,J01,c,19,1,q
father,336175,336949,774,Japan,J01,m,19,2,a
mother,338474,339617,1143,Japan,J01,f,19,3,a
father,340010,341549,1539,Japan,J01,m,20,1,q
mother,341949,345076,3127,Japan,J01,f,21,1,q
father,345601,347131,1530,Japan,J01,m,21,2,a
mother,347203,348421,1218,Japan,J01,f,21,3,a
mother,352689,353799,1110,Japan,J01,o,21,4,a
father,360131,364711,4580,Japan,J01,m,21,5,a
mother,361777,362231,454,Japan,J01,c,22,1,i
child,361982,362610,628,Japan,J01,m,22,2,a
mother,362628,362938,310,Japan,J01,c,22,3,a
child,369196,370947,1751,Japan,J01,m,23,1,i
child,373734,376789,3055,Japan,J01,m,23,2,i
mother,379474,380037,563,Japan,J01,c,24,1,q
mother,381374,381673,299,Japan,J01,c,24,2,a
child,382458,385063,2605,Japan,J01,m,24,3,a
mother,385899,388010,2111,Japan,J01,f,25,1,q
father,388043,396601,8558,Japan,J01,m,25,2,a
mother,396971,397562,591,Japan,J01,c,26,1,i
child,397697,398104,407,Japan,J01,m,26,2,a
mother,398192,398811,619,Japan,J01,c,26,3,a
child,398927,399391,464,Japan,J01,m,26,4,a
mother,399479,399833,354,Japan,J01,c,26,5,a
child,400059,400779,720,Japan,J01,m,26,6,a
mother,400998,401678,680,Japan,J01,c,26,7,i
child,402980,403457,477,Japan,J01,m,26,8,a
mother,403579,404110,531,Japan,J01,c,26,9,a
child,404327,406589,2262,Japan,J01,m,26,10,a
father,404330,406556,2226,Japan,J01,c,26,11,a
mother,404855,406004,1149,Japan,J01,c,26,12,a
child,406837,407796,959,Japan,J01,m,27,1,a
mother,409144,412683,3539,Japan,J01,c,27,2,a
father,413938,414414,476,Japan,J01,m,27,3,a
mother,414711,415016,305,Japan,J01,f,27,4,a
child,415030,417706,2676,Japan,J01,m,27,5,a
mother,418434,419885,1451,Japan,J01,c,28,1,q
child,421258,425906,4648,Japan,J01,m,28,2,q
mother,426446,428162,1716,Japan,J01,c,28,3,a
father,429645,434789,5144,Japan,J01,m,28,4,a
mother,436164,437888,1724,Japan,J01,f,28,5,q
father,437800,442363,4563,Japan,J01,m,28,6,a
mother,442916,444301,1385,Japan,J01,f,28,7,a
father,443535,448750,5215,Japan,J01,m,28,8,a
mother,446592,447854,1262,Japan,J01,f,28,9,a
mother,449231,450617,1386,Japan,J01,f,28,10,a
father,450601,451070,469,Japan,J01,m,28,11,a
mother,453499,455635,2136,Japan,J01,c,28,12,q
mother,459866,462965,3099,Japan,J01,f,28,13,a
father,463054,463385,331,Japan,J01,m,28,14,a
mother,464286,465102,816,Japan,J01,f,28,15,a
mother,471440,474391,2951,Japan,J01,f,28,16,a
father,474507,474833,326,Japan,J01,m,28,17,a
mother,476347,479367,3020,Japan,J01,f,28,18,a
father,481695,482833,1138,Japan,J01,m,28,19,a
mother,483098,487236,4138,Japan,J01,f,28,20,q
father,488849,489723,874,Japan,J01,m,28,21,q
mother,489772,490081,309,Japan,J01,f,28,22,a
father,491418,492159,741,Japan,J01,m,28,23,q
mother,491960,492330,370,Japan,J01,f,28,24,a
father,492521,493032,511,Japan,J01,m,28,25,a
mother,493241,493772,531,Japan,J01,f,28,26,q
father,494551,497142,2591,Japan,J01,m,28,27,a
mother,497253,499385,2132,Japan,J01,f,28,28,q
father,500385,502827,2442,Japan,J01,m,28,29,a
mother,502899,505010,2111,Japan,J01,f,28,30,q
father,505436,506693,1257,Japan,J01,m,28,31,a
mother,506595,507588,993,Japan,J01,f,28,32,i
father,508245,508613,368,Japan,J01,m,28,33,a
child,430810,433354,2544,Japan,J01,m,29,1,a
mother,433286,434167,881,Japan,J01,c,29,2,a
child,462389,464706,2317,Japan,J01,m,29,3,a
child,503789,504548,759,Japan,J01,m,29,4,a
mother,508623,510302,1679,Japan,J01,c,29,5,a
father,511510,512061,551,Japan,J01,m,30,1,a
mother,512352,513126,774,Japan,J01,c,31,1,q
child,513079,514699,1620,Japan,J01,m,31,2,a
mother,514319,515785,1466,Japan,J01,c,31,3,a
child,515893,517244,1351,Japan,J01,m,31,4,a
mother,516440,516965,525,Japan,J01,c,31,5,q
mother,517452,520109,2657,Japan,J01,c,31,6,a
father,520745,521074,329,Japan,J01,m,31,7,a
child,521079,521892,813,Japan,J01,m,31,8,a
mother,521965,522623,658,Japan,J01,f,31,9,a
mother,522916,524227,1311,Japan,J01,c,31,10,q
child,524637,526023,1386,Japan,J01,m,31,11,a
child,526044,529975,3931,Japan,J01,m,31,12,a
father,531181,531556,375,Japan,J01,m,32,1,a
father,534081,534420,339,Japan,J01,m,32,2,a
mother,535269,538960,3691,Japan,J01,f,32,3,a
father,539307,540921,1614,Japan,J01,m,32,4,a
mother,540286,542418,2132,Japan,J01,f,32,5,q
father,542114,544198,2084,Japan,J01,NA,32,6,a
mother,544877,546744,1867,Japan,J01,f,32,7,i
father,547661,548358,697,Japan,J01,m,32,8,a
mother,548435,549976,1541,Japan,J01,f,32,9,a
father,550210,550570,360,Japan,J01,m,32,10,a
father,555308,560753,5445,Japan,J01,m,32,11,a
mother,558678,558976,298,Japan,J01,f,32,12,a
mother,560385,560838,453,Japan,J01,f,32,13,a
mother,562678,563258,580,Japan,J01,f,32,14,i
father,563529,563960,431,Japan,J01,m,32,15,a
mother,564159,565601,1442,Japan,J01,f,32,16,a
father,566010,566553,543,Japan,J01,m,32,17,a
mother,569744,573138,3394,Japan,J01,f,32,18,a
father,572000,579347,7347,Japan,J01,f,32,19,a
mother,576938,577175,237,Japan,J01,f,32,20,a
mother,580142,580877,735,Japan,J01,f,32,21,a
child,545768,547672,1904,Japan,J01,o,33,1,a
child,549472,552982,3510,Japan,J01,m,34,1,a
mother,552120,553855,1735,Japan,J01,c,34,2,i
father,580308,593712,13404,Japan,J01,m,35,1,a
mother,582650,582993,343,Japan,J01,f,35,2,a
mother,583827,584203,376,Japan,J01,f,35,3,a
mother,586153,586496,343,Japan,J01,f,35,4,a
mother,587595,588428,833,Japan,J01,f,35,5,a
mother,590127,590419,292,Japan,J01,f,35,6,a
mother,593186,593584,398,Japan,J01,f,35,7,a
mother,596517,597591,1074,Japan,J01,f,35,8,q
child,364885,367279,2394,Japan,J01,m,36,1,i
mother,367291,369186,1895,Japan,J01,c,36,2,a
silence,5100,6306,1206,Japan,J01,NA,NA,NA,NA
silence,7601,8110,509,Japan,J01,NA,NA,NA,NA
silence,9242,9595,353,Japan,J01,NA,NA,NA,NA
silence,10413,12523,2110,Japan,J01,NA,NA,NA,NA
silence,14994,15634,640,Japan,J01,NA,NA,NA,NA
silence,16877,17800,923,Japan,J01,NA,NA,NA,NA
silence,20010,20120,110,Japan,J01,NA,NA,NA,NA
silence,20816,23020,2204,Japan,J01,NA,NA,NA,NA
silence,24240,24496,256,Japan,J01,NA,NA,NA,NA
silence,24987,33507,8520,Japan,J01,NA,NA,NA,NA
silence,34037,34660,623,Japan,J01,NA,NA,NA,NA
silence,35657,36270,613,Japan,J01,NA,NA,NA,NA
silence,37540,37800,260,Japan,J01,NA,NA,NA,NA
silence,38747,38853,106,Japan,J01,NA,NA,NA,NA
silence,39183,40430,1247,Japan,J01,NA,NA,NA,NA
child_gesture,40312,41524,1212,Japan,J01,NA,NA,NA,NA
silence,41064,41452,388,Japan,J01,NA,NA,NA,NA
silence,46684,47678,994,Japan,J01,NA,NA,NA,NA
silence,51982,55245,3263,Japan,J01,NA,NA,NA,NA
mother,55245,58457,3212,Japan,J01,c,NA,NA,a
silence,58457,58468,11,Japan,J01,NA,NA,NA,NA
silence,58800,59777,977,Japan,J01,NA,NA,NA,NA
silence,61242,61286,44,Japan,J01,NA,NA,NA,NA
silence,61584,62917,1333,Japan,J01,NA,NA,NA,NA
silence,66805,66822,17,Japan,J01,NA,NA,NA,NA
silence,68414,69258,844,Japan,J01,NA,NA,NA,NA
silence,69750,70663,913,Japan,J01,NA,NA,NA,NA
silence,70972,72247,1275,Japan,J01,NA,NA,NA,NA
silence,74010,74286,276,Japan,J01,NA,NA,NA,NA
silence,74650,75103,453,Japan,J01,NA,NA,NA,NA
silence,76111,76313,202,Japan,J01,NA,NA,NA,NA
silence,78197,78800,603,Japan,J01,NA,NA,NA,NA
silence,79568,85816,6248,Japan,J01,NA,NA,NA,NA
silence,90192,91137,945,Japan,J01,NA,NA,NA,NA
silence,91545,92098,553,Japan,J01,NA,NA,NA,NA
silence,97927,97952,25,Japan,J01,NA,NA,NA,NA
silence,98423,99236,813,Japan,J01,NA,NA,NA,NA
silence,103264,103650,386,Japan,J01,NA,NA,NA,NA
silence,104678,104777,99,Japan,J01,NA,NA,NA,NA
silence,105445,109247,3802,Japan,J01,NA,NA,NA,NA
silence,111084,112534,1450,Japan,J01,NA,NA,NA,NA
silence,115734,119196,3462,Japan,J01,NA,NA,NA,NA
silence,120523,122131,1608,Japan,J01,NA,NA,NA,NA
silence,127231,127523,292,Japan,J01,NA,NA,NA,NA
silence,133783,136905,3122,Japan,J01,NA,NA,NA,NA
silence,138937,139871,934,Japan,J01,NA,NA,NA,NA
silence,141127,142331,1204,Japan,J01,NA,NA,NA,NA
child_gesture,145596,147456,1860,Japan,J01,NA,NA,NA,NA
silence,145624,146040,416,Japan,J01,NA,NA,NA,NA
silence,147190,147917,727,Japan,J01,NA,NA,NA,NA
silence,150214,152000,1786,Japan,J01,NA,NA,NA,NA
child_gesture,151846,153098,1252,Japan,J01,NA,NA,NA,NA
child_gesture,155315,156520,1205,Japan,J01,NA,NA,NA,NA
silence,156137,156320,183,Japan,J01,NA,NA,NA,NA
silence,156760,156888,128,Japan,J01,NA,NA,NA,NA
silence,158324,158450,126,Japan,J01,NA,NA,NA,NA
silence,163850,164137,287,Japan,J01,NA,NA,NA,NA
silence,165451,166010,559,Japan,J01,NA,NA,NA,NA
child,166010,166285,275,Japan,J01,m,NA,NA,a
silence,166285,166568,283,Japan,J01,NA,NA,NA,NA
silence,167019,168019,1000,Japan,J01,NA,NA,NA,NA
silence,168935,169380,445,Japan,J01,NA,NA,NA,NA
silence,169766,170971,1205,Japan,J01,NA,NA,NA,NA
silence,172347,172402,55,Japan,J01,NA,NA,NA,NA
silence,172923,176777,3854,Japan,J01,NA,NA,NA,NA
silence,177840,178214,374,Japan,J01,NA,NA,NA,NA
silence,178973,183871,4898,Japan,J01,NA,NA,NA,NA
child_gesture,183667,185006,1339,Japan,J01,NA,NA,NA,NA
silence,185269,185568,299,Japan,J01,NA,NA,NA,NA
silence,185816,189733,3917,Japan,J01,NA,NA,NA,NA
silence,190165,191463,1298,Japan,J01,NA,NA,NA,NA
silence,191695,193292,1597,Japan,J01,NA,NA,NA,NA
silence,193775,193932,157,Japan,J01,NA,NA,NA,NA
silence,194335,197644,3309,Japan,J01,NA,NA,NA,NA
silence,198396,198617,221,Japan,J01,NA,NA,NA,NA
silence,199186,200072,886,Japan,J01,NA,NA,NA,NA
silence,200637,200689,52,Japan,J01,NA,NA,NA,NA
silence,201252,203003,1751,Japan,J01,NA,NA,NA,NA
child,203003,203615,612,Japan,J01,m,NA,NA,a
silence,203615,203827,212,Japan,J01,NA,NA,NA,NA
silence,204385,205092,707,Japan,J01,NA,NA,NA,NA
silence,208430,208695,265,Japan,J01,NA,NA,NA,NA
silence,211844,211906,62,Japan,J01,NA,NA,NA,NA
silence,212561,212772,211,Japan,J01,NA,NA,NA,NA
child_gesture,215219,217543,2324,Japan,J01,NA,NA,NA,NA
silence,215258,215706,448,Japan,J01,NA,NA,NA,NA
child,215706,218215,2509,Japan,J01,m,NA,NA,i
silence,218215,218811,596,Japan,J01,NA,NA,NA,NA
silence,219109,222800,3691,Japan,J01,NA,NA,NA,NA
child_gesture,222841,224994,2153,Japan,J01,NA,NA,NA,NA
silence,223882,223899,17,Japan,J01,NA,NA,NA,NA
silence,225927,226437,510,Japan,J01,NA,NA,NA,NA
silence,230623,230864,241,Japan,J01,NA,NA,NA,NA
silence,231295,231755,460,Japan,J01,NA,NA,NA,NA
silence,233291,233507,216,Japan,J01,NA,NA,NA,NA
silence,237523,242085,4562,Japan,J01,NA,NA,NA,NA
silence,245811,245971,160,Japan,J01,NA,NA,NA,NA
silence,247032,247347,315,Japan,J01,NA,NA,NA,NA
silence,247695,248764,1069,Japan,J01,NA,NA,NA,NA
silence,249879,251772,1893,Japan,J01,NA,NA,NA,NA
silence,254374,256877,2503,Japan,J01,NA,NA,NA,NA
silence,260479,260844,365,Japan,J01,NA,NA,NA,NA
silence,265879,267015,1136,Japan,J01,NA,NA,NA,NA
silence,270951,276076,5125,Japan,J01,NA,NA,NA,NA
silence,276717,279330,2613,Japan,J01,NA,NA,NA,NA
silence,280733,282026,1293,Japan,J01,NA,NA,NA,NA
mother_gesture,281888,282662,774,Japan,J01,NA,NA,NA,NA
mother_gesture,282720,283794,1074,Japan,J01,NA,NA,NA,NA
silence,286651,288051,1400,Japan,J01,NA,NA,NA,NA
silence,289699,290065,366,Japan,J01,NA,NA,NA,NA
silence,290606,293258,2652,Japan,J01,NA,NA,NA,NA
mother_gesture,292564,294220,1656,Japan,J01,NA,NA,NA,NA
silence,294435,294534,99,Japan,J01,NA,NA,NA,NA
silence,295930,296789,859,Japan,J01,NA,NA,NA,NA
silence,297744,297993,249,Japan,J01,NA,NA,NA,NA
father,297993,298639,646,Japan,J01,m,NA,NA,a
silence,298639,300639,2000,Japan,J01,NA,NA,NA,NA
silence,301717,302175,458,Japan,J01,NA,NA,NA,NA
silence,302980,303418,438,Japan,J01,NA,NA,NA,NA
mother,303418,304067,649,Japan,J01,c,NA,NA,a
silence,304067,304644,577,Japan,J01,NA,NA,NA,NA
silence,307347,308568,1221,Japan,J01,NA,NA,NA,NA
mother_gesture,308336,309425,1089,Japan,J01,NA,NA,NA,NA
silence,309611,312637,3026,Japan,J01,NA,NA,NA,NA
silence,313037,313330,293,Japan,J01,NA,NA,NA,NA
silence,314936,316347,1411,Japan,J01,NA,NA,NA,NA
silence,319965,321397,1432,Japan,J01,NA,NA,NA,NA
silence,323390,324286,896,Japan,J01,NA,NA,NA,NA
silence,325043,325131,88,Japan,J01,NA,NA,NA,NA
silence,325921,326551,630,Japan,J01,NA,NA,NA,NA
silence,330616,331197,581,Japan,J01,NA,NA,NA,NA
silence,331789,332838,1049,Japan,J01,NA,NA,NA,NA
silence,333197,334982,1785,Japan,J01,NA,NA,NA,NA
silence,336949,338474,1525,Japan,J01,NA,NA,NA,NA
silence,339617,340010,393,Japan,J01,NA,NA,NA,NA
silence,341549,341949,400,Japan,J01,NA,NA,NA,NA
silence,345076,345601,525,Japan,J01,NA,NA,NA,NA
silence,347131,347203,72,Japan,J01,NA,NA,NA,NA
silence,348421,352689,4268,Japan,J01,NA,NA,NA,NA
silence,353799,360131,6332,Japan,J01,NA,NA,NA,NA
silence,364711,364885,174,Japan,J01,NA,NA,NA,NA
silence,367279,367291,12,Japan,J01,NA,NA,NA,NA
silence,369186,369196,10,Japan,J01,NA,NA,NA,NA
silence,370947,373734,2787,Japan,J01,NA,NA,NA,NA
child_gesture,374829,377239,2410,Japan,J01,NA,NA,NA,NA
silence,376789,379474,2685,Japan,J01,NA,NA,NA,NA
silence,380037,380644,607,Japan,J01,NA,NA,NA,NA
child_gesture,380436,381765,1329,Japan,J01,NA,NA,NA,NA
child,380644,381327,683,Japan,J01,m,NA,NA,a
silence,381327,381374,47,Japan,J01,NA,NA,NA,NA
silence,381673,382458,785,Japan,J01,NA,NA,NA,NA
silence,385063,385899,836,Japan,J01,NA,NA,NA,NA
silence,388010,388043,33,Japan,J01,NA,NA,NA,NA
father_gesture,393699,394446,747,Japan,J01,NA,NA,NA,NA
silence,396601,396971,370,Japan,J01,NA,NA,NA,NA
silence,397562,397697,135,Japan,J01,NA,NA,NA,NA
silence,398104,398192,88,Japan,J01,NA,NA,NA,NA
silence,398811,398927,116,Japan,J01,NA,NA,NA,NA
silence,399391,399479,88,Japan,J01,NA,NA,NA,NA
silence,399833,400059,226,Japan,J01,NA,NA,NA,NA
silence,400779,400998,219,Japan,J01,NA,NA,NA,NA
silence,401678,402980,1302,Japan,J01,NA,NA,NA,NA
silence,403457,403579,122,Japan,J01,NA,NA,NA,NA
silence,404110,404327,217,Japan,J01,NA,NA,NA,NA
silence,406589,406837,248,Japan,J01,NA,NA,NA,NA
child_gesture,406804,407655,851,Japan,J01,NA,NA,NA,NA
silence,407796,409144,1348,Japan,J01,NA,NA,NA,NA
silence,412683,413938,1255,Japan,J01,NA,NA,NA,NA
silence,414414,414711,297,Japan,J01,NA,NA,NA,NA
child_gesture,414941,416629,1688,Japan,J01,NA,NA,NA,NA
silence,415016,415030,14,Japan,J01,NA,NA,NA,NA
silence,417706,418434,728,Japan,J01,NA,NA,NA,NA
silence,419885,421258,1373,Japan,J01,NA,NA,NA,NA
silence,425906,426446,540,Japan,J01,NA,NA,NA,NA
silence,428162,429645,1483,Japan,J01,NA,NA,NA,NA
silence,434789,436164,1375,Japan,J01,NA,NA,NA,NA
silence,442363,442916,553,Japan,J01,NA,NA,NA,NA
silence,448750,449231,481,Japan,J01,NA,NA,NA,NA
silence,451070,453499,2429,Japan,J01,NA,NA,NA,NA
silence,455635,459866,4231,Japan,J01,NA,NA,NA,NA
child_gesture,461704,463712,2008,Japan,J01,NA,NA,NA,NA
silence,465102,471440,6338,Japan,J01,NA,NA,NA,NA
silence,474391,474507,116,Japan,J01,NA,NA,NA,NA
silence,474833,476347,1514,Japan,J01,NA,NA,NA,NA
silence,479367,481695,2328,Japan,J01,NA,NA,NA,NA
silence,482833,483098,265,Japan,J01,NA,NA,NA,NA
silence,487236,488849,1613,Japan,J01,NA,NA,NA,NA
silence,489723,489772,49,Japan,J01,NA,NA,NA,NA
silence,490081,491418,1337,Japan,J01,NA,NA,NA,NA
silence,492330,492521,191,Japan,J01,NA,NA,NA,NA
silence,493032,493241,209,Japan,J01,NA,NA,NA,NA
silence,493772,494551,779,Japan,J01,NA,NA,NA,NA
silence,497142,497253,111,Japan,J01,NA,NA,NA,NA
silence,499385,500385,1000,Japan,J01,NA,NA,NA,NA
silence,502827,502899,72,Japan,J01,NA,NA,NA,NA
silence,505010,505436,426,Japan,J01,NA,NA,NA,NA
silence,507588,507803,215,Japan,J01,NA,NA,NA,NA
child,507803,508616,813,Japan,J01,m,NA,NA,a
silence,508616,508623,7,Japan,J01,NA,NA,NA,NA
silence,510302,511510,1208,Japan,J01,NA,NA,NA,NA
child_gesture,511167,514136,2969,Japan,J01,NA,NA,NA,NA
silence,512061,512352,291,Japan,J01,NA,NA,NA,NA
silence,515785,515893,108,Japan,J01,NA,NA,NA,NA
silence,517244,517452,208,Japan,J01,NA,NA,NA,NA
silence,520109,520745,636,Japan,J01,NA,NA,NA,NA
child_gesture,520712,521923,1211,Japan,J01,NA,NA,NA,NA
silence,521074,521079,5,Japan,J01,NA,NA,NA,NA
silence,521892,521965,73,Japan,J01,NA,NA,NA,NA
silence,522623,522916,293,Japan,J01,NA,NA,NA,NA
silence,524227,524637,410,Japan,J01,NA,NA,NA,NA
silence,526023,526044,21,Japan,J01,NA,NA,NA,NA
mother,526203,533728,7525,Japan,J01,f,NA,NA,q
silence,533728,534081,353,Japan,J01,NA,NA,NA,NA
silence,534420,535269,849,Japan,J01,NA,NA,NA,NA
silence,538960,539307,347,Japan,J01,NA,NA,NA,NA
silence,544198,544877,679,Japan,J01,NA,NA,NA,NA
silence,548358,548435,77,Japan,J01,NA,NA,NA,NA
silence,553855,555308,1453,Japan,J01,NA,NA,NA,NA
silence,560838,562678,1840,Japan,J01,NA,NA,NA,NA
silence,563258,563529,271,Japan,J01,NA,NA,NA,NA
silence,563960,564159,199,Japan,J01,NA,NA,NA,NA
silence,565601,566010,409,Japan,J01,NA,NA,NA,NA
silence,566553,569744,3191,Japan,J01,NA,NA,NA,NA
silence,579347,580142,795,Japan,J01,NA,NA,NA,NA
silence,593712,596517,2805,Japan,J01,NA,NA,NA,NA
silence,597591,598700,1109,Japan,J01,NA,NA,NA,NA
mother,2568,5070,2502,Japan,J02,b,1,1,a
mother,5927,7977,2050,Japan,J02,c,2,1,q
mother,13875,14285,410,Japan,J02,c,2,2,a
father,16154,18944,2790,Japan,J02,m,3,1,a
mother,17695,17966,271,Japan,J02,f,3,2,a
mother,19011,19497,486,Japan,J02,f,3,3,q
father,19511,20102,591,Japan,J02,m,3,4,a
mother,21788,22894,1106,Japan,J02,f,3,5,a
father,23446,24135,689,Japan,J02,f,3,6,a
father,26315,28374,2059,Japan,J02,m,3,7,a
mother,28336,29011,675,Japan,J02,f,3,8,a
child,37368,39848,2480,Japan,J02,m,3,9,q
mother,39889,41174,1285,Japan,J02,c,3,10,a
child,41141,42956,1815,Japan,J02,m,3,11,q
mother,43380,44806,1426,Japan,J02,m,3,12,a
child,45552,47494,1942,Japan,J02,m,3,13,a
mother,47867,50220,2353,Japan,J02,c,3,14,a
child,52735,53460,725,Japan,J02,m,3,15,q
mother,53823,54284,461,Japan,J02,c,3,16,q
father,20128,20953,825,Japan,J02,b,4,1,a
father,55006,56133,1127,Japan,J02,c,5,1,i
father,60155,61320,1165,Japan,J02,c,6,1,a
child,62789,64611,1822,Japan,J02,f,6,2,a
mother,64568,67392,2824,Japan,J02,c,7,1,a
father,67427,68133,706,Japan,J02,m,7,2,q
child,70898,73299,2401,Japan,J02,m,7,3,a
mother,73291,74065,774,Japan,J02,c,7,4,q
child,75014,75716,702,Japan,J02,m,7,5,a
mother,76240,77001,761,Japan,J02,c,7,6,q
child,77184,77455,271,Japan,J02,m,7,7,a
mother,77430,78365,935,Japan,J02,c,7,8,a
mother,79942,81819,1877,Japan,J02,c,7,9,a
child,80104,80650,546,Japan,J02,m,7,10,a
child,82168,83141,973,Japan,J02,m,7,11,a
child,84737,86328,1591,Japan,J02,m,7,12,a
mother,87988,90463,2475,Japan,J02,c,7,13,a
mother,90596,92275,1679,Japan,J02,c,8,1,i
child,93138,94901,1763,Japan,J02,m,8,2,a
mother,95188,95581,393,Japan,J02,c,8,3,a
child,95779,96386,607,Japan,J02,m,8,4,q
mother,96726,98137,1411,Japan,J02,c,8,5,i
child,98144,98534,390,Japan,J02,m,8,6,a
mother,99295,99757,462,Japan,J02,c,8,7,q
child,100963,102049,1086,Japan,J02,c,8,8,q
father,102679,103653,974,Japan,J02,c,8,9,a
mother,102733,103640,907,Japan,J02,c,8,10,a
child,103735,104392,657,Japan,J02,m,9,1,a
father,118092,119271,1179,Japan,J02,c,10,1,a
mother,118238,120148,1910,Japan,J02,o,11,1,q
mother,150745,152723,1978,Japan,J02,c,12,1,a
father,152929,153375,446,Japan,J02,m,12,2,a
child,156954,157785,831,Japan,J02,m,13,1,a
mother,161874,162732,858,Japan,J02,c,13,2,a
child,162898,163154,256,Japan,J02,m,13,3,a
mother,163237,163594,357,Japan,J02,c,13,4,a
mother,166795,167590,795,Japan,J02,c,13,5,a
mother,171894,172338,444,Japan,J02,c,13,6,q
mother,192972,193929,957,Japan,J02,c,14,1,a
father,199987,201412,1425,Japan,J02,m,15,1,q
mother,202624,203061,437,Japan,J02,f,15,2,q
father,203099,203395,296,Japan,J02,m,15,3,a
mother,204126,204637,511,Japan,J02,f,15,4,q
father,204668,205000,332,Japan,J02,m,15,5,a
mother,206821,210738,3917,Japan,J02,f,15,6,a
father,210536,211026,490,Japan,J02,m,15,7,a
mother,225831,229463,3632,Japan,J02,f,15,8,a
father,227157,227874,717,Japan,J02,m,15,9,a
mother,229502,231303,1801,Japan,J02,c,15,10,q
child,230827,231766,939,Japan,J02,m,15,11,a
mother,233464,238099,4635,Japan,J02,f,15,12,a
father,216537,219880,3343,Japan,J02,c,16,1,i
child,218512,220740,2228,Japan,J02,f,16,2,a
father,237930,238935,1005,Japan,J02,b,17,1,a
child,239594,240500,906,Japan,J02,m,18,1,a
mother,241005,241729,724,Japan,J02,c,18,2,a
child,241840,242797,957,Japan,J02,m,19,1,q
mother,242951,243806,855,Japan,J02,c,19,2,a
mother,246270,252524,6254,Japan,J02,f,20,1,a
child,253049,257574,4525,Japan,J02,m,21,1,a
mother,257828,260684,2856,Japan,J02,c,21,2,q
child,260848,261312,464,Japan,J02,m,21,3,a
mother,265535,266595,1060,Japan,J02,c,21,4,q
child,267051,270853,3802,Japan,J02,m,21,5,a
mother,270590,272474,1884,Japan,J02,c,21,6,a
child,275795,278998,3203,Japan,J02,b,22,1,a
father,279042,280889,1847,Japan,J02,c,22,2,i
mother,282900,293066,10166,Japan,J02,f,23,1,a
father,290381,290872,491,Japan,J02,m,23,2,a
father,293082,293566,484,Japan,J02,m,23,3,a
mother,295822,298502,2680,Japan,J02,f,23,4,a
father,298418,299100,682,Japan,J02,m,23,5,a
mother,304145,309885,5740,Japan,J02,f,23,6,a
mother,312512,316887,4375,Japan,J02,f,23,7,a
father,316912,317711,799,Japan,J02,m,23,8,a
mother,319292,326802,7510,Japan,J02,f,23,9,a
father,326880,328884,2004,Japan,J02,m,23,10,q
mother,330546,346220,15674,Japan,J02,f,23,11,a
child,339027,339378,351,Japan,J02,b,24,1,a
child,344861,346278,1417,Japan,J02,b,24,2,a
father,345356,349927,4571,Japan,J02,c,24,3,q
child,349993,350466,473,Japan,J02,f,24,4,a
mother,351314,363988,12674,Japan,J02,f,25,1,a
mother,372105,392126,20021,Japan,J02,f,25,2,a
father,363034,369392,6358,Japan,J02,c,26,1,a
father,376332,377023,691,Japan,J02,c,26,2,q
father,383237,384171,934,Japan,J02,c,26,3,a
father,398126,398988,862,Japan,J02,c,26,4,q
father,404045,409144,5099,Japan,J02,c,26,5,a
child,408954,411801,2847,Japan,J02,o,26,6,a
mother,417872,424729,6857,Japan,J02,c,26,7,i
mother,429725,431695,1970,Japan,J02,f,27,1,a
father,431967,432773,806,Japan,J02,m,27,2,a
father,435094,435775,681,Japan,J02,c,28,1,a
mother,436231,436718,487,Japan,J02,f,28,2,a
mother,448339,450783,2444,Japan,J02,c,29,1,a
mother,453867,458829,4962,Japan,J02,c,29,2,a
mother,465922,467566,1644,Japan,J02,c,29,3,q
child,477306,480246,2940,Japan,J02,m,30,1,q
mother,480428,485251,4823,Japan,J02,c,30,2,a
mother,492415,504975,12560,Japan,J02,c,31,1,q
child,505342,505718,376,Japan,J02,m,31,2,q
father,514140,515374,1234,Japan,J02,c,32,1,i
child,515880,517978,2098,Japan,J02,m,32,2,a
mother,516913,517801,888,Japan,J02,NA,32,3,a
mother,527189,527904,715,Japan,J02,NA,33,1,a
child,528488,529409,921,Japan,J02,m,33,2,a
mother,530233,532630,2397,Japan,J02,c,33,3,a
father,533013,533830,817,Japan,J02,c,33,4,q
mother,537332,538558,1226,Japan,J02,c,33,5,a
child,538948,540114,1166,Japan,J02,m,33,6,a
mother,540303,540875,572,Japan,J02,c,33,7,a
child,544888,546700,1812,Japan,J02,m,33,8,a
mother,546490,547097,607,Japan,J02,c,33,9,q
child,547589,549289,1700,Japan,J02,m,33,10,a
mother,549329,550240,911,Japan,J02,c,33,11,q
father,551796,553116,1320,Japan,J02,c,33,12,q
father,564521,565220,699,Japan,J02,b,34,1,a
child,568957,576546,7589,Japan,J02,o,35,1,q
father,573790,579737,5947,Japan,J02,m,35,2,a
mother,579783,581652,1869,Japan,J02,b,35,3,a
silence,5070,5927,857,Japan,J02,NA,NA,NA,NA
silence,7977,13875,5898,Japan,J02,NA,NA,NA,NA
silence,14285,16154,1869,Japan,J02,NA,NA,NA,NA
silence,18944,19011,67,Japan,J02,NA,NA,NA,NA
silence,19497,19511,14,Japan,J02,NA,NA,NA,NA
silence,20102,20128,26,Japan,J02,NA,NA,NA,NA
silence,20953,21788,835,Japan,J02,NA,NA,NA,NA
silence,22894,23446,552,Japan,J02,NA,NA,NA,NA
father_gesture,23295,25397,2102,Japan,J02,NA,NA,NA,NA
silence,24135,26315,2180,Japan,J02,NA,NA,NA,NA
silence,29011,37368,8357,Japan,J02,NA,NA,NA,NA
child_gesture,37070,38737,1667,Japan,J02,NA,NA,NA,NA
silence,39848,39889,41,Japan,J02,NA,NA,NA,NA
silence,42956,43380,424,Japan,J02,NA,NA,NA,NA
silence,44806,45552,746,Japan,J02,NA,NA,NA,NA
child_gesture,45183,47112,1929,Japan,J02,NA,NA,NA,NA
silence,47494,47867,373,Japan,J02,NA,NA,NA,NA
silence,50220,52735,2515,Japan,J02,NA,NA,NA,NA
silence,53460,53823,363,Japan,J02,NA,NA,NA,NA
silence,54284,55006,722,Japan,J02,NA,NA,NA,NA
father_gesture,54738,56414,1676,Japan,J02,NA,NA,NA,NA
silence,56133,60155,4022,Japan,J02,NA,NA,NA,NA
silence,61320,62789,1469,Japan,J02,NA,NA,NA,NA
silence,67392,67427,35,Japan,J02,NA,NA,NA,NA
silence,68133,70898,2765,Japan,J02,NA,NA,NA,NA
silence,74065,75014,949,Japan,J02,NA,NA,NA,NA
child_gesture,74475,76007,1532,Japan,J02,NA,NA,NA,NA
silence,75716,76240,524,Japan,J02,NA,NA,NA,NA
silence,77001,77184,183,Japan,J02,NA,NA,NA,NA
silence,78365,79942,1577,Japan,J02,NA,NA,NA,NA
silence,81819,82168,349,Japan,J02,NA,NA,NA,NA
silence,83141,84737,1596,Japan,J02,NA,NA,NA,NA
child_gesture,83712,86320,2608,Japan,J02,NA,NA,NA,NA
silence,86328,87988,1660,Japan,J02,NA,NA,NA,NA
silence,90463,90596,133,Japan,J02,NA,NA,NA,NA
silence,92275,93138,863,Japan,J02,NA,NA,NA,NA
child_gesture,93145,93546,401,Japan,J02,NA,NA,NA,NA
child_gesture,93582,93999,417,Japan,J02,NA,NA,NA,NA
child_gesture,94225,95336,1111,Japan,J02,NA,NA,NA,NA
silence,94901,95188,287,Japan,J02,NA,NA,NA,NA
silence,95581,95779,198,Japan,J02,NA,NA,NA,NA
child_gesture,95761,96669,908,Japan,J02,NA,NA,NA,NA
silence,96386,96726,340,Japan,J02,NA,NA,NA,NA
mother_gesture,96735,98137,1402,Japan,J02,NA,NA,NA,NA
silence,98137,98144,7,Japan,J02,NA,NA,NA,NA
silence,98534,99295,761,Japan,J02,NA,NA,NA,NA
silence,99757,100963,1206,Japan,J02,NA,NA,NA,NA
child_gesture,100148,102082,1934,Japan,J02,NA,NA,NA,NA
silence,102049,102679,630,Japan,J02,NA,NA,NA,NA
silence,103653,103735,82,Japan,J02,NA,NA,NA,NA
silence,104392,118092,13700,Japan,J02,NA,NA,NA,NA
silence,120148,150745,30597,Japan,J02,NA,NA,NA,NA
silence,152723,152929,206,Japan,J02,NA,NA,NA,NA
silence,153375,156954,3579,Japan,J02,NA,NA,NA,NA
silence,157785,161874,4089,Japan,J02,NA,NA,NA,NA
silence,162732,162898,166,Japan,J02,NA,NA,NA,NA
silence,163154,163237,83,Japan,J02,NA,NA,NA,NA
silence,163594,166795,3201,Japan,J02,NA,NA,NA,NA
silence,167590,171894,4304,Japan,J02,NA,NA,NA,NA
silence,172338,173392,1054,Japan,J02,NA,NA,NA,NA
child,173392,174284,892,Japan,J02,m,NA,NA,a
silence,174284,192972,18688,Japan,J02,NA,NA,NA,NA
silence,193929,199987,6058,Japan,J02,NA,NA,NA,NA
silence,201412,202624,1212,Japan,J02,NA,NA,NA,NA
silence,203061,203099,38,Japan,J02,NA,NA,NA,NA
silence,203395,204126,731,Japan,J02,NA,NA,NA,NA
silence,204637,204668,31,Japan,J02,NA,NA,NA,NA
silence,205000,206821,1821,Japan,J02,NA,NA,NA,NA
silence,211026,216537,5511,Japan,J02,NA,NA,NA,NA
silence,220740,225831,5091,Japan,J02,NA,NA,NA,NA
silence,229463,229502,39,Japan,J02,NA,NA,NA,NA
silence,231766,233464,1698,Japan,J02,NA,NA,NA,NA
silence,238935,239594,659,Japan,J02,NA,NA,NA,NA
silence,240500,241005,505,Japan,J02,NA,NA,NA,NA
silence,241729,241840,111,Japan,J02,NA,NA,NA,NA
silence,242797,242951,154,Japan,J02,NA,NA,NA,NA
silence,243806,246270,2464,Japan,J02,NA,NA,NA,NA
silence,252524,253049,525,Japan,J02,NA,NA,NA,NA
silence,257574,257828,254,Japan,J02,NA,NA,NA,NA
silence,260684,260848,164,Japan,J02,NA,NA,NA,NA
silence,261312,265535,4223,Japan,J02,NA,NA,NA,NA
silence,266595,267051,456,Japan,J02,NA,NA,NA,NA
child_gesture,268755,270819,2064,Japan,J02,NA,NA,NA,NA
silence,272474,275795,3321,Japan,J02,NA,NA,NA,NA
silence,278998,279042,44,Japan,J02,NA,NA,NA,NA
silence,280889,282900,2011,Japan,J02,NA,NA,NA,NA
silence,293066,293082,16,Japan,J02,NA,NA,NA,NA
silence,293566,295822,2256,Japan,J02,NA,NA,NA,NA
silence,299100,304145,5045,Japan,J02,NA,NA,NA,NA
silence,309885,312512,2627,Japan,J02,NA,NA,NA,NA
silence,316887,316912,25,Japan,J02,NA,NA,NA,NA
silence,317711,319292,1581,Japan,J02,NA,NA,NA,NA
silence,326802,326880,78,Japan,J02,NA,NA,NA,NA
silence,328884,330546,1662,Japan,J02,NA,NA,NA,NA
silence,349927,349993,66,Japan,J02,NA,NA,NA,NA
silence,350466,351314,848,Japan,J02,NA,NA,NA,NA
silence,369392,372105,2713,Japan,J02,NA,NA,NA,NA
silence,392126,398126,6000,Japan,J02,NA,NA,NA,NA
silence,398988,404045,5057,Japan,J02,NA,NA,NA,NA
mother,406478,408298,1820,Japan,J02,c,NA,NA,a
silence,411801,417872,6071,Japan,J02,NA,NA,NA,NA
silence,424729,429725,4996,Japan,J02,NA,NA,NA,NA
mother_gesture,428808,433119,4311,Japan,J02,NA,NA,NA,NA
silence,431695,431967,272,Japan,J02,NA,NA,NA,NA
silence,432773,435094,2321,Japan,J02,NA,NA,NA,NA
silence,435775,436231,456,Japan,J02,NA,NA,NA,NA
silence,436718,448339,11621,Japan,J02,NA,NA,NA,NA
silence,450783,453867,3084,Japan,J02,NA,NA,NA,NA
silence,458829,465922,7093,Japan,J02,NA,NA,NA,NA
silence,467566,477306,9740,Japan,J02,NA,NA,NA,NA
silence,480246,480428,182,Japan,J02,NA,NA,NA,NA
silence,485251,492415,7164,Japan,J02,NA,NA,NA,NA
silence,504975,505342,367,Japan,J02,NA,NA,NA,NA
silence,505718,514140,8422,Japan,J02,NA,NA,NA,NA
silence,515374,515880,506,Japan,J02,NA,NA,NA,NA
silence,517978,527189,9211,Japan,J02,NA,NA,NA,NA
silence,527904,528488,584,Japan,J02,NA,NA,NA,NA
silence,529409,530233,824,Japan,J02,NA,NA,NA,NA
silence,532630,533013,383,Japan,J02,NA,NA,NA,NA
silence,533830,537332,3502,Japan,J02,NA,NA,NA,NA
silence,538558,538948,390,Japan,J02,NA,NA,NA,NA
silence,540114,540303,189,Japan,J02,NA,NA,NA,NA
silence,540875,544888,4013,Japan,J02,NA,NA,NA,NA
child_gesture,544654,547367,2713,Japan,J02,NA,NA,NA,NA
silence,547097,547589,492,Japan,J02,NA,NA,NA,NA
child_gesture,547581,549781,2200,Japan,J02,NA,NA,NA,NA
silence,549289,549329,40,Japan,J02,NA,NA,NA,NA
silence,550240,551796,1556,Japan,J02,NA,NA,NA,NA
silence,553116,564521,11405,Japan,J02,NA,NA,NA,NA
silence,565220,568957,3737,Japan,J02,NA,NA,NA,NA
silence,579737,579783,46,Japan,J02,NA,NA,NA,NA
mother,1609,2609,1000,Japan,J03,c,1,1,a
child,3069,5982,2913,Japan,J03,m,2,1,i
mother,6121,7776,1655,Japan,J03,c,2,2,a
father,8927,11393,2466,Japan,J03,o,3,1,a
child,10380,11932,1552,Japan,J03,m,4,1,q
father,12393,13012,619,Japan,J03,c,4,2,q
mother,13126,14237,1111,Japan,J03,c,5,1,i
mother,14405,16684,2279,Japan,J03,c,6,1,a
child,16781,17051,270,Japan,J03,m,6,2,a
mother,16939,17632,693,Japan,J03,c,6,3,q
mother,18421,19760,1339,Japan,J03,b,7,1,a
father,19453,21308,1855,Japan,J03,b,7,2,a
child,19941,20665,724,Japan,J03,b,7,3,a
mother,20458,22268,1810,Japan,J03,b,7,4,a
child,26567,27861,1294,Japan,J03,m,8,1,a
mother,28368,30189,1821,Japan,J03,c,8,2,a
child,31346,32247,901,Japan,J03,m,9,1,q
mother,37347,37779,432,Japan,J03,c,9,2,q
child,37965,38305,340,Japan,J03,m,9,3,a
mother,38353,40279,1926,Japan,J03,c,9,4,a
child,40468,40905,437,Japan,J03,m,9,5,q
mother,41400,41779,379,Japan,J03,c,9,6,a
mother,44347,45840,1493,Japan,J03,c,10,1,q
child,55413,58229,2816,Japan,J03,m,10,2,a
mother,57726,59768,2042,Japan,J03,c,10,3,a
mother,60494,60900,406,Japan,J03,c,10,4,q
child,62153,64315,2162,Japan,J03,m,10,5,a
mother,64758,66715,1957,Japan,J03,c,10,6,q
child,66887,67272,385,Japan,J03,m,10,7,a
mother,67332,72789,5457,Japan,J03,c,10,8,a
mother,75289,77495,2206,Japan,J03,c,10,9,q
child,79376,80438,1062,Japan,J03,m,10,10,a
mother,80442,83540,3098,Japan,J03,c,10,11,a
mother,49584,54947,5363,Japan,J03,f,11,1,a
mother,86510,87905,1395,Japan,J03,f,12,1,q
father,88432,88750,318,Japan,J03,m,12,2,q
mother,88895,90784,1889,Japan,J03,f,12,3,q
child,91771,92619,848,Japan,J03,m,13,1,i
father,104024,106519,2495,Japan,J03,m,14,1,q
mother,107742,109840,2098,Japan,J03,f,14,2,q
mother,112859,117889,5030,Japan,J03,f,14,3,a
father,119750,121856,2106,Japan,J03,m,14,4,q
mother,121586,129128,7542,Japan,J03,f,14,5,a
father,130184,133821,3637,Japan,J03,m,14,6,a
mother,133953,135816,1863,Japan,J03,f,14,7,a
mother,137091,139558,2467,Japan,J03,f,14,8,q
father,139591,142573,2982,Japan,J03,m,14,9,a
child,137505,138461,956,Japan,J03,m,15,1,q
child,140407,141057,650,Japan,J03,m,15,2,q
mother,141405,145425,4020,Japan,J03,c,15,3,a
child,145757,147076,1319,Japan,J03,m,16,1,q
mother,147500,149095,1595,Japan,J03,c,16,2,a
child,154223,155211,988,Japan,J03,m,16,3,i
mother,155253,156368,1115,Japan,J03,c,16,4,q
father,150706,154724,4018,Japan,J03,m,17,1,a
mother,168547,169620,1073,Japan,J03,f,18,1,a
father,173140,174523,1383,Japan,J03,m,18,2,q
mother,175895,188042,12147,Japan,J03,f,18,3,a
father,177609,178724,1115,Japan,J03,f,18,4,a
father,182573,183272,699,Japan,J03,m,18,5,a
mother,189440,192868,3428,Japan,J03,f,19,1,a
father,194043,194600,557,Japan,J03,m,19,2,q
mother,195481,203568,8087,Japan,J03,f,19,3,a
mother,206314,211032,4718,Japan,J03,f,19,4,a
child,192340,193079,739,Japan,J03,m,20,1,a
child,218898,221824,2926,Japan,J03,m,21,1,a
mother,220679,222665,1986,Japan,J03,c,21,2,a
father,225688,226564,876,Japan,J03,o,21,3,a
mother,236547,237216,669,Japan,J03,c,21,4,q
father,237637,239439,1802,Japan,J03,m,22,1,q
mother,240416,241963,1547,Japan,J03,f,22,2,a
mother,245437,247263,1826,Japan,J03,c,23,1,i
child,247628,248019,391,Japan,J03,m,23,2,a
child,250757,252024,1267,Japan,J03,o,23,3,a
father,251115,252025,910,Japan,J03,m,24,1,q
mother,252581,265147,12566,Japan,J03,f,24,2,a
mother,286253,288738,2485,Japan,J03,c,25,1,a
mother,290045,293221,3176,Japan,J03,c,25,2,a
child,306113,307330,1217,Japan,J03,NA,26,1,q
mother,308300,309810,1510,Japan,J03,c,26,2,a
child,310091,310497,406,Japan,J03,m,26,3,a
father,310799,313569,2770,Japan,J03,m,27,1,a
mother,331354,332763,1409,Japan,J03,f,28,1,q
father,333329,333682,353,Japan,J03,m,28,2,q
mother,333874,335105,1231,Japan,J03,f,28,3,q
father,335189,335704,515,Japan,J03,m,28,4,a
mother,340358,343353,2995,Japan,J03,f,29,1,a
father,345380,347292,1912,Japan,J03,m,29,2,a
mother,345979,349489,3510,Japan,J03,f,29,3,a
father,349682,350387,705,Japan,J03,m,29,4,a
child,342125,343364,1239,Japan,J03,m,30,1,a
mother,343384,344576,1192,Japan,J03,c,30,2,a
mother,350621,352563,1942,Japan,J03,f,31,1,a
father,351268,353505,2237,Japan,J03,m,31,2,a
mother,352989,354137,1148,Japan,J03,f,31,3,a
father,354439,360299,5860,Japan,J03,m,31,4,a
mother,360563,369179,8616,Japan,J03,f,31,5,a
mother,371410,375163,3753,Japan,J03,f,31,6,a
father,375343,385659,10316,Japan,J03,m,31,7,a
mother,384975,389668,4693,Japan,J03,f,31,8,a
father,389133,392101,2968,Japan,J03,m,31,9,a
child,352260,353332,1072,Japan,J03,b,32,1,a
mother,354184,355595,1411,Japan,J03,c,32,2,a
mother,391074,394537,3463,Japan,J03,f,33,1,a
father,394667,396608,1941,Japan,J03,m,33,2,a
mother,396863,399510,2647,Japan,J03,f,33,3,a
father,399895,403145,3250,Japan,J03,m,33,4,a
mother,405348,408505,3157,Japan,J03,f,33,5,a
father,407334,408091,757,Japan,J03,m,33,6,a
father,410005,413336,3331,Japan,J03,m,33,7,a
mother,413332,415868,2536,Japan,J03,f,33,8,a
father,416299,419770,3471,Japan,J03,m,33,9,a
mother,421576,422158,582,Japan,J03,f,33,10,a
father,422226,424152,1926,Japan,J03,m,33,11,a
father,425990,427307,1317,Japan,J03,m,33,12,q
mother,427373,428512,1139,Japan,J03,f,33,13,a
father,430277,432262,1985,Japan,J03,m,33,14,a
father,435586,442836,7250,Japan,J03,m,33,15,a
mother,447898,450726,2828,Japan,J03,f,33,16,a
father,450917,452696,1779,Japan,J03,m,33,17,a
mother,451132,459037,7905,Japan,J03,f,33,18,a
child,432340,433280,940,Japan,J03,m,34,1,a
child,458067,460641,2574,Japan,J03,m,35,1,q
mother,460705,463510,2805,Japan,J03,c,35,2,a
child,462450,466462,4012,Japan,J03,m,35,3,q
mother,466158,470289,4131,Japan,J03,c,35,4,a
child,470678,471831,1153,Japan,J03,m,35,5,q
mother,472300,473841,1541,Japan,J03,c,35,6,a
child,474092,475314,1222,Japan,J03,m,35,7,a
father,474461,475387,926,Japan,J03,m,36,1,q
mother,475779,476948,1169,Japan,J03,f,36,2,q
father,476389,478562,2173,Japan,J03,m,36,3,q
mother,478284,479816,1532,Japan,J03,f,36,4,a
mother,480860,483326,2466,Japan,J03,c,37,1,a
child,484259,484824,565,Japan,J03,m,37,2,a
mother,484932,491368,6436,Japan,J03,c,37,3,a
child,492333,492790,457,Japan,J03,c,37,4,a
child,498191,499526,1335,Japan,J03,m,37,5,a
father,490270,491696,1426,Japan,J03,m,38,1,a
mother,491732,492232,500,Japan,J03,f,38,2,a
mother,497789,503926,6137,Japan,J03,f,38,3,q
father,501901,502364,463,Japan,J03,m,38,4,a
child,505383,506814,1431,Japan,J03,m,38,5,a
father,505880,512628,6748,Japan,J03,m,39,1,a
mother,512768,513642,874,Japan,J03,m,39,2,q
father,515057,517755,2698,Japan,J03,m,39,3,a
mother,517858,519889,2031,Japan,J03,f,39,4,a
father,519857,522689,2832,Japan,J03,m,39,5,a
mother,520700,530853,10153,Japan,J03,f,39,6,a
child,528327,531549,3222,Japan,J03,m,40,1,i
mother,531558,534047,2489,Japan,J03,c,40,2,a
child,534098,535734,1636,Japan,J03,m,40,3,q
mother,536042,536384,342,Japan,J03,c,40,4,q
child,537666,537975,309,Japan,J03,m,40,5,a
child,540493,544938,4445,Japan,J03,m,40,6,a
mother,543251,544163,912,Japan,J03,f,41,1,a
father,544579,544909,330,Japan,J03,m,41,2,a
mother,545106,550210,5104,Japan,J03,f,41,3,a
father,556130,557526,1396,Japan,J03,m,41,4,q
mother,550947,553426,2479,Japan,J03,f,42,1,q
child,554277,555573,1296,Japan,J03,m,43,1,i
child,557110,559067,1957,Japan,J03,m,43,2,a
mother,559265,560810,1545,Japan,J03,c,43,3,a
child,561360,563073,1713,Japan,J03,m,43,4,a
mother,563400,564464,1064,Japan,J03,c,43,5,a
father,562012,564564,2552,Japan,J03,m,44,1,q
mother,565068,572205,7137,Japan,J03,f,44,2,a
father,572233,573586,1353,Japan,J03,m,44,3,q
mother,574468,575932,1464,Japan,J03,f,44,4,a
father,576284,579329,3045,Japan,J03,m,44,5,a
mother,579638,580332,694,Japan,J03,f,44,6,a
father,580390,580887,497,Japan,J03,m,44,7,q
mother,581353,585563,4210,Japan,J03,f,44,8,a
father,587137,589549,2412,Japan,J03,m,44,9,a
mother,590137,593063,2926,Japan,J03,f,44,10,q
father,593167,593851,684,Japan,J03,m,44,11,a
child,576096,577950,1854,Japan,J03,m,45,1,a
child,595394,597067,1673,Japan,J03,o,46,1,a
father,322358,323473,1115,Japan,J03,m,47,1,q
mother,324364,324689,325,Japan,J03,f,47,2,q
father,325542,326659,1117,Japan,J03,m,47,3,q
silence,2609,3069,460,Japan,J03,NA,NA,NA,NA
silence,5982,6121,139,Japan,J03,NA,NA,NA,NA
silence,7776,8927,1151,Japan,J03,NA,NA,NA,NA
silence,11932,12393,461,Japan,J03,NA,NA,NA,NA
silence,13012,13126,114,Japan,J03,NA,NA,NA,NA
silence,14237,14405,168,Japan,J03,NA,NA,NA,NA
silence,16684,16781,97,Japan,J03,NA,NA,NA,NA
silence,17632,18421,789,Japan,J03,NA,NA,NA,NA
silence,22268,26567,4299,Japan,J03,NA,NA,NA,NA
silence,27861,28368,507,Japan,J03,NA,NA,NA,NA
silence,30189,31346,1157,Japan,J03,NA,NA,NA,NA
silence,32247,33425,1178,Japan,J03,NA,NA,NA,NA
child,33425,37164,3739,Japan,J03,m,NA,NA,q
silence,37164,37347,183,Japan,J03,NA,NA,NA,NA
silence,37779,37965,186,Japan,J03,NA,NA,NA,NA
silence,38305,38353,48,Japan,J03,NA,NA,NA,NA
silence,40279,40468,189,Japan,J03,NA,NA,NA,NA
child_gesture,40356,41328,972,Japan,J03,NA,NA,NA,NA
silence,40905,41400,495,Japan,J03,NA,NA,NA,NA
silence,41779,44347,2568,Japan,J03,NA,NA,NA,NA
silence,45840,49584,3744,Japan,J03,NA,NA,NA,NA
silence,54947,55413,466,Japan,J03,NA,NA,NA,NA
silence,59768,60494,726,Japan,J03,NA,NA,NA,NA
silence,60900,62153,1253,Japan,J03,NA,NA,NA,NA
silence,64315,64758,443,Japan,J03,NA,NA,NA,NA
silence,66715,66887,172,Japan,J03,NA,NA,NA,NA
silence,67272,67332,60,Japan,J03,NA,NA,NA,NA
silence,72789,75289,2500,Japan,J03,NA,NA,NA,NA
silence,77495,79376,1881,Japan,J03,NA,NA,NA,NA
silence,80438,80442,4,Japan,J03,NA,NA,NA,NA
silence,83540,86510,2970,Japan,J03,NA,NA,NA,NA
silence,87905,88432,527,Japan,J03,NA,NA,NA,NA
silence,88750,88895,145,Japan,J03,NA,NA,NA,NA
silence,90784,91771,987,Japan,J03,NA,NA,NA,NA
silence,92619,104024,11405,Japan,J03,NA,NA,NA,NA
silence,106519,107742,1223,Japan,J03,NA,NA,NA,NA
silence,109840,111060,1220,Japan,J03,NA,NA,NA,NA
father,111060,111715,655,Japan,J03,m,NA,NA,a
silence,111715,112859,1144,Japan,J03,NA,NA,NA,NA
silence,117889,119750,1861,Japan,J03,NA,NA,NA,NA
silence,129128,130184,1056,Japan,J03,NA,NA,NA,NA
silence,133821,133953,132,Japan,J03,NA,NA,NA,NA
silence,135816,137091,1275,Japan,J03,NA,NA,NA,NA
silence,139558,139591,33,Japan,J03,NA,NA,NA,NA
silence,145425,145757,332,Japan,J03,NA,NA,NA,NA
silence,147076,147500,424,Japan,J03,NA,NA,NA,NA
silence,149095,150706,1611,Japan,J03,NA,NA,NA,NA
silence,155211,155253,42,Japan,J03,NA,NA,NA,NA
silence,156368,164945,8577,Japan,J03,NA,NA,NA,NA
father,164945,168547,3602,Japan,J03,m,NA,NA,a
silence,169620,173140,3520,Japan,J03,NA,NA,NA,NA
silence,174523,175895,1372,Japan,J03,NA,NA,NA,NA
silence,188042,189440,1398,Japan,J03,NA,NA,NA,NA
child_gesture,191805,193520,1715,Japan,J03,NA,NA,NA,NA
silence,193079,194043,964,Japan,J03,NA,NA,NA,NA
silence,194600,195481,881,Japan,J03,NA,NA,NA,NA
silence,203568,206314,2746,Japan,J03,NA,NA,NA,NA
silence,211032,218898,7866,Japan,J03,NA,NA,NA,NA
silence,222665,225688,3023,Japan,J03,NA,NA,NA,NA
silence,226564,236547,9983,Japan,J03,NA,NA,NA,NA
silence,237216,237637,421,Japan,J03,NA,NA,NA,NA
silence,239439,240416,977,Japan,J03,NA,NA,NA,NA
silence,241963,245437,3474,Japan,J03,NA,NA,NA,NA
silence,247263,247628,365,Japan,J03,NA,NA,NA,NA
silence,248019,250757,2738,Japan,J03,NA,NA,NA,NA
silence,252025,252581,556,Japan,J03,NA,NA,NA,NA
father,258549,259123,574,Japan,J03,m,NA,NA,a
silence,265147,286253,21106,Japan,J03,NA,NA,NA,NA
silence,288738,289106,368,Japan,J03,NA,NA,NA,NA
child,289106,290484,1378,Japan,J03,m,NA,NA,a
silence,293221,306113,12892,Japan,J03,NA,NA,NA,NA
silence,307330,308300,970,Japan,J03,NA,NA,NA,NA
silence,309810,310091,281,Japan,J03,NA,NA,NA,NA
silence,310497,310799,302,Japan,J03,NA,NA,NA,NA
silence,313569,322358,8789,Japan,J03,NA,NA,NA,NA
silence,323473,324364,891,Japan,J03,NA,NA,NA,NA
silence,324689,325542,853,Japan,J03,NA,NA,NA,NA
silence,326659,331354,4695,Japan,J03,NA,NA,NA,NA
silence,332763,333329,566,Japan,J03,NA,NA,NA,NA
silence,333682,333874,192,Japan,J03,NA,NA,NA,NA
silence,335105,335189,84,Japan,J03,NA,NA,NA,NA
silence,335704,340358,4654,Japan,J03,NA,NA,NA,NA
silence,343364,343384,20,Japan,J03,NA,NA,NA,NA
silence,344576,345380,804,Japan,J03,NA,NA,NA,NA
silence,349489,349682,193,Japan,J03,NA,NA,NA,NA
silence,350387,350621,234,Japan,J03,NA,NA,NA,NA
silence,354137,354184,47,Japan,J03,NA,NA,NA,NA
silence,360299,360563,264,Japan,J03,NA,NA,NA,NA
silence,369179,371410,2231,Japan,J03,NA,NA,NA,NA
silence,375163,375343,180,Japan,J03,NA,NA,NA,NA
silence,394537,394667,130,Japan,J03,NA,NA,NA,NA
silence,396608,396863,255,Japan,J03,NA,NA,NA,NA
silence,399510,399895,385,Japan,J03,NA,NA,NA,NA
silence,403145,405348,2203,Japan,J03,NA,NA,NA,NA
silence,408505,410005,1500,Japan,J03,NA,NA,NA,NA
silence,415868,416299,431,Japan,J03,NA,NA,NA,NA
silence,419770,421576,1806,Japan,J03,NA,NA,NA,NA
silence,422158,422226,68,Japan,J03,NA,NA,NA,NA
silence,424152,425990,1838,Japan,J03,NA,NA,NA,NA
silence,427307,427373,66,Japan,J03,NA,NA,NA,NA
silence,428512,430277,1765,Japan,J03,NA,NA,NA,NA
silence,432262,432340,78,Japan,J03,NA,NA,NA,NA
silence,433280,433700,420,Japan,J03,NA,NA,NA,NA
mother,433700,435380,1680,Japan,J03,m,NA,NA,a
silence,435380,435586,206,Japan,J03,NA,NA,NA,NA
silence,442836,447898,5062,Japan,J03,NA,NA,NA,NA
silence,450726,450917,191,Japan,J03,NA,NA,NA,NA
child_gesture,457813,460230,2417,Japan,J03,NA,NA,NA,NA
silence,460641,460705,64,Japan,J03,NA,NA,NA,NA
child_gesture,461863,463629,1766,Japan,J03,NA,NA,NA,NA
child_gesture,464082,466173,2091,Japan,J03,NA,NA,NA,NA
silence,470289,470678,389,Japan,J03,NA,NA,NA,NA
child_gesture,470353,473242,2889,Japan,J03,NA,NA,NA,NA
silence,471831,472300,469,Japan,J03,NA,NA,NA,NA
silence,473841,474092,251,Japan,J03,NA,NA,NA,NA
child_gesture,473924,476185,2261,Japan,J03,NA,NA,NA,NA
silence,475387,475779,392,Japan,J03,NA,NA,NA,NA
silence,479816,479907,91,Japan,J03,NA,NA,NA,NA
child,479907,480518,611,Japan,J03,m,NA,NA,q
silence,480518,480860,342,Japan,J03,NA,NA,NA,NA
silence,483326,484259,933,Japan,J03,NA,NA,NA,NA
silence,484824,484932,108,Japan,J03,NA,NA,NA,NA
silence,491696,491732,36,Japan,J03,NA,NA,NA,NA
silence,492232,492333,101,Japan,J03,NA,NA,NA,NA
silence,492790,497789,4999,Japan,J03,NA,NA,NA,NA
silence,503926,505383,1457,Japan,J03,NA,NA,NA,NA
silence,512628,512768,140,Japan,J03,NA,NA,NA,NA
silence,513642,515057,1415,Japan,J03,NA,NA,NA,NA
silence,517755,517858,103,Japan,J03,NA,NA,NA,NA
silence,531549,531558,9,Japan,J03,NA,NA,NA,NA
silence,534047,534098,51,Japan,J03,NA,NA,NA,NA
silence,535734,536042,308,Japan,J03,NA,NA,NA,NA
silence,536384,537666,1282,Japan,J03,NA,NA,NA,NA
silence,537975,540493,2518,Japan,J03,NA,NA,NA,NA
father,540932,543115,2183,Japan,J03,m,NA,NA,q
silence,544938,545106,168,Japan,J03,NA,NA,NA,NA
silence,550210,550947,737,Japan,J03,NA,NA,NA,NA
silence,553426,554277,851,Japan,J03,NA,NA,NA,NA
silence,555573,556130,557,Japan,J03,NA,NA,NA,NA
silence,559067,559265,198,Japan,J03,NA,NA,NA,NA
silence,560810,561360,550,Japan,J03,NA,NA,NA,NA
silence,564564,565068,504,Japan,J03,NA,NA,NA,NA
silence,572205,572233,28,Japan,J03,NA,NA,NA,NA
silence,573586,574468,882,Japan,J03,NA,NA,NA,NA
silence,575932,576096,164,Japan,J03,NA,NA,NA,NA
silence,579329,579638,309,Japan,J03,NA,NA,NA,NA
silence,580332,580390,58,Japan,J03,NA,NA,NA,NA
silence,580887,581353,466,Japan,J03,NA,NA,NA,NA
silence,585563,587137,1574,Japan,J03,NA,NA,NA,NA
silence,589549,590137,588,Japan,J03,NA,NA,NA,NA
silence,593063,593167,104,Japan,J03,NA,NA,NA,NA
silence,593851,595394,1543,Japan,J03,NA,NA,NA,NA
silence,597067,597137,70,Japan,J03,NA,NA,NA,NA
father,790,2865,2075,Japan,J04,c,1,1,a
child,2010,3897,1887,Japan,J04,b,2,1,a
mother,3510,4134,624,Japan,J04,c,2,2,a
father,4203,5507,1304,Japan,J04,c,2,3,i
child,7140,9162,2022,Japan,J04,b,2,4,i
mother,4322,5891,1569,Japan,J04,f,3,1,q
child,9521,12341,2820,Japan,J04,m,4,1,a
mother,11969,12458,489,Japan,J04,c,4,2,a
mother,14107,16796,2689,Japan,J04,c,5,1,a
mother,18017,19190,1173,Japan,J04,b,6,1,a
father,18194,19800,1606,Japan,J04,c,6,2,a
father,19844,23513,3669,Japan,J04,b,6,3,a
child,19919,23362,3443,Japan,J04,b,6,4,a
mother,21869,23348,1479,Japan,J04,b,6,5,a
mother,23548,25121,1573,Japan,J04,c,7,1,q
child,25127,25500,373,Japan,J04,m,7,2,a
mother,25583,26569,986,Japan,J04,m,7,3,a
child,27836,32245,4409,Japan,J04,m,7,4,a
mother,32432,33948,1516,Japan,J04,c,7,5,a
child,37416,41513,4097,Japan,J04,m,7,6,a
mother,41321,41845,524,Japan,J04,c,7,7,a
father,32900,34217,1317,Japan,J04,m,8,1,a
mother,34114,36210,2096,Japan,J04,f,8,2,a
mother,42072,43603,1531,Japan,J04,c,9,1,q
mother,45493,47638,2145,Japan,J04,c,10,1,a
child,47725,48399,674,Japan,J04,m,11,1,a
mother,48609,49307,698,Japan,J04,c,11,2,q
father,49410,51610,2200,Japan,J04,c,11,3,q
child,51875,52792,917,Japan,J04,m,11,4,a
mother,53354,54486,1132,Japan,J04,c,11,5,a
child,55482,57444,1962,Japan,J04,m,11,6,a
mother,57543,59725,2182,Japan,J04,c,11,7,a
child,60620,61504,884,Japan,J04,m,11,8,a
mother,63306,64561,1255,Japan,J04,o,12,1,a
mother,71985,73390,1405,Japan,J04,c,13,1,q
father,76783,78707,1924,Japan,J04,c,14,1,q
father,82865,83672,807,Japan,J04,c,14,2,a
mother,79116,80903,1787,Japan,J04,c,15,1,a
mother,86604,88289,1685,Japan,J04,c,15,2,a
child,94482,96322,1840,Japan,J04,m,15,3,a
child,102002,104173,2171,Japan,J04,m,15,4,q
father,130058,131976,1918,Japan,J04,m,16,1,a
mother,132003,132796,793,Japan,J04,f,16,2,q
father,132714,133169,455,Japan,J04,m,16,3,a
father,142203,143238,1035,Japan,J04,NA,16,4,q
child,143294,143814,520,Japan,J04,f,16,5,a
mother,144118,145134,1016,Japan,J04,c,17,1,q
father,147204,148562,1358,Japan,J04,c,17,2,q
father,149396,151996,2600,Japan,J04,c,17,3,a
mother,152432,154155,1723,Japan,J04,c,18,1,a
father,153479,157455,3976,Japan,J04,c,18,2,a
child,163555,165252,1697,Japan,J04,NA,18,3,a
father,165225,166293,1068,Japan,J04,c,18,4,q
child,166465,167017,552,Japan,J04,f,18,5,a
father,172852,173886,1034,Japan,J04,m,18,6,q
mother,176195,177391,1196,Japan,J04,m,18,7,a
child,178610,183783,5173,Japan,J04,m,18,8,a
father,183693,185005,1312,Japan,J04,c,18,9,q
child,185031,185624,593,Japan,J04,f,18,10,a
mother,187126,189459,2333,Japan,J04,c,18,11,a
mother,190024,194545,4521,Japan,J04,f,18,12,q
father,195983,199211,3228,Japan,J04,m,18,13,a
father,200997,201796,799,Japan,J04,m,18,14,a
mother,201686,202617,931,Japan,J04,m,18,15,i
father,202479,203183,704,Japan,J04,m,18,16,a
mother,209515,210985,1470,Japan,J04,c,18,17,a
father,215617,217190,1573,Japan,J04,c,18,18,a
father,222493,224355,1862,Japan,J04,c,18,19,a
mother,225908,226666,758,Japan,J04,c,18,20,a
mother,231174,232548,1374,Japan,J04,b,19,1,a
child,233101,233306,205,Japan,J04,m,19,2,a
child,235640,237538,1898,Japan,J04,m,20,1,a
mother,237524,237889,365,Japan,J04,c,20,2,q
mother,244306,246328,2022,Japan,J04,f,21,1,a
father,247803,250491,2688,Japan,J04,m,21,2,a
child,254587,255499,912,Japan,J04,m,21,3,a
mother,257289,258394,1105,Japan,J04,c,21,4,q
father,259921,261169,1248,Japan,J04,b,21,5,a
mother,261183,262065,882,Japan,J04,f,21,6,q
father,261969,262547,578,Japan,J04,m,21,7,a
father,264886,267162,2276,Japan,J04,m,21,8,a
child,267206,268455,1249,Japan,J04,m,22,1,a
mother,268445,269893,1448,Japan,J04,c,22,2,a
father,270603,271203,600,Japan,J04,c,22,3,q
mother,271838,276182,4344,Japan,J04,c,22,4,a
child,280361,281514,1153,Japan,J04,m,22,5,a
father,286238,288500,2262,Japan,J04,m,23,1,q
mother,287610,290526,2916,Japan,J04,f,23,2,q
child,286692,305620,18928,Japan,J04,o,24,1,a
father,298003,298869,866,Japan,J04,c,24,2,i
father,305990,306624,634,Japan,J04,c,24,3,a
child,309283,310240,957,Japan,J04,m,24,4,a
father,310496,312223,1727,Japan,J04,c,24,5,a
child,313062,316096,3034,Japan,J04,m,24,6,a
father,317583,319757,2174,Japan,J04,c,25,1,i
child,319201,320786,1585,Japan,J04,m,25,2,a
mother,322100,323541,1441,Japan,J04,c,25,3,a
child,324571,325996,1425,Japan,J04,m,25,4,a
child,328411,349112,20701,Japan,J04,m,25,5,a
father,345409,346880,1471,Japan,J04,m,25,6,a
child,359963,360201,238,Japan,J04,m,26,1,a
mother,362038,363590,1552,Japan,J04,c,27,1,a
father,365279,368376,3097,Japan,J04,c,27,2,i
child,371543,374991,3448,Japan,J04,m,27,3,a
mother,374796,376031,1235,Japan,J04,c,27,4,a
father,375479,382700,7221,Japan,J04,c,27,5,a
mother,382974,384459,1485,Japan,J04,c,28,1,a
father,389481,391091,1610,Japan,J04,c,31,1,q
mother,389927,393803,3876,Japan,J04,c,32,1,a
child,394241,396762,2521,Japan,J04,m,32,2,a
father,402700,408424,5724,Japan,J04,m,33,1,a
mother,408838,409500,662,Japan,J04,f,33,2,q
father,409590,410190,600,Japan,J04,m,33,3,a
mother,410210,413100,2890,Japan,J04,f,33,4,a
mother,416673,417240,567,Japan,J04,f,33,5,a
father,416790,418133,1343,Japan,J04,m,33,6,a
mother,418307,422879,4572,Japan,J04,f,33,7,a
father,423983,424342,359,Japan,J04,m,33,8,a
mother,425541,427771,2230,Japan,J04,f,33,9,a
child,406184,407405,1221,Japan,J04,m,34,1,i
child,415217,416946,1729,Japan,J04,o,36,1,a
child,419488,419996,508,Japan,J04,o,37,1,a
child,424692,426797,2105,Japan,J04,b,38,1,a
father,427525,428191,666,Japan,J04,c,38,2,i
mother,430893,432079,1186,Japan,J04,c,38,3,q
father,434259,441293,7034,Japan,J04,m,38,4,a
mother,436783,437762,979,Japan,J04,f,38,5,a
child,437687,440545,2858,Japan,J04,m,38,6,a
child,443386,445692,2306,Japan,J04,m,39,1,a
mother,447996,449114,1118,Japan,J04,c,40,1,q
child,449167,449410,243,Japan,J04,m,40,2,a
mother,449796,450583,787,Japan,J04,c,40,3,q
child,451203,451886,683,Japan,J04,m,40,4,a
mother,451914,452493,579,Japan,J04,c,40,5,q
mother,452590,455991,3401,Japan,J04,c,41,1,a
child,457101,458692,1591,Japan,J04,o,41,2,a
child,460803,461178,375,Japan,J04,m,41,3,a
mother,461383,461865,482,Japan,J04,c,41,4,q
father,461686,462898,1212,Japan,J04,c,41,5,a
child,464499,468350,3851,Japan,J04,b,41,6,a
father,465686,467346,1660,Japan,J04,NA,41,7,q
mother,470509,474525,4016,Japan,J04,c,41,8,q
child,471858,472809,951,Japan,J04,NA,41,9,a
mother,478080,480069,1989,Japan,J04,c,41,10,i
child,482051,482701,650,Japan,J04,b,42,1,a
father,482711,483805,1094,Japan,J04,c,42,2,i
mother,488845,491334,2489,Japan,J04,f,43,1,a
father,491500,492180,680,Japan,J04,m,43,2,a
mother,497045,497790,745,Japan,J04,f,43,3,q
father,498190,499601,1411,Japan,J04,NA,43,4,a
father,500679,501472,793,Japan,J04,c,44,1,a
child,506206,509078,2872,Japan,J04,f,44,2,a
father,507396,509486,2090,Japan,J04,c,44,3,i
father,514458,515835,1377,Japan,J04,NA,44,4,q
child,515383,516572,1189,Japan,J04,f,44,5,a
father,516693,520900,4207,Japan,J04,c,44,6,a
mother,519927,523934,4007,Japan,J04,f,45,1,a
father,523790,525244,1454,Japan,J04,m,45,2,a
father,528396,536950,8554,Japan,J04,m,45,3,a
child,540466,543908,3442,Japan,J04,o,46,1,a
father,543990,544396,406,Japan,J04,NA,46,2,q
mother,544390,544955,565,Japan,J04,c,47,1,a
child,545115,545565,450,Japan,J04,m,47,2,a
father,546782,547915,1133,Japan,J04,c,47,3,q
child,548098,551195,3097,Japan,J04,f,47,4,a
child,553499,554388,889,Japan,J04,b,47,5,a
father,554983,556776,1793,Japan,J04,c,47,6,q
child,557932,559306,1374,Japan,J04,f,47,7,a
mother,559596,565046,5450,Japan,J04,f,47,8,a
child,562101,585759,23658,Japan,J04,o,47,9,a
father,564893,565713,820,Japan,J04,m,47,10,a
mother,587107,590996,3889,Japan,J04,c,47,11,q
child,591562,598038,6476,Japan,J04,m,47,12,a
father,592424,593824,1400,Japan,J04,c,47,13,i
mother,598507,598803,296,Japan,J04,c,47,14,q
child,599235,599562,327,Japan,J04,m,47,15,a
mother,550700,552369,1669,Japan,J04,c,48,1,a
child,119692,120703,1011,Japan,J04,m,49,1,a
silence,4134,4203,69,Japan,J04,NA,NA,NA,NA
silence,5891,7140,1249,Japan,J04,NA,NA,NA,NA
silence,9162,9521,359,Japan,J04,NA,NA,NA,NA
child_gesture,9855,13545,3690,Japan,J04,NA,NA,NA,NA
silence,12458,14107,1649,Japan,J04,NA,NA,NA,NA
silence,16796,18017,1221,Japan,J04,NA,NA,NA,NA
silence,19800,19844,44,Japan,J04,NA,NA,NA,NA
silence,23513,23548,35,Japan,J04,NA,NA,NA,NA
silence,25121,25127,6,Japan,J04,NA,NA,NA,NA
silence,25500,25583,83,Japan,J04,NA,NA,NA,NA
silence,26569,27836,1267,Japan,J04,NA,NA,NA,NA
child_gesture,27838,30000,2162,Japan,J04,NA,NA,NA,NA
silence,32245,32432,187,Japan,J04,NA,NA,NA,NA
silence,36210,37416,1206,Japan,J04,NA,NA,NA,NA
child_gesture,37003,39721,2718,Japan,J04,NA,NA,NA,NA
silence,41845,42072,227,Japan,J04,NA,NA,NA,NA
silence,43603,45493,1890,Japan,J04,NA,NA,NA,NA
silence,47638,47725,87,Japan,J04,NA,NA,NA,NA
silence,48399,48609,210,Japan,J04,NA,NA,NA,NA
silence,49307,49410,103,Japan,J04,NA,NA,NA,NA
silence,51610,51875,265,Japan,J04,NA,NA,NA,NA
child_gesture,51616,52952,1336,Japan,J04,NA,NA,NA,NA
silence,52792,53354,562,Japan,J04,NA,NA,NA,NA
silence,54486,55482,996,Japan,J04,NA,NA,NA,NA
silence,57444,57543,99,Japan,J04,NA,NA,NA,NA
silence,59725,60620,895,Japan,J04,NA,NA,NA,NA
silence,61504,63306,1802,Japan,J04,NA,NA,NA,NA
silence,64561,71985,7424,Japan,J04,NA,NA,NA,NA
silence,73390,76783,3393,Japan,J04,NA,NA,NA,NA
silence,78707,79116,409,Japan,J04,NA,NA,NA,NA
silence,80903,82865,1962,Japan,J04,NA,NA,NA,NA
silence,83672,86604,2932,Japan,J04,NA,NA,NA,NA
silence,88289,94482,6193,Japan,J04,NA,NA,NA,NA
mother,95985,100797,4812,Japan,J04,c,NA,NA,a
silence,100797,102002,1205,Japan,J04,NA,NA,NA,NA
silence,104173,119692,15519,Japan,J04,NA,NA,NA,NA
silence,120703,130058,9355,Japan,J04,NA,NA,NA,NA
silence,131976,132003,27,Japan,J04,NA,NA,NA,NA
silence,133169,142203,9034,Japan,J04,NA,NA,NA,NA
silence,143238,143294,56,Japan,J04,NA,NA,NA,NA
silence,143814,144118,304,Japan,J04,NA,NA,NA,NA
silence,145134,147204,2070,Japan,J04,NA,NA,NA,NA
silence,148562,149396,834,Japan,J04,NA,NA,NA,NA
silence,151996,152432,436,Japan,J04,NA,NA,NA,NA
silence,157455,163555,6100,Japan,J04,NA,NA,NA,NA
silence,166293,166465,172,Japan,J04,NA,NA,NA,NA
silence,167017,172852,5835,Japan,J04,NA,NA,NA,NA
silence,173886,176195,2309,Japan,J04,NA,NA,NA,NA
silence,177391,178610,1219,Japan,J04,NA,NA,NA,NA
silence,185005,185031,26,Japan,J04,NA,NA,NA,NA
silence,185624,187126,1502,Japan,J04,NA,NA,NA,NA
silence,189459,190024,565,Japan,J04,NA,NA,NA,NA
silence,194545,195983,1438,Japan,J04,NA,NA,NA,NA
silence,199211,199333,122,Japan,J04,NA,NA,NA,NA
mother,199333,200665,1332,Japan,J04,f,NA,NA,q
silence,200665,200997,332,Japan,J04,NA,NA,NA,NA
silence,203183,209515,6332,Japan,J04,NA,NA,NA,NA
silence,210985,215617,4632,Japan,J04,NA,NA,NA,NA
silence,217190,222493,5303,Japan,J04,NA,NA,NA,NA
silence,224355,225908,1553,Japan,J04,NA,NA,NA,NA
silence,226666,231174,4508,Japan,J04,NA,NA,NA,NA
silence,232548,233101,553,Japan,J04,NA,NA,NA,NA
silence,233306,235640,2334,Japan,J04,NA,NA,NA,NA
silence,237889,244306,6417,Japan,J04,NA,NA,NA,NA
silence,246328,247803,1475,Japan,J04,NA,NA,NA,NA
silence,250491,254587,4096,Japan,J04,NA,NA,NA,NA
silence,255499,257289,1790,Japan,J04,NA,NA,NA,NA
silence,258394,259921,1527,Japan,J04,NA,NA,NA,NA
silence,261169,261183,14,Japan,J04,NA,NA,NA,NA
silence,262547,264886,2339,Japan,J04,NA,NA,NA,NA
silence,267162,267206,44,Japan,J04,NA,NA,NA,NA
silence,269893,270603,710,Japan,J04,NA,NA,NA,NA
silence,271203,271838,635,Japan,J04,NA,NA,NA,NA
silence,276182,280361,4179,Japan,J04,NA,NA,NA,NA
silence,281514,286238,4724,Japan,J04,NA,NA,NA,NA
silence,305620,305990,370,Japan,J04,NA,NA,NA,NA
silence,306624,309283,2659,Japan,J04,NA,NA,NA,NA
silence,310240,310496,256,Japan,J04,NA,NA,NA,NA
silence,312223,313062,839,Japan,J04,NA,NA,NA,NA
silence,316096,317583,1487,Japan,J04,NA,NA,NA,NA
silence,320786,322100,1314,Japan,J04,NA,NA,NA,NA
silence,323541,324571,1030,Japan,J04,NA,NA,NA,NA
silence,325996,328411,2415,Japan,J04,NA,NA,NA,NA
silence,349112,349169,57,Japan,J04,NA,NA,NA,NA
mother,349169,351268,2099,Japan,J04,c,NA,NA,i
silence,351268,359963,8695,Japan,J04,NA,NA,NA,NA
silence,360201,362038,1837,Japan,J04,NA,NA,NA,NA
silence,363590,365279,1689,Japan,J04,NA,NA,NA,NA
silence,368376,371543,3167,Japan,J04,NA,NA,NA,NA
silence,382700,382974,274,Japan,J04,NA,NA,NA,NA
father,384079,385300,1221,Japan,J04,c,NA,NA,i
silence,385300,385700,400,Japan,J04,NA,NA,NA,NA
child,385700,387582,1882,Japan,J04,m,NA,NA,a
silence,387582,389481,1899,Japan,J04,NA,NA,NA,NA
silence,393803,394241,438,Japan,J04,NA,NA,NA,NA
silence,396762,402700,5938,Japan,J04,NA,NA,NA,NA
silence,408424,408838,414,Japan,J04,NA,NA,NA,NA
silence,409500,409590,90,Japan,J04,NA,NA,NA,NA
silence,410190,410210,20,Japan,J04,NA,NA,NA,NA
child,410228,411659,1431,Japan,J04,b,NA,NA,a
silence,413100,415217,2117,Japan,J04,NA,NA,NA,NA
silence,418133,418307,174,Japan,J04,NA,NA,NA,NA
silence,422879,423983,1104,Japan,J04,NA,NA,NA,NA
silence,424342,424692,350,Japan,J04,NA,NA,NA,NA
silence,428191,430893,2702,Japan,J04,NA,NA,NA,NA
silence,432079,434259,2180,Japan,J04,NA,NA,NA,NA
silence,441293,443386,2093,Japan,J04,NA,NA,NA,NA
silence,445692,447996,2304,Japan,J04,NA,NA,NA,NA
silence,449114,449167,53,Japan,J04,NA,NA,NA,NA
silence,449410,449796,386,Japan,J04,NA,NA,NA,NA
silence,450583,451203,620,Japan,J04,NA,NA,NA,NA
silence,451886,451914,28,Japan,J04,NA,NA,NA,NA
silence,452493,452590,97,Japan,J04,NA,NA,NA,NA
silence,455991,457101,1110,Japan,J04,NA,NA,NA,NA
silence,458692,460803,2111,Japan,J04,NA,NA,NA,NA
silence,461178,461383,205,Japan,J04,NA,NA,NA,NA
silence,462898,464499,1601,Japan,J04,NA,NA,NA,NA
silence,468350,470509,2159,Japan,J04,NA,NA,NA,NA
silence,474525,478080,3555,Japan,J04,NA,NA,NA,NA
silence,480069,482051,1982,Japan,J04,NA,NA,NA,NA
silence,482701,482711,10,Japan,J04,NA,NA,NA,NA
silence,483805,488845,5040,Japan,J04,NA,NA,NA,NA
silence,491334,491500,166,Japan,J04,NA,NA,NA,NA
silence,492180,497045,4865,Japan,J04,NA,NA,NA,NA
silence,497790,498190,400,Japan,J04,NA,NA,NA,NA
silence,499601,500679,1078,Japan,J04,NA,NA,NA,NA
silence,501472,506206,4734,Japan,J04,NA,NA,NA,NA
silence,509486,514458,4972,Japan,J04,NA,NA,NA,NA
silence,516572,516693,121,Japan,J04,NA,NA,NA,NA
silence,525244,528396,3152,Japan,J04,NA,NA,NA,NA
silence,536950,540466,3516,Japan,J04,NA,NA,NA,NA
silence,543908,543990,82,Japan,J04,NA,NA,NA,NA
silence,544955,545115,160,Japan,J04,NA,NA,NA,NA
silence,545565,546782,1217,Japan,J04,NA,NA,NA,NA
silence,547915,548098,183,Japan,J04,NA,NA,NA,NA
silence,552369,553499,1130,Japan,J04,NA,NA,NA,NA
silence,554388,554983,595,Japan,J04,NA,NA,NA,NA
silence,556776,557932,1156,Japan,J04,NA,NA,NA,NA
silence,559306,559596,290,Japan,J04,NA,NA,NA,NA
silence,585759,587107,1348,Japan,J04,NA,NA,NA,NA
silence,590996,591562,566,Japan,J04,NA,NA,NA,NA
child_gesture,592210,599445,7235,Japan,J04,NA,NA,NA,NA
silence,598038,598507,469,Japan,J04,NA,NA,NA,NA
silence,598803,599235,432,Japan,J04,NA,NA,NA,NA
silence,599562,599696,134,Japan,J04,NA,NA,NA,NA
mother,864,1887,1023,Japan,J05,c,1,1,a
father,3371,4179,808,Japan,J05,c,2,1,q
child,4380,4903,523,Japan,J05,f,2,2,q
father,5246,6687,1441,Japan,J05,c,3,1,a
child,9376,12433,3057,Japan,J05,f,4,1,i
mother,9444,10329,885,Japan,J05,f,4,2,q
father,10844,11290,446,Japan,J05,m,4,3,a
father,15349,16661,1312,Japan,J05,c,4,4,a
mother,16952,19491,2539,Japan,J05,c,4,5,a
father,20004,21829,1825,Japan,J05,c,4,6,a
child,24754,27034,2280,Japan,J05,b,4,7,a
mother,27268,29128,1860,Japan,J05,c,4,8,a
father,26069,26886,817,Japan,J05,c,5,1,a
child,29223,29922,699,Japan,J05,b,5,2,a
mother,30790,31797,1007,Japan,J05,c,5,3,a
child,31474,32341,867,Japan,J05,f,5,4,a
father,33687,34834,1147,Japan,J05,c,5,5,a
child,35503,36267,764,Japan,J05,f,5,6,a
father,36275,36991,716,Japan,J05,NA,5,7,a
mother,37577,39128,1551,Japan,J05,NA,6,1,q
father,39393,40849,1456,Japan,J05,m,6,2,a
father,44628,45224,596,Japan,J05,c,7,1,q
child,45775,46143,368,Japan,J05,NA,7,2,q
father,46172,46908,736,Japan,J05,c,7,3,a
child,47709,50518,2809,Japan,J05,f,7,4,q
father,51937,52547,610,Japan,J05,m,8,1,a
mother,53180,53650,470,Japan,J05,f,8,2,q
father,54231,56062,1831,Japan,J05,m,8,3,a
child,57810,58379,569,Japan,J05,m,8,4,a
mother,58655,61334,2679,Japan,J05,f,8,5,q
mother,66364,67163,799,Japan,J05,f,8,6,q
father,67312,68575,1263,Japan,J05,m,8,7,a
mother,71312,76864,5552,Japan,J05,c,8,8,a
child,68631,71970,3339,Japan,J05,f,9,1,a
child,77746,82834,5088,Japan,J05,o,11,1,a
father,78596,79849,1253,Japan,J05,c,11,2,q
father,82069,85069,3000,Japan,J05,c,12,1,a
father,89123,91525,2402,Japan,J05,c,12,2,q
mother,98274,99488,1214,Japan,J05,c,13,1,a
mother,104263,104827,564,Japan,J05,c,13,2,i
child,105654,106378,724,Japan,J05,m,13,3,a
father,106275,107522,1247,Japan,J05,c,13,4,a
father,111290,112309,1019,Japan,J05,c,13,5,a
mother,116878,118849,1971,Japan,J05,o,15,1,a
child,123312,124974,1662,Japan,J05,m,16,1,a
mother,125062,125565,503,Japan,J05,c,16,2,q
child,126011,129580,3569,Japan,J05,b,17,1,a
mother,132338,133650,1312,Japan,J05,o,18,1,a
mother,136680,137650,970,Japan,J05,f,18,2,a
father,142069,145665,3596,Japan,J05,c,19,1,q
mother,150062,152893,2831,Japan,J05,f,20,1,a
father,156421,158013,1592,Japan,J05,m,21,1,a
mother,158535,162665,4130,Japan,J05,f,21,2,a
father,173849,178945,5096,Japan,J05,c,22,1,a
mother,177864,180739,2875,Japan,J05,c,22,2,i
father,180761,181968,1207,Japan,J05,c,23,1,q
child,188379,189175,796,Japan,J05,f,23,2,a
child,195741,196790,1049,Japan,J05,f,23,3,a
father,196797,198227,1430,Japan,J05,c,23,4,i
child,198275,200209,1934,Japan,J05,f,24,1,i
child,204367,206731,2364,Japan,J05,b,24,2,i
mother,207910,210915,3005,Japan,J05,c,24,3,q
child,208371,209059,688,Japan,J05,b,24,4,a
father,208716,210313,1597,Japan,J05,c,24,5,a
child,211725,212181,456,Japan,J05,f,24,6,a
father,212834,214086,1252,Japan,J05,c,24,7,q
mother,214853,215518,665,Japan,J05,c,24,8,a
father,217202,218683,1481,Japan,J05,c,24,9,a
mother,218849,219312,463,Japan,J05,f,24,10,q
father,219569,220944,1375,Japan,J05,m,24,11,a
mother,220658,221957,1299,Japan,J05,f,24,12,a
child,222591,232959,10368,Japan,J05,b,25,1,a
mother,224966,225408,442,Japan,J05,c,25,2,a
father,232944,233971,1027,Japan,J05,c,25,3,q
mother,233000,233636,636,Japan,J05,c,25,4,a
child,234996,236511,1515,Japan,J05,f,25,5,a
father,238187,239174,987,Japan,J05,c,25,6,q
child,239577,241378,1801,Japan,J05,f,25,7,a
father,242533,243536,1003,Japan,J05,c,25,8,q
child,244444,244961,517,Japan,J05,f,25,9,a
father,247533,249319,1786,Japan,J05,c,26,1,i
father,251341,252243,902,Japan,J05,c,26,2,i
mother,252285,252876,591,Japan,J05,c,26,3,a
father,253746,258753,5007,Japan,J05,c,26,4,q
child,261209,261690,481,Japan,J05,b,27,1,a
mother,263555,264525,970,Japan,J05,c,27,2,q
father,263580,264836,1256,Japan,J05,c,27,3,i
child,267915,270694,2779,Japan,J05,f,27,4,q
father,278371,279134,763,Japan,J05,NA,28,1,i
mother,280503,281126,623,Japan,J05,f,28,2,a
father,286783,287576,793,Japan,J05,m,29,1,i
mother,288149,290900,2751,Japan,J05,f,29,2,a
child,291783,295709,3926,Japan,J05,f,30,1,q
father,295797,296491,694,Japan,J05,c,30,2,q
child,297016,298893,1877,Japan,J05,f,30,3,a
father,299044,300518,1474,Japan,J05,c,30,4,q
child,301062,302231,1169,Japan,J05,f,30,5,a
father,302194,304650,2456,Japan,J05,c,30,6,i
child,304881,308489,3608,Japan,J05,m,30,7,i
mother,308547,309289,742,Japan,J05,c,30,8,a
child,310990,311765,775,Japan,J05,f,30,9,a
mother,311680,312341,661,Japan,J05,c,30,10,a
father,318574,319560,986,Japan,J05,c,31,1,q
child,318584,318970,386,Japan,J05,f,32,1,a
father,320371,321537,1166,Japan,J05,c,32,2,i
mother,322431,323351,920,Japan,J05,c,32,3,a
child,324380,325721,1341,Japan,J05,f,33,1,a
child,327018,330125,3107,Japan,J05,f,34,1,a
mother,329864,331665,1801,Japan,J05,b,35,1,a
child,340415,342758,2343,Japan,J05,m,36,1,a
mother,342886,346591,3705,Japan,J05,c,36,2,a
father,343150,343935,785,Japan,J05,m,36,3,a
father,364819,365915,1096,Japan,J05,b,37,1,a
child,371290,373533,2243,Japan,J05,b,37,2,a
mother,373570,374756,1186,Japan,J05,c,37,3,i
child,374996,376344,1348,Japan,J05,m,37,4,a
father,376503,377290,787,Japan,J05,c,37,5,i
mother,381136,381694,558,Japan,J05,c,37,6,a
mother,385015,386327,1312,Japan,J05,b,38,1,a
father,388628,389939,1311,Japan,J05,c,38,2,q
mother,390305,391937,1632,Japan,J05,f,38,3,a
mother,400236,401040,804,Japan,J05,c,39,1,a
mother,403297,405642,2345,Japan,J05,c,39,2,a
father,406033,407503,1470,Japan,J05,c,39,3,q
child,408415,409557,1142,Japan,J05,f,39,4,a
father,400885,401603,718,Japan,J05,o,40,1,a
mother,411601,412528,927,Japan,J05,c,40,2,q
child,413187,414279,1092,Japan,J05,m,40,3,a
mother,414805,415300,495,Japan,J05,c,40,4,a
child,415371,415922,551,Japan,J05,f,41,1,a
father,416493,420091,3598,Japan,J05,c,41,2,a
child,420680,422128,1448,Japan,J05,f,41,3,q
father,422533,423307,774,Japan,J05,c,41,4,a
child,422783,425753,2970,Japan,J05,f,41,5,a
father,425481,426775,1294,Japan,J05,c,41,6,a
child,426908,428057,1149,Japan,J05,f,41,7,a
father,428118,429946,1828,Japan,J05,c,41,8,a
father,433790,434453,663,Japan,J05,c,41,9,q
father,436088,437069,981,Japan,J05,c,41,10,q
mother,438076,439100,1024,Japan,J05,o,42,1,a
child,440327,441395,1068,Japan,J05,m,42,2,a
mother,440569,442834,2265,Japan,J05,c,42,3,q
child,443283,444085,802,Japan,J05,m,42,4,a
father,444621,447547,2926,Japan,J05,c,43,1,a
father,452400,453621,1221,Japan,J05,c,43,2,a
father,457187,458841,1654,Japan,J05,c,43,3,i
father,462158,463775,1617,Japan,J05,c,43,4,a
child,467665,470944,3279,Japan,J05,m,43,5,q
mother,470562,471277,715,Japan,J05,c,43,6,q
child,450998,452163,1165,Japan,J05,m,44,1,q
mother,452172,452878,706,Japan,J05,c,44,2,a
child,454677,455759,1082,Japan,J05,m,44,3,q
mother,455981,456447,466,Japan,J05,c,44,4,q
mother,464614,466222,1608,Japan,J05,c,45,1,a
child,472650,477180,4530,Japan,J05,m,46,1,q
mother,481981,483092,1111,Japan,J05,c,46,2,a
mother,480456,481949,1493,Japan,J05,f,47,1,i
child,483966,484540,574,Japan,J05,m,47,2,q
mother,485334,486147,813,Japan,J05,b,47,3,a
father,486444,487753,1309,Japan,J05,c,47,4,a
mother,488893,492305,3412,Japan,J05,f,47,5,a
mother,494305,496172,1867,Japan,J05,c,48,1,q
father,497084,500364,3280,Japan,J05,c,48,2,a
mother,500011,501812,1801,Japan,J05,c,48,3,a
father,502716,503459,743,Japan,J05,m,48,4,a
mother,505356,509790,4434,Japan,J05,c,48,5,a
father,514739,515892,1153,Japan,J05,c,48,6,a
mother,515312,515892,580,Japan,J05,c,48,7,q
mother,516450,519484,3034,Japan,J05,f,50,1,a
father,519928,521893,1965,Japan,J05,m,50,2,a
mother,522344,524554,2210,Japan,J05,f,50,3,a
mother,524710,526155,1445,Japan,J05,c,51,1,q
mother,527702,529543,1841,Japan,J05,c,51,2,q
child,528802,530496,1694,Japan,J05,m,51,3,a
mother,530334,532974,2640,Japan,J05,c,51,4,a
mother,540050,540788,738,Japan,J05,c,51,5,a
father,542584,543572,988,Japan,J05,m,53,1,q
mother,544136,547011,2875,Japan,J05,f,53,2,a
father,551208,555158,3950,Japan,J05,o,54,1,a
mother,566915,570060,3145,Japan,J05,f,55,1,q
mother,574508,577231,2723,Japan,J05,c,56,1,a
mother,580672,588297,7625,Japan,J05,c,56,2,a
father,587094,588393,1299,Japan,J05,c,56,3,a
child,590227,591349,1122,Japan,J05,m,56,4,a
mother,591351,592381,1030,Japan,J05,c,56,5,q
child,592869,595864,2995,Japan,J05,c,56,6,a
mother,598643,599386,743,Japan,J05,c,56,7,a
silence,1887,3371,1484,Japan,J05,NA,NA,NA,NA
silence,4179,4380,201,Japan,J05,NA,NA,NA,NA
silence,4903,5246,343,Japan,J05,NA,NA,NA,NA
father_gesture,5146,6379,1233,Japan,J05,NA,NA,NA,NA
silence,6687,9376,2689,Japan,J05,NA,NA,NA,NA
child_gesture,9489,17417,7928,Japan,J05,NA,NA,NA,NA
silence,12433,15349,2916,Japan,J05,NA,NA,NA,NA
silence,16661,16952,291,Japan,J05,NA,NA,NA,NA
mother_gesture,16973,19172,2199,Japan,J05,NA,NA,NA,NA
silence,19491,20004,513,Japan,J05,NA,NA,NA,NA
silence,21829,24754,2925,Japan,J05,NA,NA,NA,NA
silence,27034,27268,234,Japan,J05,NA,NA,NA,NA
silence,29128,29223,95,Japan,J05,NA,NA,NA,NA
silence,29922,30790,868,Japan,J05,NA,NA,NA,NA
silence,32341,33687,1346,Japan,J05,NA,NA,NA,NA
silence,34834,35503,669,Japan,J05,NA,NA,NA,NA
silence,36267,36275,8,Japan,J05,NA,NA,NA,NA
silence,36991,37577,586,Japan,J05,NA,NA,NA,NA
silence,39128,39393,265,Japan,J05,NA,NA,NA,NA
silence,40849,42959,2110,Japan,J05,NA,NA,NA,NA
child,42959,44500,1541,Japan,J05,f,NA,NA,a
silence,44500,44628,128,Japan,J05,NA,NA,NA,NA
silence,45224,45775,551,Japan,J05,NA,NA,NA,NA
child_gesture,45385,46879,1494,Japan,J05,NA,NA,NA,NA
silence,46143,46172,29,Japan,J05,NA,NA,NA,NA
silence,46908,47709,801,Japan,J05,NA,NA,NA,NA
silence,50518,51937,1419,Japan,J05,NA,NA,NA,NA
silence,52547,53180,633,Japan,J05,NA,NA,NA,NA
silence,53650,54231,581,Japan,J05,NA,NA,NA,NA
silence,56062,57810,1748,Japan,J05,NA,NA,NA,NA
silence,58379,58655,276,Japan,J05,NA,NA,NA,NA
silence,61334,66364,5030,Japan,J05,NA,NA,NA,NA
silence,67163,67312,149,Japan,J05,NA,NA,NA,NA
silence,68575,68631,56,Japan,J05,NA,NA,NA,NA
silence,76864,77746,882,Japan,J05,NA,NA,NA,NA
father_gesture,81503,83062,1559,Japan,J05,NA,NA,NA,NA
silence,85069,89123,4054,Japan,J05,NA,NA,NA,NA
silence,91525,98274,6749,Japan,J05,NA,NA,NA,NA
silence,99488,104263,4775,Japan,J05,NA,NA,NA,NA
silence,104827,105654,827,Japan,J05,NA,NA,NA,NA
silence,107522,111290,3768,Japan,J05,NA,NA,NA,NA
silence,112309,116878,4569,Japan,J05,NA,NA,NA,NA
silence,118849,123312,4463,Japan,J05,NA,NA,NA,NA
silence,124974,125062,88,Japan,J05,NA,NA,NA,NA
silence,125565,126011,446,Japan,J05,NA,NA,NA,NA
silence,129580,132338,2758,Japan,J05,NA,NA,NA,NA
silence,133650,136680,3030,Japan,J05,NA,NA,NA,NA
silence,137650,142069,4419,Japan,J05,NA,NA,NA,NA
silence,145665,150062,4397,Japan,J05,NA,NA,NA,NA
silence,152893,156421,3528,Japan,J05,NA,NA,NA,NA
silence,158013,158535,522,Japan,J05,NA,NA,NA,NA
silence,162665,173849,11184,Japan,J05,NA,NA,NA,NA
silence,174785,176511,1726,Japan,J05,NA,NA,NA,NA
father_gesture,176055,178026,1971,Japan,J05,NA,NA,NA,NA
silence,180739,180761,22,Japan,J05,NA,NA,NA,NA
silence,181968,188379,6411,Japan,J05,NA,NA,NA,NA
silence,189175,195741,6566,Japan,J05,NA,NA,NA,NA
silence,196790,196797,7,Japan,J05,NA,NA,NA,NA
child_gesture,198196,200511,2315,Japan,J05,NA,NA,NA,NA
silence,198227,198275,48,Japan,J05,NA,NA,NA,NA
silence,200209,204367,4158,Japan,J05,NA,NA,NA,NA
child_gesture,203709,206900,3191,Japan,J05,NA,NA,NA,NA
silence,206731,207910,1179,Japan,J05,NA,NA,NA,NA
silence,210915,211725,810,Japan,J05,NA,NA,NA,NA
silence,212181,212834,653,Japan,J05,NA,NA,NA,NA
silence,214086,214853,767,Japan,J05,NA,NA,NA,NA
silence,215518,217202,1684,Japan,J05,NA,NA,NA,NA
father_gesture,217047,218405,1358,Japan,J05,NA,NA,NA,NA
silence,218683,218849,166,Japan,J05,NA,NA,NA,NA
silence,219312,219569,257,Japan,J05,NA,NA,NA,NA
silence,221957,222591,634,Japan,J05,NA,NA,NA,NA
child_gesture,224981,229040,4059,Japan,J05,NA,NA,NA,NA
silence,233971,234996,1025,Japan,J05,NA,NA,NA,NA
silence,236511,238187,1676,Japan,J05,NA,NA,NA,NA
silence,239174,239577,403,Japan,J05,NA,NA,NA,NA
child_gesture,240930,244959,4029,Japan,J05,NA,NA,NA,NA
silence,241378,242533,1155,Japan,J05,NA,NA,NA,NA
father_gesture,242238,243573,1335,Japan,J05,NA,NA,NA,NA
silence,243536,244444,908,Japan,J05,NA,NA,NA,NA
silence,244961,247533,2572,Japan,J05,NA,NA,NA,NA
silence,249319,251341,2022,Japan,J05,NA,NA,NA,NA
silence,252243,252285,42,Japan,J05,NA,NA,NA,NA
silence,252876,253746,870,Japan,J05,NA,NA,NA,NA
silence,258753,261209,2456,Japan,J05,NA,NA,NA,NA
silence,261690,263555,1865,Japan,J05,NA,NA,NA,NA
silence,264836,267915,3079,Japan,J05,NA,NA,NA,NA
silence,270694,278371,7677,Japan,J05,NA,NA,NA,NA
silence,279134,280503,1369,Japan,J05,NA,NA,NA,NA
silence,281126,286783,5657,Japan,J05,NA,NA,NA,NA
silence,287576,288149,573,Japan,J05,NA,NA,NA,NA
silence,290900,291783,883,Japan,J05,NA,NA,NA,NA
silence,295709,295797,88,Japan,J05,NA,NA,NA,NA
silence,296491,297016,525,Japan,J05,NA,NA,NA,NA
silence,298893,299044,151,Japan,J05,NA,NA,NA,NA
silence,300518,301062,544,Japan,J05,NA,NA,NA,NA
silence,304650,304881,231,Japan,J05,NA,NA,NA,NA
silence,308489,308547,58,Japan,J05,NA,NA,NA,NA
silence,309289,310990,1701,Japan,J05,NA,NA,NA,NA
silence,312341,318574,6233,Japan,J05,NA,NA,NA,NA
silence,319560,320371,811,Japan,J05,NA,NA,NA,NA
silence,321537,322431,894,Japan,J05,NA,NA,NA,NA
silence,323351,324380,1029,Japan,J05,NA,NA,NA,NA
father_gesture,325616,327662,2046,Japan,J05,NA,NA,NA,NA
father,325694,326944,1250,Japan,J05,c,NA,NA,a
silence,326944,327018,74,Japan,J05,NA,NA,NA,NA
silence,331665,340415,8750,Japan,J05,NA,NA,NA,NA
child_gesture,340597,343869,3272,Japan,J05,NA,NA,NA,NA
silence,342758,342886,128,Japan,J05,NA,NA,NA,NA
silence,346591,364819,18228,Japan,J05,NA,NA,NA,NA
silence,365915,371290,5375,Japan,J05,NA,NA,NA,NA
silence,373533,373570,37,Japan,J05,NA,NA,NA,NA
silence,374756,374996,240,Japan,J05,NA,NA,NA,NA
silence,376344,376503,159,Japan,J05,NA,NA,NA,NA
silence,377290,381136,3846,Japan,J05,NA,NA,NA,NA
silence,381694,385015,3321,Japan,J05,NA,NA,NA,NA
silence,386327,388628,2301,Japan,J05,NA,NA,NA,NA
silence,389939,390305,366,Japan,J05,NA,NA,NA,NA
silence,391937,400236,8299,Japan,J05,NA,NA,NA,NA
silence,401603,403297,1694,Japan,J05,NA,NA,NA,NA
silence,403989,404150,161,Japan,J05,NA,NA,NA,NA
silence,405642,406033,391,Japan,J05,NA,NA,NA,NA
silence,407503,408415,912,Japan,J05,NA,NA,NA,NA
silence,409557,411601,2044,Japan,J05,NA,NA,NA,NA
silence,412528,413187,659,Japan,J05,NA,NA,NA,NA
silence,414279,414805,526,Japan,J05,NA,NA,NA,NA
silence,415300,415371,71,Japan,J05,NA,NA,NA,NA
silence,415922,416493,571,Japan,J05,NA,NA,NA,NA
silence,420091,420680,589,Japan,J05,NA,NA,NA,NA
silence,422128,422533,405,Japan,J05,NA,NA,NA,NA
silence,426775,426908,133,Japan,J05,NA,NA,NA,NA
silence,428057,428118,61,Japan,J05,NA,NA,NA,NA
silence,429946,433790,3844,Japan,J05,NA,NA,NA,NA
silence,434453,436088,1635,Japan,J05,NA,NA,NA,NA
silence,437069,438076,1007,Japan,J05,NA,NA,NA,NA
silence,439100,440327,1227,Japan,J05,NA,NA,NA,NA
silence,442834,443283,449,Japan,J05,NA,NA,NA,NA
silence,444085,444621,536,Japan,J05,NA,NA,NA,NA
silence,447547,450998,3451,Japan,J05,NA,NA,NA,NA
silence,452163,452172,9,Japan,J05,NA,NA,NA,NA
silence,453621,454677,1056,Japan,J05,NA,NA,NA,NA
silence,455759,455981,222,Japan,J05,NA,NA,NA,NA
silence,456447,457187,740,Japan,J05,NA,NA,NA,NA
silence,458841,462158,3317,Japan,J05,NA,NA,NA,NA
silence,463775,464614,839,Japan,J05,NA,NA,NA,NA
silence,466222,467665,1443,Japan,J05,NA,NA,NA,NA
silence,471277,472650,1373,Japan,J05,NA,NA,NA,NA
silence,477180,480456,3276,Japan,J05,NA,NA,NA,NA
silence,481949,481981,32,Japan,J05,NA,NA,NA,NA
silence,483092,483966,874,Japan,J05,NA,NA,NA,NA
silence,484540,485334,794,Japan,J05,NA,NA,NA,NA
silence,486147,486444,297,Japan,J05,NA,NA,NA,NA
silence,487753,488893,1140,Japan,J05,NA,NA,NA,NA
silence,492305,494305,2000,Japan,J05,NA,NA,NA,NA
silence,496172,497084,912,Japan,J05,NA,NA,NA,NA
father_gesture,496709,497815,1106,Japan,J05,NA,NA,NA,NA
child,497268,498136,868,Japan,J05,m,NA,NA,a
silence,501812,502716,904,Japan,J05,NA,NA,NA,NA
silence,503459,505356,1897,Japan,J05,NA,NA,NA,NA
silence,509790,514739,4949,Japan,J05,NA,NA,NA,NA
silence,515892,516450,558,Japan,J05,NA,NA,NA,NA
silence,519484,519928,444,Japan,J05,NA,NA,NA,NA
silence,521893,522704,811,Japan,J05,NA,NA,NA,NA
silence,523255,524757,1502,Japan,J05,NA,NA,NA,NA
silence,525203,527702,2499,Japan,J05,NA,NA,NA,NA
child_gesture,528444,530622,2178,Japan,J05,NA,NA,NA,NA
silence,532974,540050,7076,Japan,J05,NA,NA,NA,NA
silence,540788,542584,1796,Japan,J05,NA,NA,NA,NA
silence,543572,544136,564,Japan,J05,NA,NA,NA,NA
silence,547011,551208,4197,Japan,J05,NA,NA,NA,NA
silence,555158,566915,11757,Japan,J05,NA,NA,NA,NA
silence,570060,574508,4448,Japan,J05,NA,NA,NA,NA
silence,577231,580672,3441,Japan,J05,NA,NA,NA,NA
silence,588393,590227,1834,Japan,J05,NA,NA,NA,NA
silence,591349,591351,2,Japan,J05,NA,NA,NA,NA
silence,592381,592869,488,Japan,J05,NA,NA,NA,NA
silence,595864,598643,2779,Japan,J05,NA,NA,NA,NA
mother_gesture,598480,599717,1237,Japan,J05,NA,NA,NA,NA
silence,599386,599599,213,Japan,J05,NA,NA,NA,NA
father,669,3296,2627,Japan,J06,b,1,1,a
child,1452,6087,4635,Japan,J06,b,2,1,a
father,6099,6350,251,Japan,J06,c,2,2,a
child,7289,7718,429,Japan,J06,f,2,3,a
mother,8964,11641,2677,Japan,J06,f,3,1,a
mother,18655,18949,294,Japan,J06,c,4,1,a
father,20921,22350,1429,Japan,J06,c,4,2,q
mother,25099,26140,1041,Japan,J06,f,5,1,q
father,26208,26687,479,Japan,J06,m,5,2,a
child,29991,32112,2121,Japan,J06,f,6,1,a
father,32215,32778,563,Japan,J06,c,6,2,q
child,34390,34753,363,Japan,J06,f,6,3,a
father,34829,35123,294,Japan,J06,c,6,4,q
child,35567,36045,478,Japan,J06,f,6,5,a
father,35857,36506,649,Japan,J06,c,6,6,q
child,36538,37202,664,Japan,J06,f,6,7,a
father,37345,37709,364,Japan,J06,c,6,8,q
child,38270,38499,229,Japan,J06,f,6,9,a
father,38518,38892,374,Japan,J06,c,6,10,a
child,38734,39376,642,Japan,J06,f,6,11,a
father,39363,39691,328,Japan,J06,c,6,12,q
child,39931,40379,448,Japan,J06,f,6,13,a
mother,30957,32807,1850,Japan,J06,f,7,1,q
father,33656,34132,476,Japan,J06,m,7,2,a
mother,51884,53703,1819,Japan,J06,o,8,1,a
child,57772,58733,961,Japan,J06,f,9,1,a
father,59178,59499,321,Japan,J06,c,9,2,a
father,64024,64456,432,Japan,J06,c,10,1,a
child,64505,65616,1111,Japan,J06,f,11,1,a
father,68833,69470,637,Japan,J06,c,11,2,q
father,75452,76720,1268,Japan,J06,c,12,1,a
mother,77045,79023,1978,Japan,J06,f,12,2,a
father,79086,79684,598,Japan,J06,m,12,3,q
mother,80404,81202,798,Japan,J06,f,12,4,a
father,82592,83573,981,Japan,J06,m,12,5,a
mother,83700,84867,1167,Japan,J06,f,13,1,a
father,85468,86305,837,Japan,J06,m,13,2,q
mother,86427,86935,508,Japan,J06,f,13,3,q
father,86833,87154,321,Japan,J06,m,13,4,a
child,89337,92239,2902,Japan,J06,f,14,1,a
father,91640,94123,2483,Japan,J06,c,14,2,q
mother,92986,95226,2240,Japan,J06,c,14,3,a
child,96816,99859,3043,Japan,J06,m,14,4,a
mother,99972,101626,1654,Japan,J06,c,14,5,q
child,100407,103292,2885,Japan,J06,m,14,6,a
mother,102626,104016,1390,Japan,J06,c,14,7,a
father,103835,104663,828,Japan,J06,c,14,8,a
mother,104904,107788,2884,Japan,J06,c,14,9,a
mother,109516,112098,2582,Japan,J06,f,15,1,q
father,112462,114405,1943,Japan,J06,m,15,2,a
mother,115273,116864,1591,Japan,J06,f,15,3,a
father,116692,117115,423,Japan,J06,m,15,4,a
child,124602,126433,1831,Japan,J06,m,15,5,a
mother,130119,131097,978,Japan,J06,f,15,6,q
father,131555,132036,481,Japan,J06,m,15,7,a
mother,132199,132464,265,Japan,J06,f,15,8,a
mother,119295,119911,616,Japan,J06,f,16,1,q
father,120820,123666,2846,Japan,J06,m,16,2,a
mother,138552,139238,686,Japan,J06,m,17,1,q
child,139328,139956,628,Japan,J06,m,17,2,a
mother,140582,141274,692,Japan,J06,c,17,3,q
child,143292,144552,1260,Japan,J06,m,17,4,a
mother,144945,146304,1359,Japan,J06,c,17,5,q
child,146363,146877,514,Japan,J06,m,17,6,a
father,147672,148301,629,Japan,J06,m,18,1,q
mother,148274,148633,359,Japan,J06,f,18,2,a
father,156129,157240,1111,Japan,J06,b,19,1,a
father,164499,165221,722,Japan,J06,m,20,1,q
mother,165677,171567,5890,Japan,J06,f,20,2,a
mother,178520,179219,699,Japan,J06,o,21,1,q
mother,181332,183002,1670,Japan,J06,o,21,2,a
mother,189573,191304,1731,Japan,J06,o,21,3,a
child,192578,193170,592,Japan,J06,m,21,4,a
father,193636,194436,800,Japan,J06,c,22,1,q
child,193887,198522,4635,Japan,J06,f,22,2,i
mother,198280,198677,397,Japan,J06,c,22,3,a
child,199272,200212,940,Japan,J06,f,22,4,a
child,215892,220602,4710,Japan,J06,f,23,1,i
father,220573,221282,709,Japan,J06,c,23,2,q
child,221416,221697,281,Japan,J06,f,23,3,a
father,221647,222356,709,Japan,J06,c,23,4,q
child,222232,222492,260,Japan,J06,f,23,5,a
father,222481,223222,741,Japan,J06,c,23,6,i
child,223405,224217,812,Japan,J06,f,23,7,a
father,226626,228160,1534,Japan,J06,c,24,1,a
mother,227266,229037,1771,Japan,J06,c,24,2,a
father,229339,229888,549,Japan,J06,c,24,3,a
mother,233295,237707,4412,Japan,J06,c,25,1,i
child,237012,266112,29100,Japan,J06,o,26,1,a
mother,241266,248503,7237,Japan,J06,o,26,2,a
mother,266343,267608,1265,Japan,J06,c,26,3,q
child,268222,269714,1492,Japan,J06,m,26,4,a
father,270147,270981,834,Japan,J06,m,26,5,q
mother,270885,272266,1381,Japan,J06,f,26,6,a
father,271857,272635,778,Japan,J06,c,26,7,q
child,273062,280418,7356,Japan,J06,o,26,8,a
mother,277669,278587,918,Japan,J06,c,26,9,a
father,253314,254860,1546,Japan,J06,c,27,1,a
mother,280642,284094,3452,Japan,J06,c,27,2,q
mother,286326,289755,3429,Japan,J06,c,27,3,i
mother,297349,303249,5900,Japan,J06,f,28,1,a
father,307947,308683,736,Japan,J06,c,29,1,q
mother,308492,308889,397,Japan,J06,f,29,2,a
mother,312326,313383,1057,Japan,J06,f,29,3,a
father,321496,321939,443,Japan,J06,c,30,1,q
mother,327238,328475,1237,Japan,J06,o,31,1,a
mother,336426,337461,1035,Japan,J06,c,32,1,q
child,337771,338250,479,Japan,J06,m,32,2,a
mother,338354,338570,216,Japan,J06,c,32,3,a
mother,341100,341768,668,Japan,J06,c,32,4,a
mother,347118,348226,1108,Japan,J06,c,33,1,q
father,349171,349878,707,Japan,J06,c,33,2,q
mother,350556,351328,772,Japan,J06,c,33,3,a
child,351622,352747,1125,Japan,J06,m,33,4,a
mother,352879,354614,1735,Japan,J06,c,33,5,q
child,354529,355056,527,Japan,J06,m,33,6,a
mother,355078,360128,5050,Japan,J06,c,33,7,a
mother,367947,372304,4357,Japan,J06,c,33,8,a
mother,375354,377680,2326,Japan,J06,c,33,9,a
child,360733,366702,5969,Japan,J06,o,34,1,a
father,364883,366241,1358,Japan,J06,c,34,2,a
child,374842,376502,1660,Japan,J06,b,35,1,a
child,378376,379768,1392,Japan,J06,NA,36,1,a
mother,379978,381216,1238,Japan,J06,c,36,2,a
child,381144,381503,359,Japan,J06,m,36,3,a
mother,381697,383150,1453,Japan,J06,c,36,4,a
mother,389513,392646,3133,Japan,J06,c,37,1,i
father,393993,395042,1049,Japan,J06,c,37,2,a
mother,395293,395649,356,Japan,J06,f,37,3,a
father,402333,402897,564,Japan,J06,m,38,1,a
father,408200,410179,1979,Japan,J06,m,38,2,a
mother,409896,410321,425,Japan,J06,f,38,3,a
mother,418326,420052,1726,Japan,J06,f,38,4,q
mother,422349,422785,436,Japan,J06,c,39,1,a
father,422901,423604,703,Japan,J06,c,39,2,a
mother,426304,428119,1815,Japan,J06,c,40,1,a
mother,429072,429909,837,Japan,J06,o,41,1,a
father,430565,431098,533,Japan,J06,m,41,2,q
mother,431039,431338,299,Japan,J06,f,41,3,a
mother,431951,434017,2066,Japan,J06,c,41,4,a
father,433904,434531,627,Japan,J06,b,41,5,a
mother,435188,438237,3049,Japan,J06,c,41,6,a
father,441092,441985,893,Japan,J06,c,42,1,a
child,442743,443997,1254,Japan,J06,f,42,2,a
father,443493,444075,582,Japan,J06,c,42,3,q
mother,444735,451514,6779,Japan,J06,c,42,4,q
child,451486,451744,258,Japan,J06,m,42,5,a
mother,451901,456155,4254,Japan,J06,c,42,6,a
child,459016,460442,1426,Japan,J06,m,42,7,a
mother,460439,460934,495,Japan,J06,c,42,8,a
child,461067,462295,1228,Japan,J06,m,42,9,i
father,461209,462014,805,Japan,J06,m,42,10,q
father,468721,470019,1298,Japan,J06,c,42,11,q
mother,470818,472288,1470,Japan,J06,c,42,12,a
child,472383,473400,1017,Japan,J06,m,42,13,a
mother,473547,474492,945,Japan,J06,c,42,14,q
father,474981,476212,1231,Japan,J06,c,42,15,q
mother,475846,477061,1215,Japan,J06,c,42,16,q
child,477141,477538,397,Japan,J06,f,42,17,a
mother,477454,478266,812,Japan,J06,c,42,18,q
child,478369,478690,321,Japan,J06,m,42,19,a
father,479962,481160,1198,Japan,J06,c,42,20,a
mother,485744,489622,3878,Japan,J06,c,42,21,q
child,496632,498457,1825,Japan,J06,m,42,22,a
father,498538,499055,517,Japan,J06,c,42,23,a
child,499273,500756,1483,Japan,J06,b,42,24,a
mother,499360,501227,1867,Japan,J06,f,42,25,a
child,467957,469971,2014,Japan,J06,f,43,1,a
child,501611,507420,5809,Japan,J06,m,44,1,a
mother,507393,507741,348,Japan,J06,c,44,2,a
child,508001,509126,1125,Japan,J06,m,44,3,a
mother,509166,509614,448,Japan,J06,c,44,4,a
father,509166,509610,444,Japan,J06,c,44,5,a
child,510038,512773,2735,Japan,J06,b,44,6,a
father,512493,513072,579,Japan,J06,c,44,7,a
child,514538,516479,1941,Japan,J06,b,44,8,a
mother,514589,516488,1899,Japan,J06,c,44,9,q
mother,517923,518697,774,Japan,J06,c,44,10,q
child,518146,519913,1767,Japan,J06,b,44,11,a
father,519888,520328,440,Japan,J06,c,44,12,a
child,520552,522203,1651,Japan,J06,b,44,13,a
mother,522299,522961,662,Japan,J06,c,44,14,q
child,523273,525049,1776,Japan,J06,b,44,15,a
child,527008,527861,853,Japan,J06,b,44,16,a
mother,527995,528249,254,Japan,J06,c,44,17,a
child,529997,531200,1203,Japan,J06,m,44,18,a
mother,535313,537959,2646,Japan,J06,c,45,1,a
child,538920,543074,4154,Japan,J06,m,45,2,a
father,543163,543846,683,Japan,J06,c,45,3,a
child,544009,544780,771,Japan,J06,b,45,4,a
father,548049,552752,4703,Japan,J06,c,45,5,a
father,554388,557394,3006,Japan,J06,c,45,6,a
mother,559349,561094,1745,Japan,J06,c,45,7,a
father,569304,569854,550,Japan,J06,c,45,8,a
mother,553559,554089,530,Japan,J06,o,46,1,a
mother,575431,578514,3083,Japan,J06,c,47,1,a
child,578485,578988,503,Japan,J06,m,47,2,a
mother,578934,584166,5232,Japan,J06,c,47,3,q
child,584435,584911,476,Japan,J06,m,47,4,a
father,585212,586067,855,Japan,J06,c,47,5,a
mother,587409,588067,658,Japan,J06,c,47,6,q
child,588097,588508,411,Japan,J06,m,47,7,a
mother,588512,588961,449,Japan,J06,c,47,8,a
father,591897,592769,872,Japan,J06,m,47,9,q
mother,592837,593172,335,Japan,J06,f,47,10,a
mother,597963,599655,1692,Japan,J06,c,47,11,q
father,200092,201314,1222,Japan,J06,c,48,1,i
child,201092,201802,710,Japan,J06,f,48,2,a
child,202782,204709,1927,Japan,J06,f,48,3,a
mother,206850,208128,1278,Japan,J06,c,48,4,q
silence,6087,6099,12,Japan,J06,NA,NA,NA,NA
silence,6350,7289,939,Japan,J06,NA,NA,NA,NA
silence,7718,8964,1246,Japan,J06,NA,NA,NA,NA
silence,11641,18655,7014,Japan,J06,NA,NA,NA,NA
silence,18949,20921,1972,Japan,J06,NA,NA,NA,NA
silence,22350,25099,2749,Japan,J06,NA,NA,NA,NA
mother_gesture,24637,26544,1907,Japan,J06,NA,NA,NA,NA
silence,26140,26208,68,Japan,J06,NA,NA,NA,NA
silence,26687,29991,3304,Japan,J06,NA,NA,NA,NA
silence,32807,33656,849,Japan,J06,NA,NA,NA,NA
silence,34132,34390,258,Japan,J06,NA,NA,NA,NA
silence,34753,34829,76,Japan,J06,NA,NA,NA,NA
silence,35123,35567,444,Japan,J06,NA,NA,NA,NA
silence,36506,36538,32,Japan,J06,NA,NA,NA,NA
silence,37202,37345,143,Japan,J06,NA,NA,NA,NA
silence,37709,38270,561,Japan,J06,NA,NA,NA,NA
silence,38499,38518,19,Japan,J06,NA,NA,NA,NA
silence,39691,39931,240,Japan,J06,NA,NA,NA,NA
silence,40379,51884,11505,Japan,J06,NA,NA,NA,NA
silence,53703,57772,4069,Japan,J06,NA,NA,NA,NA
silence,58733,59178,445,Japan,J06,NA,NA,NA,NA
silence,59499,64024,4525,Japan,J06,NA,NA,NA,NA
silence,64456,64505,49,Japan,J06,NA,NA,NA,NA
silence,65616,68833,3217,Japan,J06,NA,NA,NA,NA
silence,69470,75452,5982,Japan,J06,NA,NA,NA,NA
silence,76720,77045,325,Japan,J06,NA,NA,NA,NA
silence,79023,79086,63,Japan,J06,NA,NA,NA,NA
silence,79684,80404,720,Japan,J06,NA,NA,NA,NA
silence,81202,82592,1390,Japan,J06,NA,NA,NA,NA
silence,83573,83700,127,Japan,J06,NA,NA,NA,NA
silence,84867,85468,601,Japan,J06,NA,NA,NA,NA
silence,86305,86427,122,Japan,J06,NA,NA,NA,NA
silence,87154,89337,2183,Japan,J06,NA,NA,NA,NA
child_gesture,91275,92699,1424,Japan,J06,NA,NA,NA,NA
silence,95226,96816,1590,Japan,J06,NA,NA,NA,NA
child_gesture,97681,100003,2322,Japan,J06,NA,NA,NA,NA
silence,99859,99972,113,Japan,J06,NA,NA,NA,NA
silence,104663,104904,241,Japan,J06,NA,NA,NA,NA
silence,107788,109516,1728,Japan,J06,NA,NA,NA,NA
mother_gesture,109637,111239,1602,Japan,J06,NA,NA,NA,NA
silence,112098,112462,364,Japan,J06,NA,NA,NA,NA
silence,114405,115273,868,Japan,J06,NA,NA,NA,NA
silence,117115,119295,2180,Japan,J06,NA,NA,NA,NA
silence,119911,120820,909,Japan,J06,NA,NA,NA,NA
silence,123666,124602,936,Japan,J06,NA,NA,NA,NA
silence,126433,130119,3686,Japan,J06,NA,NA,NA,NA
silence,131097,131555,458,Japan,J06,NA,NA,NA,NA
silence,132036,132199,163,Japan,J06,NA,NA,NA,NA
silence,132464,138552,6088,Japan,J06,NA,NA,NA,NA
child_gesture,137310,140089,2779,Japan,J06,NA,NA,NA,NA
silence,139238,139328,90,Japan,J06,NA,NA,NA,NA
silence,139956,140582,626,Japan,J06,NA,NA,NA,NA
silence,141274,143292,2018,Japan,J06,NA,NA,NA,NA
child_gesture,142301,144804,2503,Japan,J06,NA,NA,NA,NA
silence,144552,144945,393,Japan,J06,NA,NA,NA,NA
silence,146304,146363,59,Japan,J06,NA,NA,NA,NA
silence,146877,147672,795,Japan,J06,NA,NA,NA,NA
silence,148633,156129,7496,Japan,J06,NA,NA,NA,NA
silence,157240,164499,7259,Japan,J06,NA,NA,NA,NA
silence,165221,165677,456,Japan,J06,NA,NA,NA,NA
silence,171567,178520,6953,Japan,J06,NA,NA,NA,NA
silence,179219,181332,2113,Japan,J06,NA,NA,NA,NA
silence,183002,189573,6571,Japan,J06,NA,NA,NA,NA
silence,191304,192578,1274,Japan,J06,NA,NA,NA,NA
silence,193170,193636,466,Japan,J06,NA,NA,NA,NA
silence,198677,199272,595,Japan,J06,NA,NA,NA,NA
silence,201802,202782,980,Japan,J06,NA,NA,NA,NA
silence,204709,206850,2141,Japan,J06,NA,NA,NA,NA
mother_gesture,206071,207301,1230,Japan,J06,NA,NA,NA,NA
silence,208128,215892,7764,Japan,J06,NA,NA,NA,NA
silence,221282,221416,134,Japan,J06,NA,NA,NA,NA
father_gesture,222469,223963,1494,Japan,J06,NA,NA,NA,NA
silence,223222,223405,183,Japan,J06,NA,NA,NA,NA
silence,224217,226626,2409,Japan,J06,NA,NA,NA,NA
silence,229037,229339,302,Japan,J06,NA,NA,NA,NA
silence,229888,233295,3407,Japan,J06,NA,NA,NA,NA
silence,266112,266343,231,Japan,J06,NA,NA,NA,NA
silence,267608,268222,614,Japan,J06,NA,NA,NA,NA
silence,269714,270147,433,Japan,J06,NA,NA,NA,NA
silence,272635,273062,427,Japan,J06,NA,NA,NA,NA
silence,280418,280642,224,Japan,J06,NA,NA,NA,NA
silence,284094,286326,2232,Japan,J06,NA,NA,NA,NA
mother_gesture,286930,289363,2433,Japan,J06,NA,NA,NA,NA
silence,289755,297349,7594,Japan,J06,NA,NA,NA,NA
silence,303249,307947,4698,Japan,J06,NA,NA,NA,NA
silence,308889,312326,3437,Japan,J06,NA,NA,NA,NA
silence,313383,321496,8113,Japan,J06,NA,NA,NA,NA
silence,321939,327238,5299,Japan,J06,NA,NA,NA,NA
silence,328475,336426,7951,Japan,J06,NA,NA,NA,NA
silence,337461,337771,310,Japan,J06,NA,NA,NA,NA
silence,338250,338354,104,Japan,J06,NA,NA,NA,NA
silence,338570,341100,2530,Japan,J06,NA,NA,NA,NA
silence,341768,347118,5350,Japan,J06,NA,NA,NA,NA
silence,348226,349171,945,Japan,J06,NA,NA,NA,NA
silence,349878,350556,678,Japan,J06,NA,NA,NA,NA
silence,351328,351622,294,Japan,J06,NA,NA,NA,NA
silence,352747,352879,132,Japan,J06,NA,NA,NA,NA
silence,355056,355078,22,Japan,J06,NA,NA,NA,NA
silence,360128,360733,605,Japan,J06,NA,NA,NA,NA
silence,366702,367947,1245,Japan,J06,NA,NA,NA,NA
silence,372304,374842,2538,Japan,J06,NA,NA,NA,NA
silence,377680,378376,696,Japan,J06,NA,NA,NA,NA
silence,379768,379978,210,Japan,J06,NA,NA,NA,NA
silence,381503,381697,194,Japan,J06,NA,NA,NA,NA
silence,383150,389513,6363,Japan,J06,NA,NA,NA,NA
silence,392646,393993,1347,Japan,J06,NA,NA,NA,NA
silence,395042,395293,251,Japan,J06,NA,NA,NA,NA
silence,395649,398989,3340,Japan,J06,NA,NA,NA,NA
mother,398989,402277,3288,Japan,J06,f,NA,NA,q
silence,402277,402333,56,Japan,J06,NA,NA,NA,NA
silence,402897,408200,5303,Japan,J06,NA,NA,NA,NA
silence,410321,418326,8005,Japan,J06,NA,NA,NA,NA
silence,420052,422349,2297,Japan,J06,NA,NA,NA,NA
silence,422785,422901,116,Japan,J06,NA,NA,NA,NA
silence,423604,426304,2700,Japan,J06,NA,NA,NA,NA
silence,428119,429072,953,Japan,J06,NA,NA,NA,NA
silence,429909,430565,656,Japan,J06,NA,NA,NA,NA
silence,431338,431951,613,Japan,J06,NA,NA,NA,NA
silence,434531,435188,657,Japan,J06,NA,NA,NA,NA
silence,438237,441092,2855,Japan,J06,NA,NA,NA,NA
silence,441985,442743,758,Japan,J06,NA,NA,NA,NA
silence,444075,444735,660,Japan,J06,NA,NA,NA,NA
mother_gesture,445426,452122,6696,Japan,J06,NA,NA,NA,NA
silence,451744,451901,157,Japan,J06,NA,NA,NA,NA
silence,456155,459016,2861,Japan,J06,NA,NA,NA,NA
silence,460934,461067,133,Japan,J06,NA,NA,NA,NA
mother,461924,462514,590,Japan,J06,f,NA,NA,a
silence,462514,467957,5443,Japan,J06,NA,NA,NA,NA
father_gesture,468222,470259,2037,Japan,J06,NA,NA,NA,NA
silence,470019,470818,799,Japan,J06,NA,NA,NA,NA
silence,472288,472383,95,Japan,J06,NA,NA,NA,NA
silence,473400,473547,147,Japan,J06,NA,NA,NA,NA
silence,474492,474981,489,Japan,J06,NA,NA,NA,NA
silence,477061,477141,80,Japan,J06,NA,NA,NA,NA
silence,478266,478369,103,Japan,J06,NA,NA,NA,NA
silence,478690,479962,1272,Japan,J06,NA,NA,NA,NA
silence,481160,485744,4584,Japan,J06,NA,NA,NA,NA
mother_gesture,487868,489507,1639,Japan,J06,NA,NA,NA,NA
silence,489622,496632,7010,Japan,J06,NA,NA,NA,NA
silence,498457,498538,81,Japan,J06,NA,NA,NA,NA
silence,499055,499273,218,Japan,J06,NA,NA,NA,NA
silence,501227,501611,384,Japan,J06,NA,NA,NA,NA
silence,507741,508001,260,Japan,J06,NA,NA,NA,NA
silence,509126,509166,40,Japan,J06,NA,NA,NA,NA
silence,509614,510038,424,Japan,J06,NA,NA,NA,NA
silence,513072,514538,1466,Japan,J06,NA,NA,NA,NA
silence,516488,517923,1435,Japan,J06,NA,NA,NA,NA
silence,520328,520552,224,Japan,J06,NA,NA,NA,NA
silence,522203,522299,96,Japan,J06,NA,NA,NA,NA
silence,522961,523273,312,Japan,J06,NA,NA,NA,NA
silence,525049,527008,1959,Japan,J06,NA,NA,NA,NA
silence,527861,527995,134,Japan,J06,NA,NA,NA,NA
silence,528249,529997,1748,Japan,J06,NA,NA,NA,NA
silence,531200,535313,4113,Japan,J06,NA,NA,NA,NA
mother_gesture,533699,536250,2551,Japan,J06,NA,NA,NA,NA
silence,537959,538920,961,Japan,J06,NA,NA,NA,NA
silence,543074,543163,89,Japan,J06,NA,NA,NA,NA
silence,543846,544009,163,Japan,J06,NA,NA,NA,NA
silence,544780,548049,3269,Japan,J06,NA,NA,NA,NA
silence,552752,553559,807,Japan,J06,NA,NA,NA,NA
silence,554089,554388,299,Japan,J06,NA,NA,NA,NA
silence,557394,559349,1955,Japan,J06,NA,NA,NA,NA
silence,561094,569304,8210,Japan,J06,NA,NA,NA,NA
silence,569854,575431,5577,Japan,J06,NA,NA,NA,NA
mother_gesture,574841,576115,1274,Japan,J06,NA,NA,NA,NA
silence,584166,584435,269,Japan,J06,NA,NA,NA,NA
silence,584911,585212,301,Japan,J06,NA,NA,NA,NA
silence,586067,587409,1342,Japan,J06,NA,NA,NA,NA
silence,588067,588097,30,Japan,J06,NA,NA,NA,NA
silence,588508,588512,4,Japan,J06,NA,NA,NA,NA
silence,588961,591897,2936,Japan,J06,NA,NA,NA,NA
silence,592769,592837,68,Japan,J06,NA,NA,NA,NA
silence,593172,597963,4791,Japan,J06,NA,NA,NA,NA
mother,1695,2033,338,Japan,J07,c,1,1,a
child,2037,2827,790,Japan,J07,b,1,2,a
mother,2999,4481,1482,Japan,J07,c,1,3,a
child,3971,4297,326,Japan,J07,b,1,4,a
father,4514,5213,699,Japan,J07,b,1,5,a
child,6142,6959,817,Japan,J07,b,1,6,a
father,7054,7745,691,Japan,J07,c,1,7,a
child,8291,8826,535,Japan,J07,f,1,8,a
mother,6323,8433,2110,Japan,J07,o,2,1,a
mother,8806,11640,2834,Japan,J07,b,4,1,a
father,11764,12395,631,Japan,J07,m,4,2,a
child,14263,15000,737,Japan,J07,m,5,1,a
mother,15254,16226,972,Japan,J07,c,5,2,q
child,16225,17176,951,Japan,J07,m,5,3,q
mother,17261,18226,965,Japan,J07,c,5,4,q
mother,18819,21716,2897,Japan,J07,c,5,5,a
father,22655,23673,1018,Japan,J07,c,5,6,q
child,23816,24042,226,Japan,J07,f,5,7,a
mother,25544,30461,4917,Japan,J07,f,6,1,q
father,30072,30772,700,Japan,J07,m,6,2,a
mother,30812,31571,759,Japan,J07,f,6,3,a
father,37060,37602,542,Japan,J07,m,6,4,a
mother,38102,38661,559,Japan,J07,f,6,5,q
father,38686,39023,337,Japan,J07,m,6,6,a
mother,33178,34916,1738,Japan,J07,o,7,1,a
mother,40288,42178,1890,Japan,J07,f,7,2,a
child,36127,36599,472,Japan,J07,b,8,1,a
father,42146,42877,731,Japan,J07,m,8,2,q
mother,43116,44695,1579,Japan,J07,f,8,3,a
father,44624,45379,755,Japan,J07,m,8,4,q
mother,45385,46281,896,Japan,J07,f,8,5,a
father,45919,46477,558,Japan,J07,m,8,6,q
mother,46709,48799,2090,Japan,J07,f,8,7,a
mother,48854,50219,1365,Japan,J07,c,9,1,i
child,52932,53603,671,Japan,J07,m,9,2,q
mother,54647,55054,407,Japan,J07,c,9,3,q
child,54669,56567,1898,Japan,J07,m,10,1,q
mother,56725,57275,550,Japan,J07,c,10,2,q
child,56899,57709,810,Japan,J07,m,10,3,a
mother,59047,60026,979,Japan,J07,c,11,1,a
child,60042,60374,332,Japan,J07,m,11,2,q
mother,61150,65137,3987,Japan,J07,c,11,3,a
child,65623,65987,364,Japan,J07,m,11,4,q
mother,66668,69999,3331,Japan,J07,c,11,5,a
father,72403,73367,964,Japan,J07,m,12,1,q
mother,73557,75675,2118,Japan,J07,f,12,2,a
father,75686,75962,276,Japan,J07,m,12,3,a
child,74031,76214,2183,Japan,J07,m,13,1,q
mother,76454,88144,11690,Japan,J07,c,13,2,a
child,88208,88541,333,Japan,J07,m,13,3,a
mother,88992,92818,3826,Japan,J07,c,13,4,q
child,93805,94426,621,Japan,J07,m,13,5,a
mother,94771,95481,710,Japan,J07,c,13,6,q
child,95556,95821,265,Japan,J07,m,13,7,a
mother,95633,96206,573,Japan,J07,c,13,8,q
child,96352,96573,221,Japan,J07,m,13,9,a
mother,98659,99730,1071,Japan,J07,c,13,10,a
child,86341,87203,862,Japan,J07,o,14,1,a
mother,101592,119523,17931,Japan,J07,c,15,1,a
father,119272,120197,925,Japan,J07,c,16,1,q
mother,121304,122795,1491,Japan,J07,c,16,2,q
father,123716,125931,2215,Japan,J07,c,16,3,a
child,126302,126592,290,Japan,J07,f,16,4,q
father,126919,127679,760,Japan,J07,c,16,5,q
child,128125,131534,3409,Japan,J07,f,16,6,a
father,132130,133363,1233,Japan,J07,c,16,7,q
child,133866,135035,1169,Japan,J07,f,16,8,a
father,135356,136262,906,Japan,J07,c,16,9,q
child,136772,137103,331,Japan,J07,f,16,10,a
father,138005,138588,583,Japan,J07,c,16,11,i
mother,138075,140992,2917,Japan,J07,NA,16,12,a
child,141015,142124,1109,Japan,J07,b,16,13,a
mother,142668,148385,5717,Japan,J07,c,16,14,a
child,144893,145263,370,Japan,J07,m,16,15,a
father,149173,149776,603,Japan,J07,c,16,16,a
mother,150026,154495,4469,Japan,J07,c,16,17,q
mother,155557,157695,2138,Japan,J07,f,17,1,a
father,158514,158969,455,Japan,J07,m,17,2,a
mother,159233,162185,2952,Japan,J07,f,17,3,a
father,162623,163940,1317,Japan,J07,m,17,4,a
mother,163992,164626,634,Japan,J07,f,17,5,q
father,164637,164906,269,Japan,J07,m,17,6,a
mother,165978,167633,1655,Japan,J07,f,17,7,a
father,167562,168023,461,Japan,J07,m,17,8,a
mother,168778,171081,2303,Japan,J07,c,18,1,q
mother,172750,177681,4931,Japan,J07,c,18,2,a
father,171868,172618,750,Japan,J07,b,19,1,a
mother,178295,180550,2255,Japan,J07,c,20,1,a
father,179956,181594,1638,Japan,J07,c,20,2,a
child,181462,182618,1156,Japan,J07,b,20,3,a
child,184330,185860,1530,Japan,J07,b,20,4,a
mother,185737,186647,910,Japan,J07,c,20,5,q
mother,183081,184109,1028,Japan,J07,o,21,1,a
child,188308,190772,2464,Japan,J07,b,21,2,a
mother,192566,194517,1951,Japan,J07,c,22,1,i
mother,197452,198502,1050,Japan,J07,c,22,2,a
mother,200784,202978,2194,Japan,J07,c,22,3,q
father,202193,202976,783,Japan,J07,c,22,4,a
father,220152,220623,471,Japan,J07,m,23,1,q
mother,221192,223068,1876,Japan,J07,f,23,2,a
father,223170,224258,1088,Japan,J07,m,23,3,a
mother,227971,229702,1731,Japan,J07,o,24,1,a
child,240606,241295,689,Japan,J07,b,25,1,a
mother,241378,242902,1524,Japan,J07,c,25,2,q
father,241385,243250,1865,Japan,J07,c,25,3,q
mother,244454,246999,2545,Japan,J07,o,26,1,a
mother,249150,250384,1234,Japan,J07,f,27,1,a
father,250403,250821,418,Japan,J07,m,27,2,a
mother,251481,255557,4076,Japan,J07,f,27,3,a
father,255637,256256,619,Japan,J07,m,27,4,a
mother,258378,263406,5028,Japan,J07,f,27,5,a
father,262575,263865,1290,Japan,J07,m,27,6,a
mother,264031,265530,1499,Japan,J07,f,27,7,a
father,265575,265884,309,Japan,J07,m,27,8,a
father,267802,276446,8644,Japan,J07,c,28,1,a
mother,269389,270040,651,Japan,J07,c,28,2,i
mother,273606,274385,779,Japan,J07,c,28,3,a
mother,276550,281757,5207,Japan,J07,c,28,4,a
father,282228,283189,961,Japan,J07,m,28,5,i
child,283286,285015,1729,Japan,J07,b,29,1,q
father,284508,285845,1337,Japan,J07,c,29,2,a
mother,284985,288847,3862,Japan,J07,c,29,3,i
child,289236,290845,1609,Japan,J07,m,29,4,a
mother,291571,293771,2200,Japan,J07,c,29,5,a
child,293059,295391,2332,Japan,J07,m,29,6,a
mother,295440,295872,432,Japan,J07,c,29,7,a
mother,300385,301072,687,Japan,J07,c,29,8,a
child,301379,303020,1641,Japan,J07,b,30,1,q
mother,303964,305875,1911,Japan,J07,c,30,2,a
child,306943,307916,973,Japan,J07,b,30,3,q
father,308066,308477,411,Japan,J07,c,30,4,a
mother,308275,308626,351,Japan,J07,c,30,5,a
mother,311178,322095,10917,Japan,J07,NA,30,6,q
mother,327385,328047,662,Japan,J07,c,30,7,q
mother,332419,333081,662,Japan,J07,o,30,8,a
father,335667,337643,1976,Japan,J07,c,30,9,a
child,341214,344070,2856,Japan,J07,b,30,10,a
mother,351061,352185,1124,Japan,J07,f,33,1,a
father,352575,353532,957,Japan,J07,m,33,2,a
mother,353619,354154,535,Japan,J07,f,33,3,q
father,354348,355002,654,Japan,J07,c,34,1,q
father,357741,358238,497,Japan,J07,c,34,2,q
mother,357902,359042,1140,Japan,J07,NA,34,3,q
father,359834,360397,563,Japan,J07,c,34,4,a
child,360490,362662,2172,Japan,J07,b,35,1,q
father,362710,364514,1804,Japan,J07,c,35,2,a
mother,363150,369461,6311,Japan,J07,c,35,3,a
father,370244,370975,731,Japan,J07,c,35,4,a
mother,371647,377791,6144,Japan,J07,c,35,5,a
father,378931,379606,675,Japan,J07,c,35,6,a
father,396808,397459,651,Japan,J07,c,36,1,a
child,398645,401541,2896,Japan,J07,b,37,1,a
mother,401709,402902,1193,Japan,J07,c,38,1,q
child,403205,405054,1849,Japan,J07,m,38,2,a
child,405744,406881,1137,Japan,J07,f,38,3,i
father,406998,407469,471,Japan,J07,c,38,4,q
mother,407716,407937,221,Japan,J07,c,38,5,q
mother,409709,418585,8876,Japan,J07,c,38,6,a
father,410446,411121,675,Japan,J07,c,38,7,q
mother,428571,429496,925,Japan,J07,c,39,1,i
mother,432295,434288,1993,Japan,J07,c,39,2,a
mother,440144,445750,5606,Japan,J07,c,39,3,i
father,442239,444503,2264,Japan,J07,c,39,4,a
child,446938,448036,1098,Japan,J07,f,39,5,a
father,453916,455756,1840,Japan,J07,c,40,1,q
mother,457475,458388,913,Japan,J07,c,40,2,a
mother,454261,455504,1243,Japan,J07,c,41,1,a
father,479191,480193,1002,Japan,J07,m,42,1,q
mother,480309,481978,1669,Japan,J07,f,42,2,a
child,488295,492976,4681,Japan,J07,b,43,1,a
father,492997,494268,1271,Japan,J07,m,44,1,q
mother,495268,497065,1797,Japan,J07,f,44,2,a
father,496392,496768,376,Japan,J07,m,44,3,a
mother,498861,501454,2593,Japan,J07,c,44,4,a
child,502313,502595,282,Japan,J07,m,44,5,a
mother,503013,503461,448,Japan,J07,c,45,1,q
mother,506247,507728,1481,Japan,J07,c,45,2,a
mother,509661,511406,1745,Japan,J07,c,45,3,q
father,511694,518972,7278,Japan,J07,c,45,4,a
child,519352,519683,331,Japan,J07,c,45,5,a
father,519984,520441,457,Japan,J07,c,45,6,q
child,521341,522511,1170,Japan,J07,f,45,7,a
father,522543,523461,918,Japan,J07,c,45,8,a
mother,523268,524830,1562,Japan,J07,f,45,9,q
father,525361,525650,289,Japan,J07,m,45,10,a
child,526551,528993,2442,Japan,J07,f,45,11,a
father,528984,530923,1939,Japan,J07,c,45,12,a
child,531407,532623,1216,Japan,J07,f,45,13,i
father,533114,533583,469,Japan,J07,c,45,14,q
child,533807,534142,335,Japan,J07,f,45,15,a
father,534071,534550,479,Japan,J07,c,45,16,a
child,535330,537109,1779,Japan,J07,f,45,17,q
mother,537047,537275,228,Japan,J07,f,45,18,a
father,537528,538101,573,Japan,J07,c,45,19,q
child,539291,540921,1630,Japan,J07,f,45,20,a
father,541005,541710,705,Japan,J07,c,45,21,q
mother,542088,543307,1219,Japan,J07,b,45,22,a
father,544040,544820,780,Japan,J07,c,45,23,q
mother,545102,546488,1386,Japan,J07,f,45,24,a
father,546546,547098,552,Japan,J07,b,45,25,a
mother,547102,547468,366,Japan,J07,f,45,26,a
mother,548385,550911,2526,Japan,J07,b,45,27,a
child,550974,553617,2643,Japan,J07,b,45,28,a
father,554281,554898,617,Japan,J07,c,45,29,a
child,556175,557317,1142,Japan,J07,m,45,30,a
mother,557592,559571,1979,Japan,J07,c,45,31,i
child,559175,563982,4807,Japan,J07,m,45,32,a
mother,563806,564622,816,Japan,J07,c,45,33,a
child,564783,566960,2177,Japan,J07,m,45,34,a
father,568164,568840,676,Japan,J07,c,45,35,a
mother,568516,571799,3283,Japan,J07,c,45,36,a
father,572091,573325,1234,Japan,J07,b,45,37,a
mother,574619,575753,1134,Japan,J07,c,45,38,a
mother,581585,583854,2269,Japan,J07,f,45,39,q
child,584910,586512,1602,Japan,J07,b,45,40,a
mother,586764,591792,5028,Japan,J07,m,45,41,a
father,588429,588879,450,Japan,J07,b,45,42,a
child,593092,594777,1685,Japan,J07,b,45,43,a
mother,216199,216744,545,Japan,J07,b,46,1,q
father,217440,219403,1963,Japan,J07,m,46,2,a
father,233127,233894,767,Japan,J07,m,47,1,a
mother,234371,236164,1793,Japan,J07,f,47,2,a
father,236318,236992,674,Japan,J07,m,47,3,a
mother,237813,239895,2082,Japan,J07,b,47,4,a
silence,2033,2037,4,Japan,J07,NA,NA,NA,NA
silence,2827,2999,172,Japan,J07,NA,NA,NA,NA
silence,4481,4514,33,Japan,J07,NA,NA,NA,NA
silence,5213,6142,929,Japan,J07,NA,NA,NA,NA
silence,11640,11764,124,Japan,J07,NA,NA,NA,NA
silence,12395,14263,1868,Japan,J07,NA,NA,NA,NA
silence,15000,15254,254,Japan,J07,NA,NA,NA,NA
silence,17176,17261,85,Japan,J07,NA,NA,NA,NA
child,17584,18993,1409,Japan,J07,m,NA,NA,i
silence,21716,22655,939,Japan,J07,NA,NA,NA,NA
silence,23673,23816,143,Japan,J07,NA,NA,NA,NA
silence,24042,25544,1502,Japan,J07,NA,NA,NA,NA
silence,30772,30812,40,Japan,J07,NA,NA,NA,NA
silence,31571,33178,1607,Japan,J07,NA,NA,NA,NA
silence,34916,36127,1211,Japan,J07,NA,NA,NA,NA
silence,36599,37060,461,Japan,J07,NA,NA,NA,NA
silence,37602,38102,500,Japan,J07,NA,NA,NA,NA
silence,38661,38686,25,Japan,J07,NA,NA,NA,NA
silence,39023,40288,1265,Japan,J07,NA,NA,NA,NA
silence,42877,43116,239,Japan,J07,NA,NA,NA,NA
silence,45379,45385,6,Japan,J07,NA,NA,NA,NA
silence,46477,46709,232,Japan,J07,NA,NA,NA,NA
silence,48799,48854,55,Japan,J07,NA,NA,NA,NA
silence,50219,52932,2713,Japan,J07,NA,NA,NA,NA
silence,53603,54647,1044,Japan,J07,NA,NA,NA,NA
silence,56567,56725,158,Japan,J07,NA,NA,NA,NA
silence,57709,59047,1338,Japan,J07,NA,NA,NA,NA
silence,60026,60042,16,Japan,J07,NA,NA,NA,NA
silence,60374,61150,776,Japan,J07,NA,NA,NA,NA
silence,65137,65623,486,Japan,J07,NA,NA,NA,NA
silence,65987,66668,681,Japan,J07,NA,NA,NA,NA
silence,69999,72403,2404,Japan,J07,NA,NA,NA,NA
silence,73367,73557,190,Japan,J07,NA,NA,NA,NA
silence,76214,76454,240,Japan,J07,NA,NA,NA,NA
mother_gesture,79110,80826,1716,Japan,J07,NA,NA,NA,NA
silence,88144,88208,64,Japan,J07,NA,NA,NA,NA
silence,88541,88992,451,Japan,J07,NA,NA,NA,NA
mother_gesture,88751,90172,1421,Japan,J07,NA,NA,NA,NA
silence,92818,93805,987,Japan,J07,NA,NA,NA,NA
silence,94426,94771,345,Japan,J07,NA,NA,NA,NA
silence,95481,95556,75,Japan,J07,NA,NA,NA,NA
silence,96206,96352,146,Japan,J07,NA,NA,NA,NA
silence,96573,98659,2086,Japan,J07,NA,NA,NA,NA
silence,99730,101592,1862,Japan,J07,NA,NA,NA,NA
silence,120197,121304,1107,Japan,J07,NA,NA,NA,NA
silence,122795,123716,921,Japan,J07,NA,NA,NA,NA
silence,125931,126302,371,Japan,J07,NA,NA,NA,NA
silence,126592,126919,327,Japan,J07,NA,NA,NA,NA
silence,127679,128125,446,Japan,J07,NA,NA,NA,NA
silence,131534,132130,596,Japan,J07,NA,NA,NA,NA
silence,133363,133866,503,Japan,J07,NA,NA,NA,NA
silence,135035,135356,321,Japan,J07,NA,NA,NA,NA
silence,136262,136772,510,Japan,J07,NA,NA,NA,NA
silence,137103,138005,902,Japan,J07,NA,NA,NA,NA
silence,140992,141015,23,Japan,J07,NA,NA,NA,NA
silence,142124,142668,544,Japan,J07,NA,NA,NA,NA
silence,148385,149173,788,Japan,J07,NA,NA,NA,NA
silence,149776,150026,250,Japan,J07,NA,NA,NA,NA
silence,154495,155557,1062,Japan,J07,NA,NA,NA,NA
silence,157695,158514,819,Japan,J07,NA,NA,NA,NA
silence,158969,159233,264,Japan,J07,NA,NA,NA,NA
mother_gesture,159848,161052,1204,Japan,J07,NA,NA,NA,NA
silence,162185,162623,438,Japan,J07,NA,NA,NA,NA
silence,163940,163992,52,Japan,J07,NA,NA,NA,NA
silence,164626,164637,11,Japan,J07,NA,NA,NA,NA
silence,164906,165978,1072,Japan,J07,NA,NA,NA,NA
silence,168023,168778,755,Japan,J07,NA,NA,NA,NA
silence,171081,171868,787,Japan,J07,NA,NA,NA,NA
silence,172618,172750,132,Japan,J07,NA,NA,NA,NA
mother_gesture,172752,174532,1780,Japan,J07,NA,NA,NA,NA
mother_gesture,175120,177519,2399,Japan,J07,NA,NA,NA,NA
silence,177681,178295,614,Japan,J07,NA,NA,NA,NA
silence,182618,183081,463,Japan,J07,NA,NA,NA,NA
silence,184109,184330,221,Japan,J07,NA,NA,NA,NA
silence,186647,188308,1661,Japan,J07,NA,NA,NA,NA
silence,190772,192566,1794,Japan,J07,NA,NA,NA,NA
silence,194517,197452,2935,Japan,J07,NA,NA,NA,NA
silence,198502,200784,2282,Japan,J07,NA,NA,NA,NA
silence,202978,216199,13221,Japan,J07,NA,NA,NA,NA
silence,216744,217440,696,Japan,J07,NA,NA,NA,NA
silence,219403,220152,749,Japan,J07,NA,NA,NA,NA
father_gesture,220164,223836,3672,Japan,J07,NA,NA,NA,NA
silence,220623,221192,569,Japan,J07,NA,NA,NA,NA
mother_gesture,221830,223469,1639,Japan,J07,NA,NA,NA,NA
silence,223068,223170,102,Japan,J07,NA,NA,NA,NA
silence,224258,227971,3713,Japan,J07,NA,NA,NA,NA
silence,229702,231557,1855,Japan,J07,NA,NA,NA,NA
mother,231557,233090,1533,Japan,J07,f,NA,NA,q
silence,233090,233127,37,Japan,J07,NA,NA,NA,NA
silence,233894,234371,477,Japan,J07,NA,NA,NA,NA
silence,236164,236318,154,Japan,J07,NA,NA,NA,NA
silence,236992,237813,821,Japan,J07,NA,NA,NA,NA
silence,239895,240606,711,Japan,J07,NA,NA,NA,NA
silence,241295,241378,83,Japan,J07,NA,NA,NA,NA
silence,243250,244454,1204,Japan,J07,NA,NA,NA,NA
silence,246999,249150,2151,Japan,J07,NA,NA,NA,NA
silence,250384,250403,19,Japan,J07,NA,NA,NA,NA
silence,250821,251481,660,Japan,J07,NA,NA,NA,NA
silence,255557,255637,80,Japan,J07,NA,NA,NA,NA
silence,256256,258378,2122,Japan,J07,NA,NA,NA,NA
silence,263865,264031,166,Japan,J07,NA,NA,NA,NA
silence,265530,265575,45,Japan,J07,NA,NA,NA,NA
silence,265884,267802,1918,Japan,J07,NA,NA,NA,NA
silence,276446,276550,104,Japan,J07,NA,NA,NA,NA
silence,281757,282228,471,Japan,J07,NA,NA,NA,NA
father_gesture,282230,283427,1197,Japan,J07,NA,NA,NA,NA
silence,283189,283286,97,Japan,J07,NA,NA,NA,NA
father_gesture,284676,286424,1748,Japan,J07,NA,NA,NA,NA
mother_gesture,285647,286914,1267,Japan,J07,NA,NA,NA,NA
mother_gesture,287039,288056,1017,Japan,J07,NA,NA,NA,NA
silence,288847,289236,389,Japan,J07,NA,NA,NA,NA
silence,290845,291571,726,Japan,J07,NA,NA,NA,NA
silence,295391,295440,49,Japan,J07,NA,NA,NA,NA
silence,295872,300385,4513,Japan,J07,NA,NA,NA,NA
silence,301072,301379,307,Japan,J07,NA,NA,NA,NA
child_gesture,301213,303826,2613,Japan,J07,NA,NA,NA,NA
silence,303020,303964,944,Japan,J07,NA,NA,NA,NA
silence,305875,306943,1068,Japan,J07,NA,NA,NA,NA
child_gesture,306951,308876,1925,Japan,J07,NA,NA,NA,NA
silence,307916,308066,150,Japan,J07,NA,NA,NA,NA
silence,308626,311178,2552,Japan,J07,NA,NA,NA,NA
silence,322095,327385,5290,Japan,J07,NA,NA,NA,NA
silence,328047,332419,4372,Japan,J07,NA,NA,NA,NA
silence,333081,335667,2586,Japan,J07,NA,NA,NA,NA
silence,337643,341214,3571,Japan,J07,NA,NA,NA,NA
silence,344070,351061,6991,Japan,J07,NA,NA,NA,NA
silence,352185,352575,390,Japan,J07,NA,NA,NA,NA
silence,353532,353619,87,Japan,J07,NA,NA,NA,NA
silence,354154,354348,194,Japan,J07,NA,NA,NA,NA
silence,355002,357741,2739,Japan,J07,NA,NA,NA,NA
silence,359042,359834,792,Japan,J07,NA,NA,NA,NA
silence,360397,360490,93,Japan,J07,NA,NA,NA,NA
silence,362662,362710,48,Japan,J07,NA,NA,NA,NA
silence,369461,370244,783,Japan,J07,NA,NA,NA,NA
father_gesture,370245,372363,2118,Japan,J07,NA,NA,NA,NA
silence,370975,371647,672,Japan,J07,NA,NA,NA,NA
silence,377791,378931,1140,Japan,J07,NA,NA,NA,NA
silence,379606,396808,17202,Japan,J07,NA,NA,NA,NA
silence,397459,398645,1186,Japan,J07,NA,NA,NA,NA
silence,401541,401709,168,Japan,J07,NA,NA,NA,NA
silence,402902,403205,303,Japan,J07,NA,NA,NA,NA
silence,405054,405744,690,Japan,J07,NA,NA,NA,NA
silence,406881,406998,117,Japan,J07,NA,NA,NA,NA
silence,407469,407716,247,Japan,J07,NA,NA,NA,NA
silence,407937,409709,1772,Japan,J07,NA,NA,NA,NA
silence,418585,421226,2641,Japan,J07,NA,NA,NA,NA
mother,421226,422399,1173,Japan,J07,c,NA,NA,a
silence,422399,428571,6172,Japan,J07,NA,NA,NA,NA
silence,429496,432295,2799,Japan,J07,NA,NA,NA,NA
silence,434288,440144,5856,Japan,J07,NA,NA,NA,NA
silence,445750,446938,1188,Japan,J07,NA,NA,NA,NA
silence,448036,453916,5880,Japan,J07,NA,NA,NA,NA
silence,455756,457475,1719,Japan,J07,NA,NA,NA,NA
silence,458388,479191,20803,Japan,J07,NA,NA,NA,NA
father_gesture,479201,481103,1902,Japan,J07,NA,NA,NA,NA
silence,480193,480309,116,Japan,J07,NA,NA,NA,NA
silence,481978,488295,6317,Japan,J07,NA,NA,NA,NA
child_gesture,490047,494133,4086,Japan,J07,NA,NA,NA,NA
silence,492976,492997,21,Japan,J07,NA,NA,NA,NA
silence,494268,495268,1000,Japan,J07,NA,NA,NA,NA
silence,497065,498861,1796,Japan,J07,NA,NA,NA,NA
silence,501454,502313,859,Japan,J07,NA,NA,NA,NA
silence,502595,503013,418,Japan,J07,NA,NA,NA,NA
silence,503461,506247,2786,Japan,J07,NA,NA,NA,NA
silence,507728,509661,1933,Japan,J07,NA,NA,NA,NA
mother_gesture,509186,512133,2947,Japan,J07,NA,NA,NA,NA
silence,511406,511694,288,Japan,J07,NA,NA,NA,NA
silence,518972,519352,380,Japan,J07,NA,NA,NA,NA
silence,519683,519984,301,Japan,J07,NA,NA,NA,NA
silence,520441,521341,900,Japan,J07,NA,NA,NA,NA
silence,522511,522543,32,Japan,J07,NA,NA,NA,NA
silence,524830,525361,531,Japan,J07,NA,NA,NA,NA
silence,525650,526551,901,Japan,J07,NA,NA,NA,NA
silence,530923,531407,484,Japan,J07,NA,NA,NA,NA
silence,532623,533114,491,Japan,J07,NA,NA,NA,NA
silence,533583,533807,224,Japan,J07,NA,NA,NA,NA
silence,534550,535330,780,Japan,J07,NA,NA,NA,NA
silence,537275,537528,253,Japan,J07,NA,NA,NA,NA
silence,538101,539291,1190,Japan,J07,NA,NA,NA,NA
child_gesture,538561,540593,2032,Japan,J07,NA,NA,NA,NA
silence,540921,541005,84,Japan,J07,NA,NA,NA,NA
silence,541710,542088,378,Japan,J07,NA,NA,NA,NA
mother_gesture,542091,543429,1338,Japan,J07,NA,NA,NA,NA
silence,543307,544040,733,Japan,J07,NA,NA,NA,NA
silence,544820,545102,282,Japan,J07,NA,NA,NA,NA
silence,546488,546546,58,Japan,J07,NA,NA,NA,NA
silence,547098,547102,4,Japan,J07,NA,NA,NA,NA
silence,547468,548385,917,Japan,J07,NA,NA,NA,NA
child_gesture,550870,552560,1690,Japan,J07,NA,NA,NA,NA
silence,550911,550974,63,Japan,J07,NA,NA,NA,NA
silence,553617,554281,664,Japan,J07,NA,NA,NA,NA
silence,554898,556175,1277,Japan,J07,NA,NA,NA,NA
silence,557317,557592,275,Japan,J07,NA,NA,NA,NA
silence,564622,564783,161,Japan,J07,NA,NA,NA,NA
silence,566960,568164,1204,Japan,J07,NA,NA,NA,NA
father_gesture,568002,569407,1405,Japan,J07,NA,NA,NA,NA
silence,571799,572091,292,Japan,J07,NA,NA,NA,NA
silence,573325,574619,1294,Japan,J07,NA,NA,NA,NA
silence,575753,581585,5832,Japan,J07,NA,NA,NA,NA
silence,583854,584910,1056,Japan,J07,NA,NA,NA,NA
silence,586512,586764,252,Japan,J07,NA,NA,NA,NA
silence,591792,593092,1300,Japan,J07,NA,NA,NA,NA
mother,1382,1706,324,Japan,J08,c,1,1,q
child,1783,2370,587,Japan,J08,m,1,2,a
mother,2427,3395,968,Japan,J08,c,1,3,q
child,3493,3886,393,Japan,J08,m,1,4,a
mother,3780,6206,2426,Japan,J08,c,1,5,q
child,6280,6780,500,Japan,J08,m,1,6,a
mother,6837,7711,874,Japan,J08,c,1,7,a
child,8903,9485,582,Japan,J08,m,1,8,a
mother,9575,13120,3545,Japan,J08,c,1,9,a
child,13336,14013,677,Japan,J08,m,1,10,a
mother,15245,16432,1187,Japan,J08,c,1,11,q
father,16506,17272,766,Japan,J08,m,1,12,a
mother,17181,18738,1557,Japan,J08,f,1,13,a
mother,26559,27788,1229,Japan,J08,c,2,1,q
child,28017,29048,1031,Japan,J08,m,2,2,a
mother,63434,65762,2328,Japan,J08,c,3,1,q
child,66085,66596,511,Japan,J08,m,3,2,a
mother,66632,67116,484,Japan,J08,c,3,3,a
mother,69899,71206,1307,Japan,J08,o,4,1,a
mother,73607,76978,3371,Japan,J08,c,4,2,a
mother,86931,88794,1863,Japan,J08,c,4,3,q
child,88918,89705,787,Japan,J08,m,4,4,a
mother,77858,79256,1398,Japan,J08,o,5,1,a
mother,110749,112385,1636,Japan,J08,c,5,2,a
mother,126882,128345,1463,Japan,J08,c,6,1,q
child,128368,128937,569,Japan,J08,m,6,2,a
mother,128960,132677,3717,Japan,J08,c,6,3,a
child,136407,139921,3514,Japan,J08,m,6,4,i
mother,148578,156097,7519,Japan,J08,c,6,5,i
child,148788,150101,1313,Japan,J08,m,6,6,a
mother,165082,166894,1812,Japan,J08,c,6,7,q
mother,168944,173026,4082,Japan,J08,c,6,8,a
child,173080,173780,700,Japan,J08,m,6,9,a
mother,177302,179457,2155,Japan,J08,c,6,10,a
mother,182528,183517,989,Japan,J08,c,6,11,a
father,195854,216484,20630,Japan,J08,m,7,1,a
mother,200081,200512,431,Japan,J08,f,7,2,a
mother,204573,205042,469,Japan,J08,f,7,3,a
mother,218487,219291,804,Japan,J08,f,7,4,a
father,221578,222876,1298,Japan,J08,m,7,5,a
child,239198,239935,737,Japan,J08,m,8,1,a
mother,240853,241894,1041,Japan,J08,c,8,2,q
child,241935,242514,579,Japan,J08,m,8,3,a
mother,242732,245043,2311,Japan,J08,c,8,4,q
child,245181,245777,596,Japan,J08,m,8,5,a
mother,245704,246138,434,Japan,J08,c,8,6,a
mother,249912,254856,4944,Japan,J08,c,8,7,a
child,254683,255285,602,Japan,J08,m,8,8,a
father,257562,259020,1458,Japan,J08,m,8,9,a
mother,259040,259692,652,Japan,J08,f,8,10,a
father,271854,273591,1737,Japan,J08,m,9,1,q
mother,273661,273968,307,Japan,J08,f,9,2,q
father,273976,275272,1296,Japan,J08,m,9,3,q
mother,276390,279766,3376,Japan,J08,f,9,4,a
father,296058,296681,623,Japan,J08,c,10,1,q
child,296584,297263,679,Japan,J08,f,10,2,a
father,326926,330661,3735,Japan,J08,m,11,1,a
mother,330460,331889,1429,Japan,J08,f,11,2,a
father,331563,336401,4838,Japan,J08,m,11,3,a
mother,333165,333461,296,Japan,J08,f,11,4,a
mother,336530,337076,546,Japan,J08,f,11,5,a
mother,341058,343476,2418,Japan,J08,c,12,1,a
child,343485,343866,381,Japan,J08,m,12,2,a
mother,345099,350657,5558,Japan,J08,o,12,3,a
mother,350968,355312,4344,Japan,J08,c,12,4,a
child,355190,355542,352,Japan,J08,m,12,5,a
child,377888,379470,1582,Japan,J08,b,13,1,a
mother,380561,383191,2630,Japan,J08,c,13,2,q
child,383551,385345,1794,Japan,J08,m,13,3,a
mother,385411,387644,2233,Japan,J08,c,13,4,a
mother,397075,403681,6606,Japan,J08,c,13,5,a
child,403908,404222,314,Japan,J08,m,13,6,a
mother,404388,405350,962,Japan,J08,c,13,7,q
child,405747,406067,320,Japan,J08,m,13,8,a
mother,406132,407211,1079,Japan,J08,c,13,9,q
child,408072,408870,798,Japan,J08,m,13,10,i
mother,409009,411558,2549,Japan,J08,c,13,11,a
mother,416998,419741,2743,Japan,J08,c,13,12,a
child,419849,422191,2342,Japan,J08,m,13,13,a
mother,426198,426894,696,Japan,J08,NA,13,14,q
child,427329,428750,1421,Japan,J08,b,13,15,a
mother,428804,430049,1245,Japan,J08,c,13,16,a
father,430783,433550,2767,Japan,J08,c,13,17,a
father,435666,440214,4548,Japan,J08,m,14,1,a
mother,440258,443347,3089,Japan,J08,f,14,2,q
father,443592,464821,21229,Japan,J08,m,14,3,a
mother,453727,454324,597,Japan,J08,f,14,4,a
mother,459769,460714,945,Japan,J08,NA,14,5,a
mother,466796,468363,1567,Japan,J08,f,14,6,q
father,468738,469705,967,Japan,J08,m,14,7,a
child,469744,470133,389,Japan,J08,b,15,1,a
father,472136,473158,1022,Japan,J08,c,15,2,a
child,474042,479794,5752,Japan,J08,f,15,3,a
father,479788,480876,1088,Japan,J08,c,15,4,q
child,482346,486307,3961,Japan,J08,f,15,5,a
father,486346,489302,2956,Japan,J08,c,15,6,a
father,492865,495755,2890,Japan,J08,c,15,7,q
child,496177,497495,1318,Japan,J08,f,15,8,a
mother,497832,499338,1506,Japan,J08,NA,15,9,q
child,501042,502747,1705,Japan,J08,m,15,10,a
mother,502678,503558,880,Japan,J08,c,15,11,a
child,504799,505796,997,Japan,J08,m,15,12,a
mother,506186,507015,829,Japan,J08,c,15,13,a
child,506714,507165,451,Japan,J08,m,15,14,a
child,510981,514479,3498,Japan,J08,m,15,15,a
mother,514704,515296,592,Japan,J08,c,15,16,a
father,512682,513856,1174,Japan,J08,o,16,1,a
mother,515539,519798,4259,Japan,J08,f,17,1,i
father,519644,519926,282,Japan,J08,m,17,2,q
child,523230,526190,2960,Japan,J08,m,18,1,a
mother,526374,528191,1817,Japan,J08,c,18,2,q
child,527952,528516,564,Japan,J08,m,18,3,a
child,544241,544821,580,Japan,J08,m,19,1,a
mother,551882,561091,9209,Japan,J08,c,19,2,a
mother,564086,566081,1995,Japan,J08,c,19,3,a
mother,568672,569484,812,Japan,J08,c,19,4,q
child,569876,570476,600,Japan,J08,m,19,5,a
child,571173,572788,1615,Japan,J08,b,20,1,a
mother,572821,573686,865,Japan,J08,c,20,2,a
child,574690,578755,4065,Japan,J08,m,20,3,a
mother,578783,579214,431,Japan,J08,c,20,4,a
father,579599,580031,432,Japan,J08,m,21,1,a
child,580375,582791,2416,Japan,J08,m,22,1,q
mother,582888,583272,384,Japan,J08,c,22,2,q
child,583804,584812,1008,Japan,J08,m,22,3,a
mother,584600,585051,451,Japan,J08,c,22,4,q
child,585091,585583,492,Japan,J08,m,22,5,a
mother,585370,586415,1045,Japan,J08,c,22,6,q
child,586386,586910,524,Japan,J08,m,22,7,a
mother,588073,590369,2296,Japan,J08,c,22,8,a
child,590744,591412,668,Japan,J08,m,22,9,a
father,591432,599186,7754,Japan,J08,m,23,1,a
mother,35276,36165,889,Japan,J08,c,24,1,q
father,36921,37763,842,Japan,J08,c,24,2,q
child,37834,38239,405,Japan,J08,f,24,3,a
father,38368,38780,412,Japan,J08,c,24,4,q
child,38845,39288,443,Japan,J08,f,24,5,a
father,39329,43739,4410,Japan,J08,c,24,6,a
mother,44361,45477,1116,Japan,J08,c,24,7,a
mother,47582,48558,976,Japan,J08,NA,24,8,q
child,48861,49780,919,Japan,J08,m,24,9,a
mother,49853,50083,230,Japan,J08,c,24,10,q
child,50157,50649,492,Japan,J08,m,24,11,a
mother,50419,51343,924,Japan,J08,c,24,12,q
child,51370,54559,3189,Japan,J08,m,24,13,a
mother,54678,58788,4110,Japan,J08,c,24,14,a
child,55542,56081,539,Japan,J08,m,24,15,a
mother,61042,63378,2336,Japan,J08,c,24,16,a
child,62642,63172,530,Japan,J08,m,24,17,a
mother,101501,103097,1596,Japan,J08,b,25,1,a
father,102777,103296,519,Japan,J08,m,25,2,a
child_gesture,1312,2902,1590,Japan,J08,NA,NA,NA,NA
silence,1706,1783,77,Japan,J08,NA,NA,NA,NA
silence,2370,2427,57,Japan,J08,NA,NA,NA,NA
silence,3395,3493,98,Japan,J08,NA,NA,NA,NA
silence,6206,6280,74,Japan,J08,NA,NA,NA,NA
silence,6780,6837,57,Japan,J08,NA,NA,NA,NA
silence,7711,8903,1192,Japan,J08,NA,NA,NA,NA
silence,9485,9575,90,Japan,J08,NA,NA,NA,NA
silence,13120,13336,216,Japan,J08,NA,NA,NA,NA
silence,14013,15245,1232,Japan,J08,NA,NA,NA,NA
silence,16432,16506,74,Japan,J08,NA,NA,NA,NA
silence,18738,26559,7821,Japan,J08,NA,NA,NA,NA
silence,27788,28017,229,Japan,J08,NA,NA,NA,NA
silence,29048,35276,6228,Japan,J08,NA,NA,NA,NA
silence,36165,36921,756,Japan,J08,NA,NA,NA,NA
silence,37763,37834,71,Japan,J08,NA,NA,NA,NA
silence,38239,38368,129,Japan,J08,NA,NA,NA,NA
silence,38780,38845,65,Japan,J08,NA,NA,NA,NA
silence,39288,39329,41,Japan,J08,NA,NA,NA,NA
silence,43739,44361,622,Japan,J08,NA,NA,NA,NA
silence,45477,47582,2105,Japan,J08,NA,NA,NA,NA
silence,48558,48861,303,Japan,J08,NA,NA,NA,NA
silence,49780,49853,73,Japan,J08,NA,NA,NA,NA
silence,50083,50157,74,Japan,J08,NA,NA,NA,NA
silence,51343,51370,27,Japan,J08,NA,NA,NA,NA
silence,54559,54678,119,Japan,J08,NA,NA,NA,NA
silence,58788,61042,2254,Japan,J08,NA,NA,NA,NA
silence,63378,63434,56,Japan,J08,NA,NA,NA,NA
silence,65762,66085,323,Japan,J08,NA,NA,NA,NA
silence,66596,66632,36,Japan,J08,NA,NA,NA,NA
silence,67116,67374,258,Japan,J08,NA,NA,NA,NA
father,67374,69468,2094,Japan,J08,m,NA,NA,a
silence,69468,69899,431,Japan,J08,NA,NA,NA,NA
silence,71206,73607,2401,Japan,J08,NA,NA,NA,NA
silence,76978,77858,880,Japan,J08,NA,NA,NA,NA
silence,79256,86931,7675,Japan,J08,NA,NA,NA,NA
silence,88794,88918,124,Japan,J08,NA,NA,NA,NA
silence,89705,101501,11796,Japan,J08,NA,NA,NA,NA
silence,103296,110749,7453,Japan,J08,NA,NA,NA,NA
silence,112385,126882,14497,Japan,J08,NA,NA,NA,NA
silence,128345,128368,23,Japan,J08,NA,NA,NA,NA
silence,128937,128960,23,Japan,J08,NA,NA,NA,NA
silence,132677,136407,3730,Japan,J08,NA,NA,NA,NA
silence,139921,148578,8657,Japan,J08,NA,NA,NA,NA
mother_gesture,153332,154530,1198,Japan,J08,NA,NA,NA,NA
silence,156097,165082,8985,Japan,J08,NA,NA,NA,NA
silence,166894,168944,2050,Japan,J08,NA,NA,NA,NA
silence,173026,173080,54,Japan,J08,NA,NA,NA,NA
silence,173780,177302,3522,Japan,J08,NA,NA,NA,NA
silence,179457,182528,3071,Japan,J08,NA,NA,NA,NA
silence,183517,195854,12337,Japan,J08,NA,NA,NA,NA
silence,216484,218487,2003,Japan,J08,NA,NA,NA,NA
silence,219291,221578,2287,Japan,J08,NA,NA,NA,NA
silence,222876,239198,16322,Japan,J08,NA,NA,NA,NA
silence,239935,240853,918,Japan,J08,NA,NA,NA,NA
silence,241894,241935,41,Japan,J08,NA,NA,NA,NA
silence,242514,242732,218,Japan,J08,NA,NA,NA,NA
silence,245043,245181,138,Japan,J08,NA,NA,NA,NA
silence,246138,249912,3774,Japan,J08,NA,NA,NA,NA
silence,255285,257562,2277,Japan,J08,NA,NA,NA,NA
silence,259020,259040,20,Japan,J08,NA,NA,NA,NA
silence,259692,271854,12162,Japan,J08,NA,NA,NA,NA
silence,273591,273661,70,Japan,J08,NA,NA,NA,NA
silence,273968,273976,8,Japan,J08,NA,NA,NA,NA
silence,275272,276390,1118,Japan,J08,NA,NA,NA,NA
mother_gesture,276411,277318,907,Japan,J08,NA,NA,NA,NA
silence,279766,296058,16292,Japan,J08,NA,NA,NA,NA
silence,297263,326926,29663,Japan,J08,NA,NA,NA,NA
silence,336401,336530,129,Japan,J08,NA,NA,NA,NA
silence,337076,339142,2066,Japan,J08,NA,NA,NA,NA
child,339142,340927,1785,Japan,J08,m,NA,NA,i
silence,340927,341058,131,Japan,J08,NA,NA,NA,NA
silence,343476,343485,9,Japan,J08,NA,NA,NA,NA
silence,343866,345099,1233,Japan,J08,NA,NA,NA,NA
silence,350657,350968,311,Japan,J08,NA,NA,NA,NA
silence,355542,355558,16,Japan,J08,NA,NA,NA,NA
mother,355558,355903,345,Japan,J08,c,NA,NA,a
silence,355903,377888,21985,Japan,J08,NA,NA,NA,NA
silence,379470,380561,1091,Japan,J08,NA,NA,NA,NA
silence,383191,383551,360,Japan,J08,NA,NA,NA,NA
silence,385345,385411,66,Japan,J08,NA,NA,NA,NA
child,386206,386595,389,Japan,J08,m,NA,NA,a
silence,387644,397075,9431,Japan,J08,NA,NA,NA,NA
child_gesture,398993,400709,1716,Japan,J08,NA,NA,NA,NA
silence,403681,403908,227,Japan,J08,NA,NA,NA,NA
silence,404222,404388,166,Japan,J08,NA,NA,NA,NA
silence,405350,405747,397,Japan,J08,NA,NA,NA,NA
silence,406067,406132,65,Japan,J08,NA,NA,NA,NA
silence,407211,408072,861,Japan,J08,NA,NA,NA,NA
silence,408870,409009,139,Japan,J08,NA,NA,NA,NA
silence,411558,416998,5440,Japan,J08,NA,NA,NA,NA
silence,419741,419849,108,Japan,J08,NA,NA,NA,NA
child_gesture,420002,426862,6860,Japan,J08,NA,NA,NA,NA
mother,422087,424093,2006,Japan,J08,c,NA,NA,i
silence,424093,426198,2105,Japan,J08,NA,NA,NA,NA
silence,426894,427329,435,Japan,J08,NA,NA,NA,NA
silence,428750,428804,54,Japan,J08,NA,NA,NA,NA
silence,430049,430783,734,Japan,J08,NA,NA,NA,NA
silence,433550,435666,2116,Japan,J08,NA,NA,NA,NA
silence,440214,440258,44,Japan,J08,NA,NA,NA,NA
silence,443347,443592,245,Japan,J08,NA,NA,NA,NA
father_gesture,455852,457087,1235,Japan,J08,NA,NA,NA,NA
father_gesture,458132,462387,4255,Japan,J08,NA,NA,NA,NA
father_gesture,462501,464542,2041,Japan,J08,NA,NA,NA,NA
silence,464821,466796,1975,Japan,J08,NA,NA,NA,NA
mother_gesture,466878,467635,757,Japan,J08,NA,NA,NA,NA
silence,468363,468738,375,Japan,J08,NA,NA,NA,NA
silence,469705,469744,39,Japan,J08,NA,NA,NA,NA
silence,470133,472136,2003,Japan,J08,NA,NA,NA,NA
silence,473158,474042,884,Japan,J08,NA,NA,NA,NA
child_gesture,474892,475954,1062,Japan,J08,NA,NA,NA,NA
silence,480876,482346,1470,Japan,J08,NA,NA,NA,NA
child_gesture,482642,486642,4000,Japan,J08,NA,NA,NA,NA
silence,486307,486346,39,Japan,J08,NA,NA,NA,NA
silence,489302,492865,3563,Japan,J08,NA,NA,NA,NA
silence,495755,496177,422,Japan,J08,NA,NA,NA,NA
silence,497495,497832,337,Japan,J08,NA,NA,NA,NA
silence,499338,501042,1704,Japan,J08,NA,NA,NA,NA
silence,503558,504799,1241,Japan,J08,NA,NA,NA,NA
silence,505796,506186,390,Japan,J08,NA,NA,NA,NA
silence,507165,510981,3816,Japan,J08,NA,NA,NA,NA
silence,514479,514704,225,Japan,J08,NA,NA,NA,NA
silence,515296,515539,243,Japan,J08,NA,NA,NA,NA
mother_gesture,516302,519792,3490,Japan,J08,NA,NA,NA,NA
silence,519926,523230,3304,Japan,J08,NA,NA,NA,NA
silence,526190,526374,184,Japan,J08,NA,NA,NA,NA
silence,528516,544241,15725,Japan,J08,NA,NA,NA,NA
child_gesture,543422,545312,1890,Japan,J08,NA,NA,NA,NA
silence,544821,548959,4138,Japan,J08,NA,NA,NA,NA
mother,548959,549445,486,Japan,J08,c,NA,NA,q
silence,549445,549468,23,Japan,J08,NA,NA,NA,NA
child,549468,550075,607,Japan,J08,m,NA,NA,a
silence,550075,551882,1807,Japan,J08,NA,NA,NA,NA
silence,561091,564086,2995,Japan,J08,NA,NA,NA,NA
silence,566081,568672,2591,Japan,J08,NA,NA,NA,NA
silence,569484,569876,392,Japan,J08,NA,NA,NA,NA
silence,570476,571173,697,Japan,J08,NA,NA,NA,NA
child_gesture,571982,572792,810,Japan,J08,NA,NA,NA,NA
silence,572788,572821,33,Japan,J08,NA,NA,NA,NA
silence,573686,574690,1004,Japan,J08,NA,NA,NA,NA
silence,578755,578783,28,Japan,J08,NA,NA,NA,NA
silence,579214,579599,385,Japan,J08,NA,NA,NA,NA
silence,580031,580375,344,Japan,J08,NA,NA,NA,NA
silence,582791,582888,97,Japan,J08,NA,NA,NA,NA
silence,583272,583804,532,Japan,J08,NA,NA,NA,NA
silence,585051,585091,40,Japan,J08,NA,NA,NA,NA
silence,586910,588073,1163,Japan,J08,NA,NA,NA,NA
mother_gesture,589352,590512,1160,Japan,J08,NA,NA,NA,NA
silence,590369,590744,375,Japan,J08,NA,NA,NA,NA
silence,591412,591432,20,Japan,J08,NA,NA,NA,NA
child,865,4914,4049,Japan,J09,m,1,1,a
child,6489,8417,1928,Japan,J09,m,2,1,a
mother,8266,10815,2549,Japan,J09,c,2,2,a
father,11320,12589,1269,Japan,J09,m,3,1,a
mother,14141,14881,740,Japan,J09,f,3,2,a
father,16320,17866,1546,Japan,J09,m,3,3,a
mother,18124,19431,1307,Japan,J09,f,3,4,a
father,19431,20031,600,Japan,J09,m,3,5,a
child,19914,21096,1182,Japan,J09,m,4,1,a
mother,23517,24594,1077,Japan,J09,c,4,2,q
child,24236,26417,2181,Japan,J09,m,4,3,a
mother,26119,28975,2856,Japan,J09,c,4,4,a
father,37045,39326,2281,Japan,J09,c,4,5,a
mother,76401,81595,5194,Japan,J09,b,5,1,a
father,79070,81623,2553,Japan,J09,b,5,2,a
child,79229,81506,2277,Japan,J09,b,5,3,a
father,75971,77001,1030,Japan,J09,c,6,1,q
father,82512,83794,1282,Japan,J09,c,6,2,q
child,84008,84809,801,Japan,J09,f,6,3,a
mother,85251,88253,3002,Japan,J09,c,6,4,i
child,88596,89526,930,Japan,J09,m,6,5,a
father,89542,93448,3906,Japan,J09,c,6,6,i
child,93627,93963,336,Japan,J09,f,6,7,a
mother,94820,96616,1796,Japan,J09,c,6,8,a
child,102213,103019,806,Japan,J09,f,6,9,i
father,103477,103814,337,Japan,J09,c,6,10,a
child,106953,108417,1464,Japan,J09,f,6,11,a
father,108844,109742,898,Japan,J09,c,6,12,i
child,110389,110863,474,Japan,J09,f,6,13,a
father,111271,111735,464,Japan,J09,c,6,14,a
mother,104791,105912,1121,Japan,J09,c,7,1,q
mother,116826,119920,3094,Japan,J09,c,8,1,a
father,120153,121988,1835,Japan,J09,m,8,2,a
mother,124647,127597,2950,Japan,J09,c,8,3,a
child,128382,130781,2399,Japan,J09,b,9,1,a
father,131215,132215,1000,Japan,J09,c,9,2,q
child,131903,132318,415,Japan,J09,f,9,3,a
father,132350,132730,380,Japan,J09,c,9,4,a
mother,141100,143226,2126,Japan,J09,c,10,1,a
child,144698,146657,1959,Japan,J09,b,10,2,i
mother,146511,150511,4000,Japan,J09,c,10,3,a
father,154407,155309,902,Japan,J09,c,10,4,a
mother,155301,161312,6011,Japan,J09,c,10,5,a
father,157413,159032,1619,Japan,J09,c,10,6,a
mother,163213,164820,1607,Japan,J09,o,10,7,a
child,165859,167196,1337,Japan,J09,b,10,8,a
mother,166870,168920,2050,Japan,J09,c,10,9,a
father,169773,171611,1838,Japan,J09,c,10,10,a
mother,173257,176312,3055,Japan,J09,c,10,11,a
father,174361,174971,610,Japan,J09,c,10,12,a
child,176459,177930,1471,Japan,J09,b,10,13,a
mother,177764,178555,791,Japan,J09,c,10,14,q
child,178396,178825,429,Japan,J09,m,10,15,a
father,180715,181787,1072,Japan,J09,c,10,16,a
father,144731,145878,1147,Japan,J09,c,11,1,a
father,161715,163499,1784,Japan,J09,c,12,1,a
father,190587,191816,1229,Japan,J09,c,13,1,q
child,192649,194931,2282,Japan,J09,f,13,2,a
father,194907,196366,1459,Japan,J09,c,13,3,a
mother,195102,196578,1476,Japan,J09,b,13,4,a
father,198688,199426,738,Japan,J09,c,13,5,q
child,199511,199931,420,Japan,J09,f,13,6,a
father,202012,203121,1109,Japan,J09,o,14,1,a
mother,205268,206815,1547,Japan,J09,f,14,2,a
mother,210019,211528,1509,Japan,J09,f,14,3,a
mother,214213,214910,697,Japan,J09,f,14,4,q
father,214965,215564,599,Japan,J09,m,14,5,a
mother,219622,221372,1750,Japan,J09,f,14,6,a
father,222326,224320,1994,Japan,J09,c,15,1,q
mother,230423,232010,1587,Japan,J09,b,15,2,a
mother,226969,230218,3249,Japan,J09,c,16,1,q
father,227919,229072,1153,Japan,J09,c,16,2,q
father,242215,243063,848,Japan,J09,c,17,1,a
child,247605,248644,1039,Japan,J09,f,18,1,a
father,249111,251052,1941,Japan,J09,c,18,2,a
child,251102,252743,1641,Japan,J09,f,18,3,a
mother,253544,255159,1615,Japan,J09,c,18,4,a
child,255931,257566,1635,Japan,J09,NA,18,5,a
mother,257511,257804,293,Japan,J09,c,18,6,a
father,260302,264215,3913,Japan,J09,c,18,7,a
mother,269616,270191,575,Japan,J09,c,18,8,q
child,270228,270669,441,Japan,J09,m,18,9,a
mother,270611,270907,296,Japan,J09,c,18,10,a
father,275314,276814,1500,Japan,J09,c,20,1,a
child,278025,278571,546,Japan,J09,f,20,2,q
father,279262,280221,959,Japan,J09,c,20,3,i
father,288308,289367,1059,Japan,J09,m,21,1,a
mother,289859,290506,647,Japan,J09,f,21,2,q
mother,299441,300571,1130,Japan,J09,f,23,1,a
father,303083,304147,1064,Japan,J09,c,23,2,q
mother,313307,315785,2478,Japan,J09,f,23,3,a
father,316811,317897,1086,Japan,J09,c,25,1,q
child,322892,325307,2415,Japan,J09,b,26,1,a
father,325273,325738,465,Japan,J09,c,26,2,a
child,326783,329091,2308,Japan,J09,f,27,1,a
father,329024,329774,750,Japan,J09,c,27,2,q
mother,329914,330633,719,Japan,J09,o,27,3,a
child,330428,331135,707,Japan,J09,f,27,4,a
father,332517,332936,419,Japan,J09,c,27,5,q
child,333014,333356,342,Japan,J09,f,27,6,a
father,333552,333913,361,Japan,J09,c,27,7,a
father,334413,335424,1011,Japan,J09,c,28,1,a
child,335412,335922,510,Japan,J09,f,28,2,a
child,339760,340595,835,Japan,J09,f,28,3,a
father,365097,365888,791,Japan,J09,m,29,1,q
child,370373,371167,794,Japan,J09,m,29,2,q
mother,372372,373403,1031,Japan,J09,c,30,1,a
mother,380511,385135,4624,Japan,J09,c,31,1,a
father,385521,388238,2717,Japan,J09,c,31,2,a
mother,389720,393715,3995,Japan,J09,c,31,3,a
mother,397279,397808,529,Japan,J09,o,31,4,a
child,399350,400745,1395,Japan,J09,b,31,5,i
mother,400628,401651,1023,Japan,J09,c,31,6,a
child,402771,404124,1353,Japan,J09,m,31,7,a
mother,404087,408262,4175,Japan,J09,c,31,8,a
child,408423,408855,432,Japan,J09,m,31,9,a
mother,408767,409611,844,Japan,J09,c,31,10,a
child,417406,418279,873,Japan,J09,o,32,1,a
father,418209,418866,657,Japan,J09,c,32,2,q
child,419417,420417,1000,Japan,J09,b,32,3,a
mother,419872,422919,3047,Japan,J09,c,32,4,i
father,420273,421152,879,Japan,J09,c,32,5,a
child,424268,425361,1093,Japan,J09,b,33,1,a
father,427207,429548,2341,Japan,J09,c,33,2,q
mother,430616,431616,1000,Japan,J09,c,33,3,a
mother,432924,438820,5896,Japan,J09,c,33,4,a
child,433919,436224,2305,Japan,J09,m,33,5,a
father,436830,439616,2786,Japan,J09,c,33,6,i
child,439866,440820,954,Japan,J09,f,33,7,a
father,441221,442130,909,Japan,J09,c,33,8,a
father,443289,444102,813,Japan,J09,c,33,9,q
child,445135,445513,378,Japan,J09,f,34,1,a
father,445367,446826,1459,Japan,J09,c,34,2,a
child,447666,448815,1149,Japan,J09,f,34,3,a
father,449814,450529,715,Japan,J09,c,34,4,q
child,450909,451798,889,Japan,J09,c,34,5,a
father,452174,455173,2999,Japan,J09,c,34,6,a
child,455654,458506,2852,Japan,J09,f,34,7,q
father,458616,459587,971,Japan,J09,c,34,8,a
father,461926,463299,1373,Japan,J09,c,34,9,a
mother,464145,465244,1099,Japan,J09,f,34,10,a
child,464307,466582,2275,Japan,J09,f,34,11,a
mother,467616,471890,4274,Japan,J09,c,34,12,a
child,469920,470490,570,Japan,J09,m,34,13,a
mother,478542,479314,772,Japan,J09,o,35,1,a
child,478689,479416,727,Japan,J09,f,36,1,a
father,479314,479946,632,Japan,J09,c,36,2,a
child,479925,480677,752,Japan,J09,m,36,3,a
mother,480711,481491,780,Japan,J09,c,36,4,a
child,481428,482522,1094,Japan,J09,m,36,5,a
mother,482840,487816,4976,Japan,J09,f,37,1,a
father,502424,505616,3192,Japan,J09,c,38,1,q
mother,502767,504659,1892,Japan,J09,c,38,2,a
father,505998,507197,1199,Japan,J09,c,38,3,a
child,507461,508044,583,Japan,J09,f,38,4,a
father,508302,511068,2766,Japan,J09,c,38,5,i
father,513163,514837,1674,Japan,J09,c,38,6,a
mother,526582,527263,681,Japan,J09,c,38,7,q
child,528914,529936,1022,Japan,J09,m,38,8,a
child,536015,537792,1777,Japan,J09,b,38,9,a
mother,530227,534936,4709,Japan,J09,f,39,1,a
father,538320,538808,488,Japan,J09,c,39,2,q
father,540227,541585,1358,Japan,J09,c,39,3,q
child,545616,548008,2392,Japan,J09,b,39,4,a
father,548105,549998,1893,Japan,J09,c,39,5,q
child,550165,550943,778,Japan,J09,f,39,6,a
father,551215,551831,616,Japan,J09,c,39,7,q
mother,551808,552116,308,Japan,J09,c,39,8,a
father,558885,563419,4534,Japan,J09,c,39,9,i
father,566209,570349,4140,Japan,J09,c,39,10,i
child,570438,571612,1174,Japan,J09,f,39,11,a
mother,571828,573622,1794,Japan,J09,c,39,12,a
child,577312,578420,1108,Japan,J09,f,40,1,a
child,580820,581611,791,Japan,J09,f,40,2,a
father,582177,583230,1053,Japan,J09,c,40,3,q
child,583423,583918,495,Japan,J09,f,40,4,a
child,585655,590008,4353,Japan,J09,o,40,5,a
father,589302,590872,1570,Japan,J09,c,40,6,i
father,593012,594952,1940,Japan,J09,c,40,7,a
child,595390,596055,665,Japan,J09,f,40,8,q
father,596628,598901,2273,Japan,J09,c,40,9,a
child,52848,53745,897,Japan,J09,m,41,1,i
mother,55213,55624,411,Japan,J09,c,41,2,a
father,57529,65820,8291,Japan,J09,b,41,3,a
mother,65180,68441,3261,Japan,J09,b,41,4,a
child,65682,66312,630,Japan,J09,m,41,5,a
child,67616,68318,702,Japan,J09,m,41,6,a
child,72323,75715,3392,Japan,J09,b,41,7,a
father,291977,293060,1083,Japan,J09,c,42,1,a
mother,293196,294280,1084,Japan,J09,c,42,2,a
child,293428,294392,964,Japan,J09,f,42,3,a
father,294721,295583,862,Japan,J09,c,42,4,i
child,295815,296409,594,Japan,J09,f,42,5,a
silence,4914,6489,1575,Japan,J09,NA,NA,NA,NA
silence,10815,11320,505,Japan,J09,NA,NA,NA,NA
silence,12589,14141,1552,Japan,J09,NA,NA,NA,NA
silence,14881,16320,1439,Japan,J09,NA,NA,NA,NA
silence,17866,18124,258,Japan,J09,NA,NA,NA,NA
silence,21096,23517,2421,Japan,J09,NA,NA,NA,NA
silence,28975,37045,8070,Japan,J09,NA,NA,NA,NA
silence,39326,52848,13522,Japan,J09,NA,NA,NA,NA
silence,53745,55213,1468,Japan,J09,NA,NA,NA,NA
silence,55624,57529,1905,Japan,J09,NA,NA,NA,NA
silence,68441,72323,3882,Japan,J09,NA,NA,NA,NA
silence,75715,75971,256,Japan,J09,NA,NA,NA,NA
silence,81623,82512,889,Japan,J09,NA,NA,NA,NA
silence,83794,84008,214,Japan,J09,NA,NA,NA,NA
silence,84809,85251,442,Japan,J09,NA,NA,NA,NA
silence,88253,88596,343,Japan,J09,NA,NA,NA,NA
silence,89526,89542,16,Japan,J09,NA,NA,NA,NA
silence,93448,93627,179,Japan,J09,NA,NA,NA,NA
silence,93963,94820,857,Japan,J09,NA,NA,NA,NA
silence,96616,102213,5597,Japan,J09,NA,NA,NA,NA
silence,103019,103477,458,Japan,J09,NA,NA,NA,NA
silence,103814,104791,977,Japan,J09,NA,NA,NA,NA
silence,105912,106953,1041,Japan,J09,NA,NA,NA,NA
silence,108417,108844,427,Japan,J09,NA,NA,NA,NA
silence,109742,110389,647,Japan,J09,NA,NA,NA,NA
silence,110863,111271,408,Japan,J09,NA,NA,NA,NA
silence,111735,116826,5091,Japan,J09,NA,NA,NA,NA
silence,119920,120153,233,Japan,J09,NA,NA,NA,NA
silence,121988,124647,2659,Japan,J09,NA,NA,NA,NA
silence,127597,128382,785,Japan,J09,NA,NA,NA,NA
silence,130781,131215,434,Japan,J09,NA,NA,NA,NA
silence,132318,132350,32,Japan,J09,NA,NA,NA,NA
silence,132730,141100,8370,Japan,J09,NA,NA,NA,NA
silence,143226,144698,1472,Japan,J09,NA,NA,NA,NA
silence,150511,154407,3896,Japan,J09,NA,NA,NA,NA
silence,161312,161715,403,Japan,J09,NA,NA,NA,NA
silence,164820,165859,1039,Japan,J09,NA,NA,NA,NA
silence,168920,169773,853,Japan,J09,NA,NA,NA,NA
silence,171611,173257,1646,Japan,J09,NA,NA,NA,NA
silence,176312,176459,147,Japan,J09,NA,NA,NA,NA
silence,178825,180715,1890,Japan,J09,NA,NA,NA,NA
silence,181787,190587,8800,Japan,J09,NA,NA,NA,NA
silence,191816,192649,833,Japan,J09,NA,NA,NA,NA
child_gesture,193053,197098,4045,Japan,J09,NA,NA,NA,NA
silence,196578,198688,2110,Japan,J09,NA,NA,NA,NA
silence,199426,199511,85,Japan,J09,NA,NA,NA,NA
silence,199931,202012,2081,Japan,J09,NA,NA,NA,NA
silence,203121,205268,2147,Japan,J09,NA,NA,NA,NA
silence,206815,210019,3204,Japan,J09,NA,NA,NA,NA
silence,211528,214213,2685,Japan,J09,NA,NA,NA,NA
silence,214910,214965,55,Japan,J09,NA,NA,NA,NA
silence,215564,219622,4058,Japan,J09,NA,NA,NA,NA
silence,221372,222326,954,Japan,J09,NA,NA,NA,NA
silence,224320,226969,2649,Japan,J09,NA,NA,NA,NA
silence,230218,230423,205,Japan,J09,NA,NA,NA,NA
silence,232010,242215,10205,Japan,J09,NA,NA,NA,NA
silence,243063,247605,4542,Japan,J09,NA,NA,NA,NA
silence,248644,249111,467,Japan,J09,NA,NA,NA,NA
silence,251052,251102,50,Japan,J09,NA,NA,NA,NA
silence,252743,253544,801,Japan,J09,NA,NA,NA,NA
mother_gesture,253814,256470,2656,Japan,J09,NA,NA,NA,NA
silence,255159,255931,772,Japan,J09,NA,NA,NA,NA
silence,257804,260302,2498,Japan,J09,NA,NA,NA,NA
silence,264215,269616,5401,Japan,J09,NA,NA,NA,NA
silence,270191,270228,37,Japan,J09,NA,NA,NA,NA
silence,270907,275314,4407,Japan,J09,NA,NA,NA,NA
silence,276814,278025,1211,Japan,J09,NA,NA,NA,NA
silence,278571,279262,691,Japan,J09,NA,NA,NA,NA
silence,280221,288308,8087,Japan,J09,NA,NA,NA,NA
silence,289367,289859,492,Japan,J09,NA,NA,NA,NA
silence,290506,291977,1471,Japan,J09,NA,NA,NA,NA
silence,293060,293196,136,Japan,J09,NA,NA,NA,NA
silence,294392,294721,329,Japan,J09,NA,NA,NA,NA
father_gesture,294616,295992,1376,Japan,J09,NA,NA,NA,NA
silence,295583,295815,232,Japan,J09,NA,NA,NA,NA
silence,296409,299441,3032,Japan,J09,NA,NA,NA,NA
silence,300571,303083,2512,Japan,J09,NA,NA,NA,NA
silence,304147,313307,9160,Japan,J09,NA,NA,NA,NA
silence,315785,316811,1026,Japan,J09,NA,NA,NA,NA
silence,317897,322892,4995,Japan,J09,NA,NA,NA,NA
silence,325738,326783,1045,Japan,J09,NA,NA,NA,NA
child_gesture,326677,333931,7254,Japan,J09,NA,NA,NA,NA
silence,329774,329914,140,Japan,J09,NA,NA,NA,NA
silence,331135,332517,1382,Japan,J09,NA,NA,NA,NA
silence,332936,333014,78,Japan,J09,NA,NA,NA,NA
silence,333356,333552,196,Japan,J09,NA,NA,NA,NA
silence,333913,334413,500,Japan,J09,NA,NA,NA,NA
silence,335922,339760,3838,Japan,J09,NA,NA,NA,NA
child_gesture,339504,341602,2098,Japan,J09,NA,NA,NA,NA
silence,340595,365097,24502,Japan,J09,NA,NA,NA,NA
silence,365888,370373,4485,Japan,J09,NA,NA,NA,NA
silence,371167,372372,1205,Japan,J09,NA,NA,NA,NA
silence,373403,380511,7108,Japan,J09,NA,NA,NA,NA
silence,385135,385521,386,Japan,J09,NA,NA,NA,NA
silence,388238,389720,1482,Japan,J09,NA,NA,NA,NA
child,390914,391358,444,Japan,J09,m,NA,NA,a
silence,393715,397279,3564,Japan,J09,NA,NA,NA,NA
silence,397808,399350,1542,Japan,J09,NA,NA,NA,NA
silence,401651,402771,1120,Japan,J09,NA,NA,NA,NA
child_gesture,402229,404603,2374,Japan,J09,NA,NA,NA,NA
silence,408262,408423,161,Japan,J09,NA,NA,NA,NA
silence,409611,417406,7795,Japan,J09,NA,NA,NA,NA
silence,418866,419417,551,Japan,J09,NA,NA,NA,NA
silence,422919,424268,1349,Japan,J09,NA,NA,NA,NA
silence,425361,427207,1846,Japan,J09,NA,NA,NA,NA
silence,429548,430616,1068,Japan,J09,NA,NA,NA,NA
silence,431616,432924,1308,Japan,J09,NA,NA,NA,NA
silence,439616,439866,250,Japan,J09,NA,NA,NA,NA
silence,440820,441221,401,Japan,J09,NA,NA,NA,NA
silence,442130,443289,1159,Japan,J09,NA,NA,NA,NA
silence,444102,445135,1033,Japan,J09,NA,NA,NA,NA
silence,446826,447666,840,Japan,J09,NA,NA,NA,NA
silence,448815,449814,999,Japan,J09,NA,NA,NA,NA
silence,450529,450909,380,Japan,J09,NA,NA,NA,NA
child_gesture,450911,453700,2789,Japan,J09,NA,NA,NA,NA
silence,451798,452174,376,Japan,J09,NA,NA,NA,NA
father_gesture,451885,453256,1371,Japan,J09,NA,NA,NA,NA
father_gesture,453628,455171,1543,Japan,J09,NA,NA,NA,NA
silence,455173,455654,481,Japan,J09,NA,NA,NA,NA
silence,458506,458616,110,Japan,J09,NA,NA,NA,NA
silence,459587,461926,2339,Japan,J09,NA,NA,NA,NA
silence,463299,464145,846,Japan,J09,NA,NA,NA,NA
silence,466582,467616,1034,Japan,J09,NA,NA,NA,NA
silence,471890,478542,6652,Japan,J09,NA,NA,NA,NA
silence,480677,480711,34,Japan,J09,NA,NA,NA,NA
silence,482522,482840,318,Japan,J09,NA,NA,NA,NA
silence,487816,502424,14608,Japan,J09,NA,NA,NA,NA
silence,505616,505998,382,Japan,J09,NA,NA,NA,NA
silence,507197,507461,264,Japan,J09,NA,NA,NA,NA
silence,508044,508302,258,Japan,J09,NA,NA,NA,NA
child_gesture,508805,511067,2262,Japan,J09,NA,NA,NA,NA
silence,511068,513163,2095,Japan,J09,NA,NA,NA,NA
silence,514837,526582,11745,Japan,J09,NA,NA,NA,NA
silence,527263,528914,1651,Japan,J09,NA,NA,NA,NA
silence,529936,530227,291,Japan,J09,NA,NA,NA,NA
silence,534936,536015,1079,Japan,J09,NA,NA,NA,NA
silence,537792,538320,528,Japan,J09,NA,NA,NA,NA
silence,538808,539464,656,Japan,J09,NA,NA,NA,NA
child,539464,540423,959,Japan,J09,f,NA,NA,a
silence,541585,545616,4031,Japan,J09,NA,NA,NA,NA
silence,548008,548105,97,Japan,J09,NA,NA,NA,NA
silence,549998,550165,167,Japan,J09,NA,NA,NA,NA
silence,550943,551215,272,Japan,J09,NA,NA,NA,NA
silence,552116,558885,6769,Japan,J09,NA,NA,NA,NA
silence,563419,566209,2790,Japan,J09,NA,NA,NA,NA
silence,570349,570438,89,Japan,J09,NA,NA,NA,NA
silence,571612,571828,216,Japan,J09,NA,NA,NA,NA
silence,573622,577312,3690,Japan,J09,NA,NA,NA,NA
silence,578420,580820,2400,Japan,J09,NA,NA,NA,NA
silence,581611,582177,566,Japan,J09,NA,NA,NA,NA
silence,583230,583423,193,Japan,J09,NA,NA,NA,NA
silence,583918,585655,1737,Japan,J09,NA,NA,NA,NA
silence,590872,593012,2140,Japan,J09,NA,NA,NA,NA
silence,594952,595390,438,Japan,J09,NA,NA,NA,NA
silence,596055,596628,573,Japan,J09,NA,NA,NA,NA
mother,1413,2402,989,Japan,J10,c,1,1,q
child,3853,6463,2610,Japan,J10,m,1,2,a
mother,5973,8463,2490,Japan,J10,c,1,3,a
father,6633,9721,3088,Japan,J10,c,1,4,a
father,10193,11921,1728,Japan,J10,b,2,1,a
mother,11872,13051,1179,Japan,J10,c,3,1,a
child,13546,14788,1242,Japan,J10,m,3,2,a
mother,14453,14826,373,Japan,J10,NA,3,3,a
mother,15853,19933,4080,Japan,J10,c,3,4,a
mother,20514,25082,4568,Japan,J10,f,4,1,a
mother,31742,32569,827,Japan,J10,f,4,2,a
father,33827,34300,473,Japan,J10,m,4,3,a
mother,34343,36674,2331,Japan,J10,f,4,4,a
mother,26967,28392,1425,Japan,J10,b,5,1,a
mother,49035,51243,2208,Japan,J10,b,6,1,a
father,51503,52029,526,Japan,J10,m,6,2,a
mother,71819,74874,3055,Japan,J10,f,7,1,q
father,74995,75654,659,Japan,J10,m,7,2,a
mother,75532,75915,383,Japan,J10,f,7,3,a
mother,96446,97609,1163,Japan,J10,c,8,1,q
child,102022,102953,931,Japan,J10,m,9,1,a
child,105067,109538,4471,Japan,J10,m,9,2,a
mother,109364,110359,995,Japan,J10,c,9,3,a
mother,127603,131058,3455,Japan,J10,NA,10,1,a
father,132164,132616,452,Japan,J10,c,10,2,a
mother,133680,135966,2286,Japan,J10,c,10,3,q
father,141453,142202,749,Japan,J10,NA,10,4,q
mother,143032,147600,4568,Japan,J10,c,10,5,q
child,148058,148464,406,Japan,J10,m,10,6,a
mother,148232,151907,3675,Japan,J10,c,10,7,a
father,153795,154257,462,Japan,J10,c,10,8,a
father,155792,156880,1088,Japan,J10,NA,10,9,q
mother,158537,161821,3284,Japan,J10,c,10,10,q
child,162921,163432,511,Japan,J10,m,10,11,a
mother,163327,163848,521,Japan,J10,c,10,12,a
mother,189232,190748,1516,Japan,J10,c,11,1,a
child,191045,191450,405,Japan,J10,m,11,2,a
child,193664,195005,1341,Japan,J10,m,11,3,a
mother,194611,196121,1510,Japan,J10,c,11,4,a
mother,199016,200143,1127,Japan,J10,f,12,1,q
father,200221,200600,379,Japan,J10,m,12,2,a
mother,200543,200937,394,Japan,J10,f,12,3,a
mother,204337,205055,718,Japan,J10,f,12,4,q
father,206327,207172,845,Japan,J10,m,12,5,a
child,228018,230793,2775,Japan,J10,m,13,1,q
mother,230289,232084,1795,Japan,J10,c,13,2,a
child,281358,281976,618,Japan,J10,m,13,3,a
mother,282057,282846,789,Japan,J10,s,13,4,a
child,285258,286121,863,Japan,J10,m,13,5,a
child,290543,291158,615,Japan,J10,NA,13,6,a
mother,291593,292398,805,Japan,J10,NA,13,7,a
mother,299652,301400,1748,Japan,J10,c,14,1,q
mother,303503,304438,935,Japan,J10,NA,15,1,a
mother,310933,312769,1836,Japan,J10,c,16,1,a
mother,397874,399053,1179,Japan,J10,c,17,1,q
mother,403841,404211,370,Japan,J10,c,17,2,a
mother,407827,410179,2352,Japan,J10,NA,18,1,q
mother,414000,415779,1779,Japan,J10,f,18,2,q
father,419732,421726,1994,Japan,J10,m,18,3,a
mother,421716,422300,584,Japan,J10,f,18,4,a
mother,433800,434607,807,Japan,J10,c,19,1,q
child,434873,435948,1075,Japan,J10,m,19,2,a
mother,436421,441027,4606,Japan,J10,c,19,3,a
child,441212,441690,478,Japan,J10,m,19,4,a
mother,441674,443973,2299,Japan,J10,m,19,5,a
child,444149,444497,348,Japan,J10,m,19,6,a
father,446965,448717,1752,Japan,J10,m,20,1,q
mother,448643,449264,621,Japan,J10,f,20,2,a
mother,456351,456935,584,Japan,J10,f,20,3,q
father,457148,459327,2179,Japan,J10,m,20,4,q
mother,459534,464332,4798,Japan,J10,f,20,5,i
child,465111,466579,1468,Japan,J10,m,20,6,q
mother,466628,467701,1073,Japan,J10,f,20,7,a
child,468143,468879,736,Japan,J10,m,20,8,q
mother,468795,469200,405,Japan,J10,c,20,9,a
child,485509,487750,2241,Japan,J10,m,21,1,a
mother,488711,489764,1053,Japan,J10,c,21,2,a
mother,493743,496488,2745,Japan,J10,NA,21,3,a
child,497263,498026,763,Japan,J10,m,21,4,a
child,503246,506843,3597,Japan,J10,m,21,5,a
mother,510443,513958,3515,Japan,J10,c,21,6,a
mother,516353,520023,3670,Japan,J10,c,21,7,a
child,530369,535821,5452,Japan,J10,m,22,1,q
mother,536532,539065,2533,Japan,J10,c,22,2,a
child,539932,540469,537,Japan,J10,m,22,3,a
mother,540506,541550,1044,Japan,J10,c,22,4,q
child,543243,543695,452,Japan,J10,m,22,5,a
mother,543444,544511,1067,Japan,J10,c,22,6,q
child,545379,545843,464,Japan,J10,m,22,7,a
mother,545758,546237,479,Japan,J10,c,22,8,a
silence,2402,3853,1451,Japan,J10,NA,NA,NA,NA
silence,9721,10193,472,Japan,J10,NA,NA,NA,NA
silence,13051,13546,495,Japan,J10,NA,NA,NA,NA
silence,14826,15853,1027,Japan,J10,NA,NA,NA,NA
silence,19933,20514,581,Japan,J10,NA,NA,NA,NA
silence,25082,26967,1885,Japan,J10,NA,NA,NA,NA
silence,28392,31742,3350,Japan,J10,NA,NA,NA,NA
silence,32569,33827,1258,Japan,J10,NA,NA,NA,NA
silence,34300,34343,43,Japan,J10,NA,NA,NA,NA
silence,36674,49035,12361,Japan,J10,NA,NA,NA,NA
silence,51243,51503,260,Japan,J10,NA,NA,NA,NA
silence,52029,71819,19790,Japan,J10,NA,NA,NA,NA
silence,74874,74995,121,Japan,J10,NA,NA,NA,NA
silence,75915,96446,20531,Japan,J10,NA,NA,NA,NA
silence,97609,102022,4413,Japan,J10,NA,NA,NA,NA
child_gesture,101989,106247,4258,Japan,J10,NA,NA,NA,NA
silence,102953,105067,2114,Japan,J10,NA,NA,NA,NA
child_gesture,106474,109521,3047,Japan,J10,NA,NA,NA,NA
silence,110359,127603,17244,Japan,J10,NA,NA,NA,NA
silence,131058,132164,1106,Japan,J10,NA,NA,NA,NA
silence,132616,133680,1064,Japan,J10,NA,NA,NA,NA
silence,135966,141453,5487,Japan,J10,NA,NA,NA,NA
silence,142202,143032,830,Japan,J10,NA,NA,NA,NA
silence,147600,148058,458,Japan,J10,NA,NA,NA,NA
silence,151907,153795,1888,Japan,J10,NA,NA,NA,NA
silence,154257,155792,1535,Japan,J10,NA,NA,NA,NA
silence,156880,158537,1657,Japan,J10,NA,NA,NA,NA
silence,161821,162921,1100,Japan,J10,NA,NA,NA,NA
silence,163848,189232,25384,Japan,J10,NA,NA,NA,NA
silence,190748,191045,297,Japan,J10,NA,NA,NA,NA
silence,191450,193664,2214,Japan,J10,NA,NA,NA,NA
silence,196121,199016,2895,Japan,J10,NA,NA,NA,NA
silence,200143,200221,78,Japan,J10,NA,NA,NA,NA
silence,200937,204337,3400,Japan,J10,NA,NA,NA,NA
silence,205055,206327,1272,Japan,J10,NA,NA,NA,NA
silence,207172,228018,20846,Japan,J10,NA,NA,NA,NA
silence,232084,281358,49274,Japan,J10,NA,NA,NA,NA
silence,281976,282057,81,Japan,J10,NA,NA,NA,NA
silence,282846,285258,2412,Japan,J10,NA,NA,NA,NA
silence,286121,290543,4422,Japan,J10,NA,NA,NA,NA
silence,291158,291593,435,Japan,J10,NA,NA,NA,NA
silence,292398,299652,7254,Japan,J10,NA,NA,NA,NA
silence,301400,303503,2103,Japan,J10,NA,NA,NA,NA
silence,304438,310933,6495,Japan,J10,NA,NA,NA,NA
silence,312769,396378,83609,Japan,J10,NA,NA,NA,NA
child,396378,397790,1412,Japan,J10,m,NA,NA,a
silence,397790,397874,84,Japan,J10,NA,NA,NA,NA
silence,399053,403841,4788,Japan,J10,NA,NA,NA,NA
child_gesture,399653,402555,2902,Japan,J10,NA,NA,NA,NA
silence,404211,406051,1840,Japan,J10,NA,NA,NA,NA
mother,406051,406758,707,Japan,J10,c,NA,NA,q
silence,406758,407827,1069,Japan,J10,NA,NA,NA,NA
silence,410179,414000,3821,Japan,J10,NA,NA,NA,NA
silence,415779,419732,3953,Japan,J10,NA,NA,NA,NA
silence,422300,432064,9764,Japan,J10,NA,NA,NA,NA
child,432064,433765,1701,Japan,J10,m,NA,NA,q
silence,433765,433800,35,Japan,J10,NA,NA,NA,NA
silence,434607,434873,266,Japan,J10,NA,NA,NA,NA
silence,435948,436421,473,Japan,J10,NA,NA,NA,NA
child_gesture,436411,439537,3126,Japan,J10,NA,NA,NA,NA
silence,441027,441212,185,Japan,J10,NA,NA,NA,NA
silence,443973,444149,176,Japan,J10,NA,NA,NA,NA
silence,444497,446965,2468,Japan,J10,NA,NA,NA,NA
silence,449264,453936,4672,Japan,J10,NA,NA,NA,NA
father,453936,455700,1764,Japan,J10,m,NA,NA,a
silence,455700,456351,651,Japan,J10,NA,NA,NA,NA
silence,456935,457148,213,Japan,J10,NA,NA,NA,NA
silence,459327,459534,207,Japan,J10,NA,NA,NA,NA
silence,464332,465111,779,Japan,J10,NA,NA,NA,NA
silence,466579,466628,49,Japan,J10,NA,NA,NA,NA
silence,467701,468143,442,Japan,J10,NA,NA,NA,NA
silence,469200,485509,16309,Japan,J10,NA,NA,NA,NA
silence,487750,488711,961,Japan,J10,NA,NA,NA,NA
silence,489764,493703,3939,Japan,J10,NA,NA,NA,NA
child,493703,494474,771,Japan,J10,m,NA,NA,a
silence,496488,497263,775,Japan,J10,NA,NA,NA,NA
silence,498026,503246,5220,Japan,J10,NA,NA,NA,NA
silence,506843,510443,3600,Japan,J10,NA,NA,NA,NA
silence,513958,516353,2395,Japan,J10,NA,NA,NA,NA
silence,520023,530369,10346,Japan,J10,NA,NA,NA,NA
child_gesture,530816,532748,1932,Japan,J10,NA,NA,NA,NA
child_gesture,532774,535634,2860,Japan,J10,NA,NA,NA,NA
silence,535821,536532,711,Japan,J10,NA,NA,NA,NA
silence,539065,539932,867,Japan,J10,NA,NA,NA,NA
silence,540469,540506,37,Japan,J10,NA,NA,NA,NA
silence,541550,543243,1693,Japan,J10,NA,NA,NA,NA
silence,544511,545379,868,Japan,J10,NA,NA,NA,NA
child,986,10483,9497,Japan,J11,b,1,1,a
mother,3356,10338,6982,Japan,J11,c,1,2,a
mother,11890,12405,515,Japan,J11,c,1,3,q
child,12641,13187,546,Japan,J11,m,1,4,q
child,14434,16290,1856,Japan,J11,m,1,5,a
mother,15331,18276,2945,Japan,J11,c,1,6,a
child,18338,18738,400,Japan,J11,m,1,7,a
mother,18755,19135,380,Japan,J11,c,1,8,a
child,21772,24869,3097,Japan,J11,f,2,1,a
father,25310,25993,683,Japan,J11,c,2,2,a
mother,26457,28306,1849,Japan,J11,f,2,3,a
mother,28760,30784,2024,Japan,J11,c,3,1,q
child,30992,31428,436,Japan,J11,m,3,2,a
mother,32765,35985,3220,Japan,J11,f,3,3,a
child,36883,39172,2289,Japan,J11,m,4,1,a
mother,39334,40889,1555,Japan,J11,c,4,2,a
mother,45896,46917,1021,Japan,J11,c,4,3,a
child,48159,50931,2772,Japan,J11,m,4,4,a
mother,51254,51544,290,Japan,J11,c,4,5,a
child,52145,54103,1958,Japan,J11,m,4,6,a
father,41448,44365,2917,Japan,J11,o,5,1,a
father,48186,48855,669,Japan,J11,o,6,1,q
mother,48859,50630,1771,Japan,J11,f,7,1,a
mother,55210,59723,4513,Japan,J11,f,8,1,a
child,58145,58545,400,Japan,J11,m,8,2,q
father,59428,60561,1133,Japan,J11,m,8,3,a
mother,61785,66241,4456,Japan,J11,c,9,1,a
child,66269,67245,976,Japan,J11,m,9,2,a
mother,67464,68328,864,Japan,J11,c,9,3,q
child,68365,68621,256,Japan,J11,m,9,4,a
mother,68673,69247,574,Japan,J11,c,9,5,a
child,69641,70290,649,Japan,J11,m,9,6,a
mother,70369,71146,777,Japan,J11,c,9,7,a
child,73097,75324,2227,Japan,J11,m,9,8,a
mother,75704,77025,1321,Japan,J11,c,9,9,a
child,77007,77387,380,Japan,J11,m,9,10,a
child,79200,86076,6876,Japan,J11,f,10,1,a
father,86531,87901,1370,Japan,J11,o,12,1,a
child,89248,90395,1147,Japan,J11,f,13,1,a
father,90786,93324,2538,Japan,J11,c,13,2,a
mother,93803,96132,2329,Japan,J11,c,14,1,a
child,96372,96690,318,Japan,J11,m,14,2,a
mother,96657,97352,695,Japan,J11,c,14,3,q
child,98545,100005,1460,Japan,J11,m,14,4,a
mother,100643,101476,833,Japan,J11,c,14,5,q
child,101407,102241,834,Japan,J11,m,14,6,a
mother,102846,104513,1667,Japan,J11,c,14,7,i
child,104538,107538,3000,Japan,J11,m,14,8,i
mother,107945,109413,1468,Japan,J11,c,14,9,i
child,110186,113241,3055,Japan,J11,m,14,10,a
mother,112223,116089,3866,Japan,J11,c,14,11,q
child,116324,117212,888,Japan,J11,m,14,12,a
mother,116933,117352,419,Japan,J11,c,14,13,a
mother,119223,119908,685,Japan,J11,c,14,14,q
child,120731,121524,793,Japan,J11,m,14,15,q
mother,121562,122019,457,Japan,J11,c,14,16,q
child,122193,124793,2600,Japan,J11,f,14,17,a
child,131157,132724,1567,Japan,J11,m,15,1,a
mother,132840,134785,1945,Japan,J11,c,15,2,a
child,134490,135107,617,Japan,J11,m,15,3,a
child,142524,143855,1331,Japan,J11,m,15,4,a
mother,143698,146920,3222,Japan,J11,c,15,5,a
child,148772,149317,545,Japan,J11,f,15,6,a
father,151007,152026,1019,Japan,J11,c,15,7,a
mother,152248,155548,3300,Japan,J11,c,15,8,a
child,154179,159021,4842,Japan,J11,m,15,9,a
mother,159464,161254,1790,Japan,J11,c,15,10,a
child,161310,161759,449,Japan,J11,m,15,11,q
father,174558,175969,1411,Japan,J11,b,16,1,a
mother,181538,182113,575,Japan,J11,o,17,1,a
child,191207,192049,842,Japan,J11,b,18,1,a
child,194725,195310,585,Japan,J11,b,18,2,a
mother,195710,196976,1266,Japan,J11,NA,18,3,q
child,197193,197579,386,Japan,J11,m,18,4,q
child,198848,199655,807,Japan,J11,m,18,5,a
mother,201180,204957,3777,Japan,J11,c,18,6,a
mother,208493,209414,921,Japan,J11,c,18,7,q
mother,214075,214568,493,Japan,J11,c,18,8,q
child,214593,214821,228,Japan,J11,m,18,9,a
mother,216087,216754,667,Japan,J11,c,18,10,q
child,219945,221634,1689,Japan,J11,m,18,11,a
mother,221284,223420,2136,Japan,J11,c,18,12,q
child,223793,225055,1262,Japan,J11,c,18,13,a
mother,225050,226014,964,Japan,J11,c,18,14,a
child,226867,228347,1480,Japan,J11,m,18,15,a
mother,230470,232661,2191,Japan,J11,c,18,16,a
child,232234,233366,1132,Japan,J11,f,18,17,a
father,236045,236953,908,Japan,J11,c,18,18,a
child,236952,238572,1620,Japan,J11,f,18,19,a
child,240083,243262,3179,Japan,J11,m,18,20,a
mother,242494,244377,1883,Japan,J11,c,18,21,q
child,244455,244697,242,Japan,J11,m,18,22,a
mother,246254,246785,531,Japan,J11,m,18,23,a
father,264055,270371,6316,Japan,J11,m,19,1,q
mother,270612,271044,432,Japan,J11,f,19,2,q
father,271207,271428,221,Japan,J11,m,19,3,a
child,271393,272614,1221,Japan,J11,f,19,4,a
mother,272661,274032,1371,Japan,J11,b,19,5,a
father,274552,275185,633,Japan,J11,c,19,6,a
mother,277247,277895,648,Japan,J11,f,19,7,q
father,278059,278467,408,Japan,J11,m,19,8,a
mother,279822,280945,1123,Japan,J11,f,19,9,a
child,280938,281653,715,Japan,J11,f,19,10,a
child,284467,285020,553,Japan,J11,f,19,11,a
father,285090,285331,241,Japan,J11,c,19,12,q
child,285352,286362,1010,Japan,J11,f,19,13,q
father,287000,287690,690,Japan,J11,c,19,14,a
child,288145,290062,1917,Japan,J11,f,19,15,q
father,290124,291772,1648,Japan,J11,c,19,16,a
child,292191,293377,1186,Japan,J11,NA,19,17,q
father,296524,298140,1616,Japan,J11,c,19,18,q
child,298559,299574,1015,Japan,J11,f,19,19,i
mother,302445,304546,2101,Japan,J11,f,19,20,a
father,309607,310938,1331,Japan,J11,m,19,21,q
mother,312927,315735,2808,Japan,J11,f,19,22,a
mother,294859,295705,846,Japan,J11,c,20,1,i
mother,334433,343192,8759,Japan,J11,c,21,1,a
mother,345544,350136,4592,Japan,J11,c,21,2,i
mother,351652,352371,719,Japan,J11,c,21,3,a
child,352969,354027,1058,Japan,J11,m,21,4,a
father,369503,370319,816,Japan,J11,c,22,1,q
mother,372686,373296,610,Japan,J11,m,22,2,i
father,385421,389290,3869,Japan,J11,m,23,1,a
mother,389538,389889,351,Japan,J11,f,23,2,q
father,390186,391517,1331,Japan,J11,m,23,3,a
mother,391951,395112,3161,Japan,J11,f,23,4,i
father,395910,397193,1283,Japan,J11,m,23,5,a
mother,397217,402160,4943,Japan,J11,f,23,6,a
mother,405031,407046,2015,Japan,J11,f,23,7,i
father,409255,413517,4262,Japan,J11,m,23,8,a
mother,409644,409902,258,Japan,J11,m,23,9,q
child,413069,414545,1476,Japan,J11,f,23,10,i
mother,415513,416283,770,Japan,J11,f,23,11,q
father,416386,416791,405,Japan,J11,m,23,12,a
mother,419217,421568,2351,Japan,J11,c,23,13,q
child,421827,423586,1759,Japan,J11,m,23,14,a
mother,423945,424815,870,Japan,J11,c,23,15,q
child,424814,425103,289,Japan,J11,m,23,16,a
mother,424840,426020,1180,Japan,J11,c,23,17,q
father,426103,427150,1047,Japan,J11,c,23,18,q
child,427262,427993,731,Japan,J11,f,23,19,a
child,428676,432855,4179,Japan,J11,m,23,20,a
mother,432315,434372,2057,Japan,J11,c,23,21,a
child,435400,435766,366,Japan,J11,m,23,22,q
mother,436247,436994,747,Japan,J11,f,23,23,q
child,437166,438572,1406,Japan,J11,m,23,24,i
mother,439204,440840,1636,Japan,J11,f,23,25,q
father,441683,444572,2889,Japan,J11,m,23,26,a
mother,445322,446383,1061,Japan,J11,f,23,27,a
child,449731,450322,591,Japan,J11,f,23,28,a
mother,450994,453377,2383,Japan,J11,f,23,29,a
child,451855,454993,3138,Japan,J11,b,23,30,a
child,457117,458872,1755,Japan,J11,b,23,31,a
mother,463964,467933,3969,Japan,J11,f,23,32,a
child,395149,395866,717,Japan,J11,m,24,1,q
child,408228,409034,806,Japan,J11,f,25,1,a
child,474721,476241,1520,Japan,J11,m,26,1,a
child,478370,478709,339,Japan,J11,NA,26,2,a
child,479993,480517,524,Japan,J11,m,26,3,a
child,482821,485200,2379,Japan,J11,m,26,4,a
mother,483334,483581,247,Japan,J11,c,26,5,a
mother,485260,486075,815,Japan,J11,c,26,6,q
child,486083,486310,227,Japan,J11,NA,26,7,a
mother,486322,486630,308,Japan,J11,c,26,8,a
mother,493836,494469,633,Japan,J11,c,27,1,q
mother,496951,499704,2753,Japan,J11,c,27,2,i
mother,502822,504870,2048,Japan,J11,c,27,3,i
child,505294,510207,4913,Japan,J11,f,27,4,a
mother,511433,513464,2031,Japan,J11,c,27,5,a
child,513774,514331,557,Japan,J11,f,27,6,a
child,518352,521524,3172,Japan,J11,f,28,1,a
father,521552,521910,358,Japan,J11,c,28,2,a
child,523200,524552,1352,Japan,J11,f,28,3,a
father,524810,525328,518,Japan,J11,c,28,4,a
child,536641,537025,384,Japan,J11,m,29,1,a
mother,537285,537896,611,Japan,J11,c,29,2,a
mother,542636,544840,2204,Japan,J11,c,29,3,a
mother,547507,549704,2197,Japan,J11,c,29,4,a
mother,553883,558772,4889,Japan,J11,c,29,5,a
mother,559750,561710,1960,Japan,J11,f,30,1,a
father,577241,578510,1269,Japan,J11,c,31,1,a
mother,578735,579106,371,Japan,J11,f,31,2,q
father,579283,580422,1139,Japan,J11,m,31,3,a
mother,584204,585093,889,Japan,J11,f,31,4,q
father,585855,586680,825,Japan,J11,m,31,5,a
child,579575,583490,3915,Japan,J11,f,32,1,a
father,583000,584000,1000,Japan,J11,c,32,2,a
mother,588439,590673,2234,Japan,J11,f,33,1,a
father,590777,591164,387,Japan,J11,m,33,2,a
mother,591760,595914,4154,Japan,J11,f,33,3,a
child,587332,590014,2682,Japan,J11,f,35,1,a
mother,327513,329098,1585,Japan,J11,m,36,1,q
child,330531,331510,979,Japan,J11,f,36,2,a
silence,10483,11890,1407,Japan,J11,NA,NA,NA,NA
silence,12405,12641,236,Japan,J11,NA,NA,NA,NA
silence,13187,14434,1247,Japan,J11,NA,NA,NA,NA
silence,18276,18338,62,Japan,J11,NA,NA,NA,NA
silence,18738,18755,17,Japan,J11,NA,NA,NA,NA
silence,19135,21772,2637,Japan,J11,NA,NA,NA,NA
silence,24869,25310,441,Japan,J11,NA,NA,NA,NA
silence,25993,26457,464,Japan,J11,NA,NA,NA,NA
silence,28306,28760,454,Japan,J11,NA,NA,NA,NA
silence,30784,30992,208,Japan,J11,NA,NA,NA,NA
silence,31428,32765,1337,Japan,J11,NA,NA,NA,NA
silence,35985,36883,898,Japan,J11,NA,NA,NA,NA
silence,39172,39334,162,Japan,J11,NA,NA,NA,NA
silence,40889,41448,559,Japan,J11,NA,NA,NA,NA
silence,44365,45896,1531,Japan,J11,NA,NA,NA,NA
silence,46917,48159,1242,Japan,J11,NA,NA,NA,NA
silence,50931,51254,323,Japan,J11,NA,NA,NA,NA
silence,51544,52145,601,Japan,J11,NA,NA,NA,NA
silence,54103,55210,1107,Japan,J11,NA,NA,NA,NA
silence,60561,61785,1224,Japan,J11,NA,NA,NA,NA
mother_gesture,62790,64430,1640,Japan,J11,NA,NA,NA,NA
silence,66241,66269,28,Japan,J11,NA,NA,NA,NA
silence,67245,67464,219,Japan,J11,NA,NA,NA,NA
silence,68328,68365,37,Japan,J11,NA,NA,NA,NA
silence,68621,68673,52,Japan,J11,NA,NA,NA,NA
silence,69247,69641,394,Japan,J11,NA,NA,NA,NA
silence,70290,70369,79,Japan,J11,NA,NA,NA,NA
silence,71146,73097,1951,Japan,J11,NA,NA,NA,NA
silence,75324,75704,380,Japan,J11,NA,NA,NA,NA
silence,77387,79200,1813,Japan,J11,NA,NA,NA,NA
silence,86076,86531,455,Japan,J11,NA,NA,NA,NA
silence,87901,89248,1347,Japan,J11,NA,NA,NA,NA
silence,90395,90786,391,Japan,J11,NA,NA,NA,NA
silence,93324,93803,479,Japan,J11,NA,NA,NA,NA
silence,96132,96372,240,Japan,J11,NA,NA,NA,NA
silence,97352,98545,1193,Japan,J11,NA,NA,NA,NA
silence,100005,100643,638,Japan,J11,NA,NA,NA,NA
silence,102241,102846,605,Japan,J11,NA,NA,NA,NA
silence,104513,104538,25,Japan,J11,NA,NA,NA,NA
child_gesture,104779,106500,1721,Japan,J11,NA,NA,NA,NA
silence,107538,107945,407,Japan,J11,NA,NA,NA,NA
silence,109413,110186,773,Japan,J11,NA,NA,NA,NA
silence,116089,116324,235,Japan,J11,NA,NA,NA,NA
silence,117352,118087,735,Japan,J11,NA,NA,NA,NA
child,118087,119010,923,Japan,J11,f,NA,NA,a
silence,119010,119223,213,Japan,J11,NA,NA,NA,NA
silence,119908,120731,823,Japan,J11,NA,NA,NA,NA
silence,121524,121562,38,Japan,J11,NA,NA,NA,NA
silence,122019,122193,174,Japan,J11,NA,NA,NA,NA
silence,124793,124852,59,Japan,J11,NA,NA,NA,NA
mother,124852,129797,4945,Japan,J11,c,NA,NA,a
silence,129797,131157,1360,Japan,J11,NA,NA,NA,NA
silence,132724,132840,116,Japan,J11,NA,NA,NA,NA
silence,135107,142524,7417,Japan,J11,NA,NA,NA,NA
silence,146920,148772,1852,Japan,J11,NA,NA,NA,NA
silence,149317,151007,1690,Japan,J11,NA,NA,NA,NA
silence,152026,152248,222,Japan,J11,NA,NA,NA,NA
child_gesture,155691,159083,3392,Japan,J11,NA,NA,NA,NA
silence,159021,159464,443,Japan,J11,NA,NA,NA,NA
mother_gesture,159172,160805,1633,Japan,J11,NA,NA,NA,NA
silence,161254,161310,56,Japan,J11,NA,NA,NA,NA
silence,161759,174558,12799,Japan,J11,NA,NA,NA,NA
silence,175969,181538,5569,Japan,J11,NA,NA,NA,NA
silence,182113,191207,9094,Japan,J11,NA,NA,NA,NA
silence,192049,194725,2676,Japan,J11,NA,NA,NA,NA
silence,195310,195710,400,Japan,J11,NA,NA,NA,NA
mother_gesture,195815,197338,1523,Japan,J11,NA,NA,NA,NA
silence,196976,197193,217,Japan,J11,NA,NA,NA,NA
silence,197579,198848,1269,Japan,J11,NA,NA,NA,NA
silence,199655,201180,1525,Japan,J11,NA,NA,NA,NA
mother_gesture,202515,203952,1437,Japan,J11,NA,NA,NA,NA
silence,204957,208493,3536,Japan,J11,NA,NA,NA,NA
silence,209414,214075,4661,Japan,J11,NA,NA,NA,NA
silence,214568,214593,25,Japan,J11,NA,NA,NA,NA
silence,214821,216087,1266,Japan,J11,NA,NA,NA,NA
silence,216754,217423,669,Japan,J11,NA,NA,NA,NA
child,217423,217747,324,Japan,J11,m,NA,NA,a
silence,217747,219945,2198,Japan,J11,NA,NA,NA,NA
silence,223420,223793,373,Japan,J11,NA,NA,NA,NA
silence,226014,226867,853,Japan,J11,NA,NA,NA,NA
silence,228347,230470,2123,Japan,J11,NA,NA,NA,NA
silence,233366,236045,2679,Japan,J11,NA,NA,NA,NA
silence,238572,240083,1511,Japan,J11,NA,NA,NA,NA
silence,244377,244455,78,Japan,J11,NA,NA,NA,NA
silence,244697,244698,1,Japan,J11,NA,NA,NA,NA
mother,244698,244988,290,Japan,J11,c,NA,NA,a
silence,244988,246254,1266,Japan,J11,NA,NA,NA,NA
silence,246785,264055,17270,Japan,J11,NA,NA,NA,NA
silence,270371,270612,241,Japan,J11,NA,NA,NA,NA
silence,271044,271207,163,Japan,J11,NA,NA,NA,NA
silence,272614,272661,47,Japan,J11,NA,NA,NA,NA
silence,274032,274552,520,Japan,J11,NA,NA,NA,NA
silence,275185,277247,2062,Japan,J11,NA,NA,NA,NA
silence,277895,278059,164,Japan,J11,NA,NA,NA,NA
silence,278467,279822,1355,Japan,J11,NA,NA,NA,NA
silence,281653,284467,2814,Japan,J11,NA,NA,NA,NA
silence,285020,285090,70,Japan,J11,NA,NA,NA,NA
silence,285331,285352,21,Japan,J11,NA,NA,NA,NA
silence,286362,287000,638,Japan,J11,NA,NA,NA,NA
silence,287690,288145,455,Japan,J11,NA,NA,NA,NA
silence,290062,290124,62,Japan,J11,NA,NA,NA,NA
silence,291772,292191,419,Japan,J11,NA,NA,NA,NA
silence,293377,294859,1482,Japan,J11,NA,NA,NA,NA
silence,295705,296524,819,Japan,J11,NA,NA,NA,NA
silence,298140,298559,419,Japan,J11,NA,NA,NA,NA
silence,299574,302445,2871,Japan,J11,NA,NA,NA,NA
silence,304546,309607,5061,Japan,J11,NA,NA,NA,NA
silence,310938,312927,1989,Japan,J11,NA,NA,NA,NA
silence,315735,327513,11778,Japan,J11,NA,NA,NA,NA
silence,329098,330531,1433,Japan,J11,NA,NA,NA,NA
silence,331510,334433,2923,Japan,J11,NA,NA,NA,NA
mother_gesture,336390,339651,3261,Japan,J11,NA,NA,NA,NA
silence,343192,345544,2352,Japan,J11,NA,NA,NA,NA
silence,350136,351652,1516,Japan,J11,NA,NA,NA,NA
silence,352371,352969,598,Japan,J11,NA,NA,NA,NA
silence,354027,369503,15476,Japan,J11,NA,NA,NA,NA
silence,370319,372686,2367,Japan,J11,NA,NA,NA,NA
silence,373296,385421,12125,Japan,J11,NA,NA,NA,NA
silence,389290,389538,248,Japan,J11,NA,NA,NA,NA
silence,389889,390186,297,Japan,J11,NA,NA,NA,NA
silence,391517,391951,434,Japan,J11,NA,NA,NA,NA
silence,395112,395149,37,Japan,J11,NA,NA,NA,NA
silence,395866,395910,44,Japan,J11,NA,NA,NA,NA
silence,397193,397217,24,Japan,J11,NA,NA,NA,NA
silence,402160,405031,2871,Japan,J11,NA,NA,NA,NA
silence,407046,408228,1182,Japan,J11,NA,NA,NA,NA
silence,409034,409255,221,Japan,J11,NA,NA,NA,NA
silence,414545,415513,968,Japan,J11,NA,NA,NA,NA
silence,416283,416386,103,Japan,J11,NA,NA,NA,NA
silence,416791,419217,2426,Japan,J11,NA,NA,NA,NA
silence,421568,421827,259,Japan,J11,NA,NA,NA,NA
silence,423586,423945,359,Japan,J11,NA,NA,NA,NA
silence,426020,426103,83,Japan,J11,NA,NA,NA,NA
silence,427150,427262,112,Japan,J11,NA,NA,NA,NA
silence,427993,428676,683,Japan,J11,NA,NA,NA,NA
silence,434372,435400,1028,Japan,J11,NA,NA,NA,NA
silence,435766,436247,481,Japan,J11,NA,NA,NA,NA
silence,436994,437166,172,Japan,J11,NA,NA,NA,NA
silence,438572,439204,632,Japan,J11,NA,NA,NA,NA
silence,440840,441683,843,Japan,J11,NA,NA,NA,NA
silence,444572,445322,750,Japan,J11,NA,NA,NA,NA
silence,446383,449731,3348,Japan,J11,NA,NA,NA,NA
silence,450322,450994,672,Japan,J11,NA,NA,NA,NA
silence,454993,457117,2124,Japan,J11,NA,NA,NA,NA
silence,458872,463964,5092,Japan,J11,NA,NA,NA,NA
silence,467933,474721,6788,Japan,J11,NA,NA,NA,NA
mother,475970,478371,2401,Japan,J11,c,NA,NA,a
silence,478709,478735,26,Japan,J11,NA,NA,NA,NA
mother,478735,479908,1173,Japan,J11,c,NA,NA,a
silence,479908,479993,85,Japan,J11,NA,NA,NA,NA
silence,480517,482821,2304,Japan,J11,NA,NA,NA,NA
silence,485200,485260,60,Japan,J11,NA,NA,NA,NA
silence,486075,486083,8,Japan,J11,NA,NA,NA,NA
silence,486310,486322,12,Japan,J11,NA,NA,NA,NA
silence,486630,493836,7206,Japan,J11,NA,NA,NA,NA
silence,494469,496951,2482,Japan,J11,NA,NA,NA,NA
silence,499704,502822,3118,Japan,J11,NA,NA,NA,NA
silence,504870,505294,424,Japan,J11,NA,NA,NA,NA
child_gesture,505326,507176,1850,Japan,J11,NA,NA,NA,NA
child_gesture,508860,511110,2250,Japan,J11,NA,NA,NA,NA
silence,510207,511433,1226,Japan,J11,NA,NA,NA,NA
silence,513464,513774,310,Japan,J11,NA,NA,NA,NA
silence,514331,518352,4021,Japan,J11,NA,NA,NA,NA
child_gesture,518390,520787,2397,Japan,J11,NA,NA,NA,NA
silence,521524,521552,28,Japan,J11,NA,NA,NA,NA
silence,521910,523200,1290,Japan,J11,NA,NA,NA,NA
silence,524552,524810,258,Japan,J11,NA,NA,NA,NA
silence,525328,536641,11313,Japan,J11,NA,NA,NA,NA
silence,537025,537285,260,Japan,J11,NA,NA,NA,NA
silence,537896,542636,4740,Japan,J11,NA,NA,NA,NA
silence,544840,547507,2667,Japan,J11,NA,NA,NA,NA
silence,549704,553883,4179,Japan,J11,NA,NA,NA,NA
silence,558772,559750,978,Japan,J11,NA,NA,NA,NA
silence,561710,577241,15531,Japan,J11,NA,NA,NA,NA
silence,578510,578735,225,Japan,J11,NA,NA,NA,NA
silence,579106,579283,177,Japan,J11,NA,NA,NA,NA
silence,584000,584204,204,Japan,J11,NA,NA,NA,NA
silence,585093,585855,762,Japan,J11,NA,NA,NA,NA
silence,586680,587332,652,Japan,J11,NA,NA,NA,NA
mother_gesture,589162,591943,2781,Japan,J11,NA,NA,NA,NA
silence,590673,590777,104,Japan,J11,NA,NA,NA,NA
silence,591164,591760,596,Japan,J11,NA,NA,NA,NA
silence,595914,599897,3983,Japan,J11,NA,NA,NA,NA
father,864,2091,1227,Japan,J12,m,1,1,a
mother,2245,3195,950,Japan,J12,f,1,2,a
father,5997,7248,1251,Japan,J12,c,2,1,q
mother,6959,8527,1568,Japan,J12,f,2,2,a
child,9360,10410,1050,Japan,J12,b,2,3,a
mother,10001,11265,1264,Japan,J12,c,2,4,a
father,10239,11270,1031,Japan,J12,c,2,5,a
mother,15706,17122,1416,Japan,J12,f,2,6,a
father,16070,17675,1605,Japan,J12,b,2,7,a
mother,19059,20364,1305,Japan,J12,f,3,1,a
father,20680,21264,584,Japan,J12,m,3,2,a
mother,21696,23264,1568,Japan,J12,c,3,3,q
father,22677,24660,1983,Japan,J12,m,3,4,a
mother,24632,26180,1548,Japan,J12,f,3,5,a
father,26673,28822,2149,Japan,J12,m,4,1,a
mother,28782,30426,1644,Japan,J12,f,4,2,a
mother,31236,33725,2489,Japan,J12,f,4,3,a
child,30112,34906,4794,Japan,J12,m,5,1,a
mother,34952,36070,1118,Japan,J12,c,5,2,q
father,35886,36738,852,Japan,J12,c,5,3,q
mother,36536,38380,1844,Japan,J12,c,5,4,a
child,39159,41843,2684,Japan,J12,m,5,5,a
mother,40196,40652,456,Japan,J12,c,5,6,a
father,40555,41593,1038,Japan,J12,c,5,7,a
father,41933,42954,1021,Japan,J12,c,5,8,a
mother,42206,44817,2611,Japan,J12,c,5,9,a
father,45020,48575,3555,Japan,J12,c,5,10,a
mother,48697,55816,7119,Japan,J12,c,5,11,i
child,50673,51144,471,Japan,J12,b,5,12,a
mother,60270,60927,657,Japan,J12,c,5,13,q
child,60738,61360,622,Japan,J12,m,5,14,a
mother,61631,63912,2281,Japan,J12,c,5,15,q
mother,67404,68459,1055,Japan,J12,c,5,16,a
child,69754,71214,1460,Japan,J12,m,5,17,a
mother,71448,72491,1043,Japan,J12,c,5,18,a
child,72780,74527,1747,Japan,J12,m,5,19,i
mother,74641,75116,475,Japan,J12,c,5,20,a
mother,80939,85485,4546,Japan,J12,c,5,21,i
mother,89454,90560,1106,Japan,J12,NA,5,22,a
mother,93222,94996,1774,Japan,J12,c,5,23,a
child,93875,96227,2352,Japan,J12,m,5,24,a
mother,97262,98091,829,Japan,J12,c,5,25,a
mother,99966,105648,5682,Japan,J12,c,5,26,a
child,106492,107313,821,Japan,J12,m,5,27,a
mother,107896,108875,979,Japan,J12,c,5,28,i
mother,118025,120427,2402,Japan,J12,c,6,1,a
child,124430,125893,1463,Japan,J12,m,6,2,a
mother,125412,126512,1100,Japan,J12,c,6,3,i
child,130922,131543,621,Japan,J12,m,6,4,a
mother,131477,132462,985,Japan,J12,c,6,5,i
mother,133825,135143,1318,Japan,J12,c,6,6,a
mother,138151,139391,1240,Japan,J12,c,6,7,a
father,140123,141201,1078,Japan,J12,c,6,8,a
mother,140895,142446,1551,Japan,J12,c,6,9,a
father,151431,152830,1399,Japan,J12,c,6,10,a
mother,152875,153191,316,Japan,J12,c,6,11,a
father,155806,156329,523,Japan,J12,c,6,12,a
mother,158033,159349,1316,Japan,J12,c,6,13,a
father,167622,169074,1452,Japan,J12,c,6,14,a
father,170510,171670,1160,Japan,J12,c,6,15,a
mother,171785,174297,2512,Japan,J12,c,6,16,a
child,190775,192237,1462,Japan,J12,m,7,1,a
mother,192767,193119,352,Japan,J12,c,7,2,q
child,194108,195111,1003,Japan,J12,m,7,3,a
mother,196131,198938,2807,Japan,J12,c,7,4,q
child,201843,202373,530,Japan,J12,m,7,5,a
mother,202885,204191,1306,Japan,J12,c,7,6,a
mother,207801,208707,906,Japan,J12,c,7,7,a
mother,214198,214579,381,Japan,J12,c,7,8,a
mother,218754,219580,826,Japan,J12,c,8,1,a
child,220759,221606,847,Japan,J12,m,8,2,i
mother,221633,222367,734,Japan,J12,c,8,3,a
mother,224094,224762,668,Japan,J12,c,9,1,a
child,225452,226038,586,Japan,J12,m,9,2,a
mother,226180,227285,1105,Japan,J12,c,9,3,i
child,227368,228179,811,Japan,J12,m,9,4,i
mother,232919,233709,790,Japan,J12,NA,9,5,a
mother,240559,241664,1105,Japan,J12,b,9,6,q
mother,242448,244153,1705,Japan,J12,c,10,1,q
father,246991,249875,2884,Japan,J12,m,11,1,a
mother,251706,253880,2174,Japan,J12,f,11,2,a
father,255070,256191,1121,Japan,J12,m,11,3,a
mother,256178,258143,1965,Japan,J12,f,11,4,q
father,258733,259730,997,Japan,J12,m,11,5,a
mother,259982,260898,916,Japan,J12,f,11,6,a
mother,262191,262831,640,Japan,J12,f,11,7,a
mother,273825,275591,1766,Japan,J12,f,11,8,q
father,277149,279085,1936,Japan,J12,m,11,9,a
mother,279381,280231,850,Japan,J12,f,11,10,q
father,280243,280595,352,Japan,J12,m,11,11,a
mother,280480,281027,547,Japan,J12,f,11,12,a
mother,284785,297375,12590,Japan,J12,f,11,13,a
father,294554,295038,484,Japan,J12,m,11,14,a
child,280787,282019,1232,Japan,J12,f,12,1,a
father,282226,283227,1001,Japan,J12,c,12,2,q
child,309027,310244,1217,Japan,J12,m,13,1,a
father,311101,312239,1138,Japan,J12,c,13,2,q
mother,312964,314640,1676,Japan,J12,c,13,3,i
child,314838,319548,4710,Japan,J12,m,13,4,a
father,318577,319765,1188,Japan,J12,c,13,5,q
child,320024,323117,3093,Japan,J12,m,13,6,a
mother,320071,321654,1583,Japan,J12,NA,13,7,a
mother,323214,324496,1282,Japan,J12,c,13,8,a
child,323343,323896,553,Japan,J12,m,13,9,a
father,324330,324980,650,Japan,J12,c,13,10,a
mother,324975,325730,755,Japan,J12,f,13,11,a
mother,327035,342046,15011,Japan,J12,c,13,12,a
father,344590,346575,1985,Japan,J12,m,13,13,q
mother,346648,346985,337,Japan,J12,f,13,14,a
father,347001,350085,3084,Japan,J12,m,13,15,q
mother,347475,348546,1071,Japan,J12,c,13,16,a
mother,349819,357006,7187,Japan,J12,f,13,17,a
father,357774,358917,1143,Japan,J12,c,13,18,q
mother,359303,362296,2993,Japan,J12,f,13,19,a
father,367019,369012,1993,Japan,J12,m,14,1,a
mother,369054,369603,549,Japan,J12,f,14,2,a
mother,386845,387435,590,Japan,J12,b,15,1,a
mother,388648,390091,1443,Japan,J12,f,16,1,a
mother,393866,403975,10109,Japan,J12,f,16,2,a
child,389675,391635,1960,Japan,J12,f,17,1,a
mother,392109,392516,407,Japan,J12,c,17,2,q
mother,411373,414037,2664,Japan,J12,c,18,1,a
mother,415375,417538,2163,Japan,J12,f,18,2,a
mother,418470,419926,1456,Japan,J12,c,18,3,q
father,421780,423359,1579,Japan,J12,c,18,4,a
mother,423343,426617,3274,Japan,J12,c,18,5,a
child,423717,427101,3384,Japan,J12,o,19,1,a
child,431670,436254,4584,Japan,J12,o,19,2,NA
mother,436248,440101,3853,Japan,J12,c,19,3,q
child,438210,445143,6933,Japan,J12,o,19,4,a
mother,445280,463964,18684,Japan,J12,c,19,5,q
mother,466480,468106,1626,Japan,J12,c,19,6,a
mother,469778,490080,20302,Japan,J12,f,20,1,a
father,491643,496117,4474,Japan,J12,m,20,2,a
mother,496195,496480,285,Japan,J12,f,20,3,q
father,497438,501980,4542,Japan,J12,m,20,4,a
mother,501032,502484,1452,Japan,J12,f,20,5,a
mother,505808,509875,4067,Japan,J12,f,20,6,a
child,511721,512890,1169,Japan,J12,m,21,1,a
mother,513885,515206,1321,Japan,J12,c,21,2,i
father,515222,516185,963,Japan,J12,c,21,3,i
child,515370,517691,2321,Japan,J12,m,21,4,a
mother,516322,517548,1226,Japan,J12,c,21,5,a
mother,517664,518897,1233,Japan,J12,c,21,6,i
child,518185,520080,1895,Japan,J12,m,21,7,a
mother,520070,520744,674,Japan,J12,c,21,8,a
mother,522527,526988,4461,Japan,J12,c,21,9,a
mother,529652,532596,2944,Japan,J12,c,21,10,a
mother,533061,534562,1501,Japan,J12,c,21,11,q
child,534258,537027,2769,Japan,J12,m,21,12,a
child,538145,538977,832,Japan,J12,m,21,13,a
mother,539053,539417,364,Japan,J12,c,21,14,a
child,540422,542064,1642,Japan,J12,c,21,15,a
father,540485,543701,3216,Japan,J12,c,21,16,q
mother,541850,542308,458,Japan,J12,c,21,17,a
child,542556,544317,1761,Japan,J12,m,21,18,a
mother,544506,551285,6779,Japan,J12,c,21,19,a
mother,552384,553474,1090,Japan,J12,c,21,20,a
mother,556106,558348,2242,Japan,J12,f,22,1,a
mother,566231,566658,427,Japan,J12,c,23,1,q
mother,571338,572701,1363,Japan,J12,c,24,1,a
child,583409,585054,1645,Japan,J12,m,25,1,a
mother,585914,587961,2047,Japan,J12,c,25,2,q
mother,589591,591948,2357,Japan,J12,c,26,1,a
father,594089,595448,1359,Japan,J12,c,26,2,a
mother,595375,595701,326,Japan,J12,f,26,3,a
father,597146,598265,1119,Japan,J12,c,26,4,a
silence,2091,2245,154,Japan,J12,NA,NA,NA,NA
silence,3195,3612,417,Japan,J12,NA,NA,NA,NA
mother,3612,5227,1615,Japan,J12,f,NA,NA,a
silence,5227,5997,770,Japan,J12,NA,NA,NA,NA
silence,8527,9360,833,Japan,J12,NA,NA,NA,NA
silence,11270,15706,4436,Japan,J12,NA,NA,NA,NA
silence,17675,19059,1384,Japan,J12,NA,NA,NA,NA
mother_gesture,19048,20628,1580,Japan,J12,NA,NA,NA,NA
silence,20364,20680,316,Japan,J12,NA,NA,NA,NA
silence,21264,21696,432,Japan,J12,NA,NA,NA,NA
silence,26180,26673,493,Japan,J12,NA,NA,NA,NA
child_gesture,34706,36581,1875,Japan,J12,NA,NA,NA,NA
silence,34906,34952,46,Japan,J12,NA,NA,NA,NA
silence,38380,39159,779,Japan,J12,NA,NA,NA,NA
child_gesture,38938,40243,1305,Japan,J12,NA,NA,NA,NA
silence,41843,41933,90,Japan,J12,NA,NA,NA,NA
silence,44817,45020,203,Japan,J12,NA,NA,NA,NA
silence,48575,48697,122,Japan,J12,NA,NA,NA,NA
silence,55816,60270,4454,Japan,J12,NA,NA,NA,NA
silence,61360,61631,271,Japan,J12,NA,NA,NA,NA
silence,63912,67404,3492,Japan,J12,NA,NA,NA,NA
silence,68459,69754,1295,Japan,J12,NA,NA,NA,NA
silence,71214,71448,234,Japan,J12,NA,NA,NA,NA
silence,72491,72780,289,Japan,J12,NA,NA,NA,NA
silence,74527,74641,114,Japan,J12,NA,NA,NA,NA
silence,75116,80939,5823,Japan,J12,NA,NA,NA,NA
silence,85485,89454,3969,Japan,J12,NA,NA,NA,NA
silence,90560,93222,2662,Japan,J12,NA,NA,NA,NA
silence,96227,97262,1035,Japan,J12,NA,NA,NA,NA
silence,98091,99966,1875,Japan,J12,NA,NA,NA,NA
silence,105648,106492,844,Japan,J12,NA,NA,NA,NA
silence,107313,107896,583,Japan,J12,NA,NA,NA,NA
silence,108875,118025,9150,Japan,J12,NA,NA,NA,NA
silence,120427,124430,4003,Japan,J12,NA,NA,NA,NA
silence,126512,130922,4410,Japan,J12,NA,NA,NA,NA
silence,132462,133825,1363,Japan,J12,NA,NA,NA,NA
mother_gesture,133827,135391,1564,Japan,J12,NA,NA,NA,NA
silence,135143,138151,3008,Japan,J12,NA,NA,NA,NA
silence,139391,140123,732,Japan,J12,NA,NA,NA,NA
silence,142446,151431,8985,Japan,J12,NA,NA,NA,NA
silence,152830,152875,45,Japan,J12,NA,NA,NA,NA
silence,153191,155806,2615,Japan,J12,NA,NA,NA,NA
silence,156329,158033,1704,Japan,J12,NA,NA,NA,NA
silence,159349,167622,8273,Japan,J12,NA,NA,NA,NA
silence,169074,170510,1436,Japan,J12,NA,NA,NA,NA
silence,171670,171785,115,Japan,J12,NA,NA,NA,NA
silence,174297,190775,16478,Japan,J12,NA,NA,NA,NA
child_gesture,190603,197722,7119,Japan,J12,NA,NA,NA,NA
silence,192237,192767,530,Japan,J12,NA,NA,NA,NA
silence,193119,194108,989,Japan,J12,NA,NA,NA,NA
silence,195111,196131,1020,Japan,J12,NA,NA,NA,NA
silence,198938,201843,2905,Japan,J12,NA,NA,NA,NA
silence,202373,202885,512,Japan,J12,NA,NA,NA,NA
silence,204191,207801,3610,Japan,J12,NA,NA,NA,NA
silence,208707,214198,5491,Japan,J12,NA,NA,NA,NA
silence,214579,218754,4175,Japan,J12,NA,NA,NA,NA
silence,219580,220759,1179,Japan,J12,NA,NA,NA,NA
silence,221606,221633,27,Japan,J12,NA,NA,NA,NA
silence,222367,224094,1727,Japan,J12,NA,NA,NA,NA
silence,224762,225452,690,Japan,J12,NA,NA,NA,NA
silence,226038,226180,142,Japan,J12,NA,NA,NA,NA
silence,227285,227368,83,Japan,J12,NA,NA,NA,NA
silence,228179,232919,4740,Japan,J12,NA,NA,NA,NA
silence,233709,240559,6850,Japan,J12,NA,NA,NA,NA
silence,241664,242448,784,Japan,J12,NA,NA,NA,NA
silence,244153,246991,2838,Japan,J12,NA,NA,NA,NA
silence,249875,251706,1831,Japan,J12,NA,NA,NA,NA
silence,253880,255070,1190,Japan,J12,NA,NA,NA,NA
silence,258143,258733,590,Japan,J12,NA,NA,NA,NA
silence,259730,259982,252,Japan,J12,NA,NA,NA,NA
silence,260898,262191,1293,Japan,J12,NA,NA,NA,NA
silence,262831,273825,10994,Japan,J12,NA,NA,NA,NA
silence,275591,277149,1558,Japan,J12,NA,NA,NA,NA
silence,279085,279381,296,Japan,J12,NA,NA,NA,NA
silence,280231,280243,12,Japan,J12,NA,NA,NA,NA
silence,282019,282226,207,Japan,J12,NA,NA,NA,NA
silence,283227,284785,1558,Japan,J12,NA,NA,NA,NA
silence,297375,309027,11652,Japan,J12,NA,NA,NA,NA
child_gesture,309027,321796,12769,Japan,J12,NA,NA,NA,NA
silence,310244,311101,857,Japan,J12,NA,NA,NA,NA
silence,312239,312964,725,Japan,J12,NA,NA,NA,NA
silence,314640,314838,198,Japan,J12,NA,NA,NA,NA
silence,319765,320024,259,Japan,J12,NA,NA,NA,NA
child_gesture,322315,327697,5382,Japan,J12,NA,NA,NA,NA
silence,323117,323214,97,Japan,J12,NA,NA,NA,NA
silence,325730,327035,1305,Japan,J12,NA,NA,NA,NA
silence,342046,344590,2544,Japan,J12,NA,NA,NA,NA
silence,346575,346648,73,Japan,J12,NA,NA,NA,NA
silence,346985,347001,16,Japan,J12,NA,NA,NA,NA
silence,357006,357774,768,Japan,J12,NA,NA,NA,NA
silence,358917,359303,386,Japan,J12,NA,NA,NA,NA
silence,362296,367019,4723,Japan,J12,NA,NA,NA,NA
silence,369012,369054,42,Japan,J12,NA,NA,NA,NA
silence,369603,386845,17242,Japan,J12,NA,NA,NA,NA
silence,387435,388648,1213,Japan,J12,NA,NA,NA,NA
silence,391635,392109,474,Japan,J12,NA,NA,NA,NA
silence,392516,393866,1350,Japan,J12,NA,NA,NA,NA
silence,403975,411373,7398,Japan,J12,NA,NA,NA,NA
silence,414037,415375,1338,Japan,J12,NA,NA,NA,NA
silence,417538,418470,932,Japan,J12,NA,NA,NA,NA
silence,419926,421780,1854,Japan,J12,NA,NA,NA,NA
silence,427101,431670,4569,Japan,J12,NA,NA,NA,NA
silence,445143,445280,137,Japan,J12,NA,NA,NA,NA
silence,463964,466480,2516,Japan,J12,NA,NA,NA,NA
silence,468106,469778,1672,Japan,J12,NA,NA,NA,NA
mother_gesture,473785,475885,2100,Japan,J12,NA,NA,NA,NA
mother_gesture,475964,478358,2394,Japan,J12,NA,NA,NA,NA
silence,490080,491643,1563,Japan,J12,NA,NA,NA,NA
silence,496117,496195,78,Japan,J12,NA,NA,NA,NA
silence,496480,497438,958,Japan,J12,NA,NA,NA,NA
silence,502484,505808,3324,Japan,J12,NA,NA,NA,NA
silence,509875,511721,1846,Japan,J12,NA,NA,NA,NA
child_gesture,511934,515106,3172,Japan,J12,NA,NA,NA,NA
silence,512890,513885,995,Japan,J12,NA,NA,NA,NA
mother_gesture,514205,515218,1013,Japan,J12,NA,NA,NA,NA
silence,515206,515222,16,Japan,J12,NA,NA,NA,NA
child_gesture,515217,520069,4852,Japan,J12,NA,NA,NA,NA
father_gesture,515232,516190,958,Japan,J12,NA,NA,NA,NA
mother_gesture,516556,517576,1020,Japan,J12,NA,NA,NA,NA
mother_gesture,517790,519445,1655,Japan,J12,NA,NA,NA,NA
silence,520744,522527,1783,Japan,J12,NA,NA,NA,NA
silence,526988,529652,2664,Japan,J12,NA,NA,NA,NA
silence,532596,533061,465,Japan,J12,NA,NA,NA,NA
silence,537027,538145,1118,Japan,J12,NA,NA,NA,NA
child_gesture,538017,539360,1343,Japan,J12,NA,NA,NA,NA
silence,538977,539053,76,Japan,J12,NA,NA,NA,NA
silence,539417,540422,1005,Japan,J12,NA,NA,NA,NA
father_gesture,542227,543963,1736,Japan,J12,NA,NA,NA,NA
silence,544317,544506,189,Japan,J12,NA,NA,NA,NA
mother_gesture,549833,551575,1742,Japan,J12,NA,NA,NA,NA
silence,551285,552384,1099,Japan,J12,NA,NA,NA,NA
silence,553474,556106,2632,Japan,J12,NA,NA,NA,NA
silence,558348,566231,7883,Japan,J12,NA,NA,NA,NA
silence,566658,571338,4680,Japan,J12,NA,NA,NA,NA
silence,572701,583409,10708,Japan,J12,NA,NA,NA,NA
silence,585054,585914,860,Japan,J12,NA,NA,NA,NA
silence,587961,589591,1630,Japan,J12,NA,NA,NA,NA
silence,591948,594089,2141,Japan,J12,NA,NA,NA,NA
silence,595701,597146,1445,Japan,J12,NA,NA,NA,NA
mother,424,1691,1267,Japan,J13,b,1,1,a
child,3950,4762,812,Japan,J13,b,1,2,a
mother,4591,5191,600,Japan,J13,c,1,3,a
father,11502,14160,2658,Japan,J13,b,1,4,a
mother,6248,8342,2094,Japan,J13,b,2,1,a
mother,9829,12066,2237,Japan,J13,c,3,1,a
mother,14772,15866,1094,Japan,J13,o,4,1,a
father,21025,21561,536,Japan,J13,c,5,1,a
mother,23146,23613,467,Japan,J13,o,6,1,a
father,25547,28830,3283,Japan,J13,m,7,1,a
father,33537,35103,1566,Japan,J13,m,7,2,a
mother,35447,35895,448,Japan,J13,f,7,3,a
child,37851,38403,552,Japan,J13,m,7,4,a
father,41282,41711,429,Japan,J13,c,7,5,a
father,42502,43393,891,Japan,J13,m,8,1,a
mother,42766,46110,3344,Japan,J13,f,8,2,a
mother,54431,57851,3420,Japan,J13,f,9,1,q
father,59287,60094,807,Japan,J13,m,9,2,a
mother,60657,64370,3713,Japan,J13,f,9,3,a
mother,66862,70166,3304,Japan,J13,f,9,4,a
father,70355,70829,474,Japan,J13,m,9,5,a
mother,74309,78746,4437,Japan,J13,f,9,6,a
child,77409,78055,646,Japan,J13,b,10,1,a
mother,80591,82856,2265,Japan,J13,c,10,2,q
mother,85609,86784,1175,Japan,J13,c,10,3,q
father,89956,90972,1016,Japan,J13,c,10,4,a
father,91309,92570,1261,Japan,J13,c,11,1,a
mother,98359,101935,3576,Japan,J13,f,11,2,a
father,102547,103218,671,Japan,J13,m,11,3,q
mother,103748,104229,481,Japan,J13,f,11,4,a
father,104563,105833,1270,Japan,J13,m,11,5,a
mother,107475,107960,485,Japan,J13,f,11,6,q
father,110066,111728,1662,Japan,J13,m,11,7,a
mother,113652,115134,1482,Japan,J13,f,11,8,a
father,128646,131547,2901,Japan,J13,c,12,1,a
mother,128984,130496,1512,Japan,J13,o,13,1,a
mother,133320,134646,1326,Japan,J13,o,13,2,a
father,140867,144298,3431,Japan,J13,c,14,1,a
mother,142926,143492,566,Japan,J13,f,14,2,a
mother,145070,151646,6576,Japan,J13,f,14,3,a
mother,153729,159845,6116,Japan,J13,b,14,4,a
father,161751,162900,1149,Japan,J13,m,14,5,q
mother,165061,167430,2369,Japan,J13,NA,14,6,a
father,167940,168573,633,Japan,J13,m,14,7,q
mother,170613,174179,3566,Japan,J13,f,14,8,a
father,180050,180777,727,Japan,J13,m,14,9,a
mother,181487,181880,393,Japan,J13,NA,14,10,a
mother,186044,186907,863,Japan,J13,c,14,11,a
child,188419,189265,846,Japan,J13,m,14,12,a
child,155740,157563,1823,Japan,J13,f,15,1,a
father,157834,158083,249,Japan,J13,c,15,2,a
father,164594,165739,1145,Japan,J13,c,16,1,q
father,189672,192403,2731,Japan,J13,c,17,1,a
mother,191211,191919,708,Japan,J13,f,17,2,a
mother,194906,196002,1096,Japan,J13,f,17,3,a
father,198154,199015,861,Japan,J13,m,17,4,a
mother,199561,200189,628,Japan,J13,NA,17,5,a
father,211713,212635,922,Japan,J13,c,18,1,a
father,219839,220361,522,Japan,J13,b,19,1,a
mother,223780,226785,3005,Japan,J13,o,20,1,a
father,228779,229121,342,Japan,J13,o,21,1,a
mother,229657,240077,10420,Japan,J13,f,22,1,a
father,242464,243501,1037,Japan,J13,m,22,2,a
father,252835,253489,654,Japan,J13,c,23,1,a
mother,258530,261552,3022,Japan,J13,NA,24,1,a
father,264169,265265,1096,Japan,J13,NA,25,1,a
mother,266275,266867,592,Japan,J13,c,25,2,a
father,283388,283956,568,Japan,J13,NA,25,3,a
father,284895,285276,381,Japan,J13,c,26,1,a
mother,285011,304132,19121,Japan,J13,NA,26,2,a
father,287177,287989,812,Japan,J13,c,26,3,a
child,305445,306302,857,Japan,J13,m,26,4,a
mother,306374,307083,709,Japan,J13,c,26,5,a
father,298652,299022,370,Japan,J13,o,27,1,a
father,307016,307671,655,Japan,J13,o,27,2,a
father,313895,314499,604,Japan,J13,o,27,3,a
mother,314575,314946,371,Japan,J13,NA,27,4,a
father,316514,317055,541,Japan,J13,o,27,5,a
mother,322663,323978,1315,Japan,J13,o,28,1,q
mother,326574,327635,1061,Japan,J13,f,29,1,a
father,335536,336361,825,Japan,J13,m,29,2,a
mother,328388,332293,3905,Japan,J13,o,30,1,q
child,330249,330725,476,Japan,J13,o,30,2,a
mother,338072,339110,1038,Japan,J13,f,30,3,a
mother,341531,342668,1137,Japan,J13,c,31,1,a
mother,343533,344227,694,Japan,J13,o,31,2,a
child,344867,346523,1656,Japan,J13,m,31,3,a
mother,347073,348950,1877,Japan,J13,o,32,1,q
child,349359,350031,672,Japan,J13,m,32,2,a
mother,350945,352172,1227,Japan,J13,c,32,3,a
father,354322,355012,690,Japan,J13,o,32,4,q
mother,359284,364325,5041,Japan,J13,f,32,5,a
father,365672,366222,550,Japan,J13,m,32,6,q
mother,366895,369608,2713,Japan,J13,f,32,7,q
father,371622,373259,1637,Japan,J13,NA,32,8,q
mother,373406,379504,6098,Japan,J13,f,32,9,a
mother,379950,383834,3884,Japan,J13,o,32,10,a
mother,391352,393204,1852,Japan,J13,NA,32,11,a
father,400036,402784,2748,Japan,J13,o,32,12,a
father,408558,410340,1782,Japan,J13,o,32,13,a
father,415248,415906,658,Japan,J13,o,32,14,a
mother,417385,418555,1170,Japan,J13,f,32,15,a
mother,419918,420378,460,Japan,J13,o,32,16,a
father,421254,423851,2597,Japan,J13,o,32,17,a
mother,424650,425671,1021,Japan,J13,o,32,18,a
mother,427861,430812,2951,Japan,J13,o,32,19,a
mother,433740,435442,1702,Japan,J13,o,32,20,a
child,370994,372320,1326,Japan,J13,o,33,1,a
mother,371638,372615,977,Japan,J13,o,33,2,a
mother,394360,399469,5109,Japan,J13,f,34,1,a
father,396856,397149,293,Japan,J13,m,34,2,a
mother,402060,412243,10183,Japan,J13,f,34,3,a
father,412304,412690,386,Japan,J13,m,34,4,a
child,435530,438224,2694,Japan,J13,m,35,1,a
mother,438320,440373,2053,Japan,J13,c,35,2,a
child,440585,441409,824,Japan,J13,m,35,3,a
mother,441714,442381,667,Japan,J13,c,35,4,a
father,442304,443773,1469,Japan,J13,o,36,1,a
mother,443768,444508,740,Japan,J13,o,36,2,a
father,457214,458395,1181,Japan,J13,o,36,3,a
mother,460518,466953,6435,Japan,J13,f,36,4,a
child,463746,464559,813,Japan,J13,m,36,5,a
mother,471533,473757,2224,Japan,J13,o,36,6,a
mother,475707,476746,1039,Japan,J13,c,36,7,a
father,477328,479757,2429,Japan,J13,c,36,8,a
mother,451099,454453,3354,Japan,J13,c,37,1,a
mother,456370,457357,987,Japan,J13,c,38,1,a
child,481569,485287,3718,Japan,J13,b,39,1,NA
mother,485293,488972,3679,Japan,J13,c,39,2,a
father,485840,486633,793,Japan,J13,b,40,1,a
father,488530,493195,4665,Japan,J13,o,41,1,a
mother,490193,492823,2630,Japan,J13,o,41,2,a
mother,494652,498646,3994,Japan,J13,f,42,1,a
father,504653,505053,400,Japan,J13,m,42,2,a
mother,505663,506900,1237,Japan,J13,f,42,3,a
mother,518696,528574,9878,Japan,J13,f,44,1,a
mother,530922,532066,1144,Japan,J13,f,44,2,a
mother,533969,538770,4801,Japan,J13,NA,44,3,a
father,535447,535873,426,Japan,J13,o,44,4,a
mother,541265,543817,2552,Japan,J13,f,44,5,a
father,545535,545886,351,Japan,J13,o,44,6,a
mother,546676,547801,1125,Japan,J13,f,45,1,a
mother,548164,548968,804,Japan,J13,o,45,2,q
mother,551558,552177,619,Japan,J13,o,45,3,q
father,553372,553715,343,Japan,J13,m,45,4,a
mother,554443,557143,2700,Japan,J13,o,45,5,a
father,556697,557181,484,Japan,J13,m,45,6,a
mother,558703,560701,1998,Japan,J13,o,45,7,a
father,558867,563652,4785,Japan,J13,o,45,8,a
mother,562265,570106,7841,Japan,J13,c,46,1,a
father,570558,572436,1878,Japan,J13,m,46,2,a
mother,573663,576012,2349,Japan,J13,f,46,3,a
father,573623,574177,554,Japan,J13,o,47,1,a
mother,582226,583040,814,Japan,J13,o,48,1,a
child,587147,587914,767,Japan,J13,b,49,1,a
mother,588314,589385,1071,Japan,J13,o,49,2,a
father,588690,589426,736,Japan,J13,o,49,3,a
child,589652,590425,773,Japan,J13,m,50,1,a
mother,590552,591370,818,Japan,J13,c,50,2,a
child,592127,594552,2425,Japan,J13,m,50,3,a
mother,595017,595640,623,Japan,J13,c,50,4,a
silence,1691,3950,2259,Japan,J13,NA,NA,NA,NA
silence,5191,6248,1057,Japan,J13,NA,NA,NA,NA
silence,8342,9829,1487,Japan,J13,NA,NA,NA,NA
silence,14160,14772,612,Japan,J13,NA,NA,NA,NA
silence,15866,21025,5159,Japan,J13,NA,NA,NA,NA
silence,21561,23146,1585,Japan,J13,NA,NA,NA,NA
silence,23613,25547,1934,Japan,J13,NA,NA,NA,NA
silence,28830,33537,4707,Japan,J13,NA,NA,NA,NA
silence,35103,35447,344,Japan,J13,NA,NA,NA,NA
silence,35895,37851,1956,Japan,J13,NA,NA,NA,NA
silence,38403,41282,2879,Japan,J13,NA,NA,NA,NA
silence,41711,42502,791,Japan,J13,NA,NA,NA,NA
silence,46110,54431,8321,Japan,J13,NA,NA,NA,NA
silence,57851,59287,1436,Japan,J13,NA,NA,NA,NA
silence,60094,60657,563,Japan,J13,NA,NA,NA,NA
silence,64370,66862,2492,Japan,J13,NA,NA,NA,NA
silence,70166,70355,189,Japan,J13,NA,NA,NA,NA
silence,70829,74309,3480,Japan,J13,NA,NA,NA,NA
child_gesture,76459,81162,4703,Japan,J13,NA,NA,NA,NA
silence,78746,80591,1845,Japan,J13,NA,NA,NA,NA
silence,82856,85609,2753,Japan,J13,NA,NA,NA,NA
silence,86784,89956,3172,Japan,J13,NA,NA,NA,NA
silence,90972,91309,337,Japan,J13,NA,NA,NA,NA
silence,92570,98359,5789,Japan,J13,NA,NA,NA,NA
silence,101935,102547,612,Japan,J13,NA,NA,NA,NA
silence,103218,103748,530,Japan,J13,NA,NA,NA,NA
silence,104229,104563,334,Japan,J13,NA,NA,NA,NA
silence,105833,107475,1642,Japan,J13,NA,NA,NA,NA
silence,107960,110066,2106,Japan,J13,NA,NA,NA,NA
silence,111728,113652,1924,Japan,J13,NA,NA,NA,NA
silence,115134,128646,13512,Japan,J13,NA,NA,NA,NA
silence,131547,133320,1773,Japan,J13,NA,NA,NA,NA
silence,134646,140867,6221,Japan,J13,NA,NA,NA,NA
silence,144298,145070,772,Japan,J13,NA,NA,NA,NA
silence,151646,153729,2083,Japan,J13,NA,NA,NA,NA
silence,159845,161751,1906,Japan,J13,NA,NA,NA,NA
silence,162900,164594,1694,Japan,J13,NA,NA,NA,NA
silence,167430,167940,510,Japan,J13,NA,NA,NA,NA
silence,168573,170613,2040,Japan,J13,NA,NA,NA,NA
silence,174179,180050,5871,Japan,J13,NA,NA,NA,NA
silence,180777,181487,710,Japan,J13,NA,NA,NA,NA
silence,181880,186044,4164,Japan,J13,NA,NA,NA,NA
silence,186907,188419,1512,Japan,J13,NA,NA,NA,NA
silence,189265,189672,407,Japan,J13,NA,NA,NA,NA
father_gesture,189392,191613,2221,Japan,J13,NA,NA,NA,NA
silence,192403,194906,2503,Japan,J13,NA,NA,NA,NA
silence,196002,198154,2152,Japan,J13,NA,NA,NA,NA
silence,199015,199561,546,Japan,J13,NA,NA,NA,NA
silence,200189,211713,11524,Japan,J13,NA,NA,NA,NA
silence,212635,216143,3508,Japan,J13,NA,NA,NA,NA
father,216143,217359,1216,Japan,J13,b,NA,NA,a
silence,217359,219839,2480,Japan,J13,NA,NA,NA,NA
silence,220361,223780,3419,Japan,J13,NA,NA,NA,NA
silence,226785,228779,1994,Japan,J13,NA,NA,NA,NA
silence,229121,229657,536,Japan,J13,NA,NA,NA,NA
silence,240077,242464,2387,Japan,J13,NA,NA,NA,NA
silence,243501,252835,9334,Japan,J13,NA,NA,NA,NA
silence,253489,258530,5041,Japan,J13,NA,NA,NA,NA
silence,261552,264169,2617,Japan,J13,NA,NA,NA,NA
silence,265265,266275,1010,Japan,J13,NA,NA,NA,NA
silence,266867,269994,3127,Japan,J13,NA,NA,NA,NA
mother,269994,276762,6768,Japan,J13,c,NA,NA,a
silence,276762,283388,6626,Japan,J13,NA,NA,NA,NA
silence,283956,284895,939,Japan,J13,NA,NA,NA,NA
silence,304132,305445,1313,Japan,J13,NA,NA,NA,NA
silence,306302,306374,72,Japan,J13,NA,NA,NA,NA
silence,307671,308901,1230,Japan,J13,NA,NA,NA,NA
mother,308901,312961,4060,Japan,J13,c,NA,NA,i
silence,312961,313895,934,Japan,J13,NA,NA,NA,NA
silence,314499,314575,76,Japan,J13,NA,NA,NA,NA
silence,314946,316514,1568,Japan,J13,NA,NA,NA,NA
silence,317055,322663,5608,Japan,J13,NA,NA,NA,NA
silence,323978,326574,2596,Japan,J13,NA,NA,NA,NA
silence,327635,328388,753,Japan,J13,NA,NA,NA,NA
silence,332293,335536,3243,Japan,J13,NA,NA,NA,NA
silence,336361,338072,1711,Japan,J13,NA,NA,NA,NA
silence,339110,340459,1349,Japan,J13,NA,NA,NA,NA
child,340459,341323,864,Japan,J13,m,NA,NA,a
silence,341323,341531,208,Japan,J13,NA,NA,NA,NA
silence,342668,343533,865,Japan,J13,NA,NA,NA,NA
silence,344227,344867,640,Japan,J13,NA,NA,NA,NA
silence,346523,347073,550,Japan,J13,NA,NA,NA,NA
silence,348950,349359,409,Japan,J13,NA,NA,NA,NA
silence,350031,350945,914,Japan,J13,NA,NA,NA,NA
silence,352172,354322,2150,Japan,J13,NA,NA,NA,NA
silence,355012,359284,4272,Japan,J13,NA,NA,NA,NA
silence,364325,365672,1347,Japan,J13,NA,NA,NA,NA
silence,366222,366895,673,Japan,J13,NA,NA,NA,NA
silence,369608,370994,1386,Japan,J13,NA,NA,NA,NA
silence,373259,373406,147,Japan,J13,NA,NA,NA,NA
silence,379504,379950,446,Japan,J13,NA,NA,NA,NA
father,381733,383185,1452,Japan,J13,o,NA,NA,a
silence,383834,385704,1870,Japan,J13,NA,NA,NA,NA
father,385704,389829,4125,Japan,J13,o,NA,NA,a
silence,389829,391352,1523,Japan,J13,NA,NA,NA,NA
silence,393204,394360,1156,Japan,J13,NA,NA,NA,NA
silence,399469,400036,567,Japan,J13,NA,NA,NA,NA
silence,412243,412304,61,Japan,J13,NA,NA,NA,NA
silence,412690,415248,2558,Japan,J13,NA,NA,NA,NA
silence,415906,417385,1479,Japan,J13,NA,NA,NA,NA
silence,418555,419918,1363,Japan,J13,NA,NA,NA,NA
silence,420378,421254,876,Japan,J13,NA,NA,NA,NA
mother,423679,424539,860,Japan,J13,f,NA,NA,a
silence,424539,424650,111,Japan,J13,NA,NA,NA,NA
silence,425671,427861,2190,Japan,J13,NA,NA,NA,NA
silence,430812,432558,1746,Japan,J13,NA,NA,NA,NA
father,432558,432865,307,Japan,J13,o,NA,NA,a
silence,432865,433740,875,Japan,J13,NA,NA,NA,NA
silence,435442,435530,88,Japan,J13,NA,NA,NA,NA
silence,438224,438320,96,Japan,J13,NA,NA,NA,NA
silence,440373,440585,212,Japan,J13,NA,NA,NA,NA
silence,441409,441714,305,Japan,J13,NA,NA,NA,NA
silence,444508,451099,6591,Japan,J13,NA,NA,NA,NA
silence,454453,456370,1917,Japan,J13,NA,NA,NA,NA
silence,458395,460518,2123,Japan,J13,NA,NA,NA,NA
silence,466953,469563,2610,Japan,J13,NA,NA,NA,NA
father,469563,474757,5194,Japan,J13,o,NA,NA,a
silence,474757,475707,950,Japan,J13,NA,NA,NA,NA
silence,476746,477328,582,Japan,J13,NA,NA,NA,NA
silence,479757,481569,1812,Japan,J13,NA,NA,NA,NA
child_gesture,480945,481991,1046,Japan,J13,NA,NA,NA,NA
child_gesture,482086,483255,1169,Japan,J13,NA,NA,NA,NA
child_gesture,483277,484380,1103,Japan,J13,NA,NA,NA,NA
child_gesture,484402,485285,883,Japan,J13,NA,NA,NA,NA
silence,485287,485293,6,Japan,J13,NA,NA,NA,NA
silence,493195,494652,1457,Japan,J13,NA,NA,NA,NA
silence,498646,500215,1569,Japan,J13,NA,NA,NA,NA
mother,500215,501569,1354,Japan,J13,o,NA,NA,a
father,501348,502413,1065,Japan,J13,m,NA,NA,a
silence,502413,504653,2240,Japan,J13,NA,NA,NA,NA
silence,505053,505663,610,Japan,J13,NA,NA,NA,NA
silence,506900,509961,3061,Japan,J13,NA,NA,NA,NA
father,509961,517143,7182,Japan,J13,o,NA,NA,a
silence,517143,518696,1553,Japan,J13,NA,NA,NA,NA
silence,528574,530922,2348,Japan,J13,NA,NA,NA,NA
silence,532066,532670,604,Japan,J13,NA,NA,NA,NA
father,532670,533569,899,Japan,J13,o,NA,NA,a
silence,533569,533969,400,Japan,J13,NA,NA,NA,NA
mother_gesture,533957,537425,3468,Japan,J13,NA,NA,NA,NA
silence,538770,541265,2495,Japan,J13,NA,NA,NA,NA
silence,543817,545535,1718,Japan,J13,NA,NA,NA,NA
silence,545886,546676,790,Japan,J13,NA,NA,NA,NA
silence,547801,548164,363,Japan,J13,NA,NA,NA,NA
silence,548968,551558,2590,Japan,J13,NA,NA,NA,NA
silence,552177,553372,1195,Japan,J13,NA,NA,NA,NA
silence,553715,554443,728,Japan,J13,NA,NA,NA,NA
silence,557181,558703,1522,Japan,J13,NA,NA,NA,NA
mother_gesture,561984,564087,2103,Japan,J13,NA,NA,NA,NA
silence,570106,570558,452,Japan,J13,NA,NA,NA,NA
silence,572436,573623,1187,Japan,J13,NA,NA,NA,NA
silence,576012,581821,5809,Japan,J13,NA,NA,NA,NA
father,581821,583166,1345,Japan,J13,o,NA,NA,a
silence,583166,587147,3981,Japan,J13,NA,NA,NA,NA
silence,587914,588314,400,Japan,J13,NA,NA,NA,NA
silence,589426,589652,226,Japan,J13,NA,NA,NA,NA
child_gesture,589430,591387,1957,Japan,J13,NA,NA,NA,NA
silence,590425,590552,127,Japan,J13,NA,NA,NA,NA
silence,591370,592127,757,Japan,J13,NA,NA,NA,NA
child_gesture,591480,595342,3862,Japan,J13,NA,NA,NA,NA
silence,594552,595017,465,Japan,J13,NA,NA,NA,NA
silence,595640,596774,1134,Japan,J13,NA,NA,NA,NA
child_gesture,597100,598132,1032,Japan,J13,NA,NA,NA,NA
child,737,10116,9379,Japan,J14,b,1,1,a
mother,868,2374,1506,Japan,J14,c,2,1,q
father,3213,10947,7734,Japan,J14,c,3,1,a
mother,11871,13042,1171,Japan,J14,c,3,2,a
father,13216,18368,5152,Japan,J14,c,3,3,a
mother,15807,16426,619,Japan,J14,c,3,4,a
mother,18500,20928,2428,Japan,J14,c,3,5,a
father,21294,22434,1140,Japan,J14,b,3,6,a
mother,23058,23833,775,Japan,J14,c,3,7,a
mother,8595,9055,460,Japan,J14,c,4,1,a
child,13144,14350,1206,Japan,J14,m,4,2,q
mother,14505,15343,838,Japan,J14,c,4,3,a
child,23839,25852,2013,Japan,J14,b,5,1,a
father,25568,28250,2682,Japan,J14,c,5,2,i
child,28384,29432,1048,Japan,J14,f,5,3,a
father,29832,30795,963,Japan,J14,NA,5,4,a
mother,30500,31672,1172,Japan,J14,f,5,5,a
father,32621,34015,1394,Japan,J14,c,6,1,a
child,35345,36773,1428,Japan,J14,f,6,2,a
father,36568,36887,319,Japan,J14,NA,6,3,a
father,38140,39552,1412,Japan,J14,c,6,4,a
child,40343,41148,805,Japan,J14,f,6,5,a
father,41305,42833,1528,Japan,J14,c,6,6,a
child,44868,45979,1111,Japan,J14,f,6,7,a
father,46247,50654,4407,Japan,J14,NA,6,8,a
mother,46768,49121,2353,Japan,J14,c,6,9,a
mother,50460,52674,2214,Japan,J14,f,6,10,a
child,51626,52785,1159,Japan,J14,f,6,11,a
father,52693,56263,3570,Japan,J14,NA,6,12,a
mother,54564,56626,2062,Japan,J14,f,7,1,a
mother,58590,60474,1884,Japan,J14,f,7,2,a
child,60511,62785,2274,Japan,J14,b,8,1,a
child,65258,66639,1381,Japan,J14,o,8,2,a
father,70763,71791,1028,Japan,J14,c,8,3,a
child,73500,74546,1046,Japan,J14,f,8,4,a
father,75414,75964,550,Japan,J14,c,8,5,q
child,76595,79016,2421,Japan,J14,f,8,6,a
mother,76621,77931,1310,Japan,J14,c,8,7,q
father,79288,80178,890,Japan,J14,c,8,8,q
child,80285,80758,473,Japan,J14,f,8,9,a
father,80850,82079,1229,Japan,J14,c,8,10,a
child,81592,83591,1999,Japan,J14,f,8,11,a
father,82912,84768,1856,Japan,J14,NA,8,12,a
child,84770,89258,4488,Japan,J14,f,8,13,a
mother,63084,65758,2674,Japan,J14,f,9,1,a
father,64972,67574,2602,Japan,J14,m,9,2,q
mother,67168,69196,2028,Japan,J14,f,9,3,a
father,68970,69539,569,Japan,J14,c,9,4,a
mother,71721,74064,2343,Japan,J14,f,10,1,a
mother,84811,86426,1615,Japan,J14,f,11,1,i
father,86361,86658,297,Japan,J14,m,11,2,a
mother,86704,87552,848,Japan,J14,f,11,3,a
father,86991,87837,846,Japan,J14,c,12,1,a
father,89326,89937,611,Japan,J14,c,12,2,q
child,90028,90374,346,Japan,J14,f,12,3,a
father,90405,91240,835,Japan,J14,c,12,4,q
child,91153,91648,495,Japan,J14,f,12,5,a
father,92152,94053,1901,Japan,J14,c,12,6,q
child,94224,94882,658,Japan,J14,f,12,7,a
mother,94642,95722,1080,Japan,J14,c,12,8,q
father,95839,97092,1253,Japan,J14,NA,12,9,q
father,99495,99890,395,Japan,J14,NA,12,10,q
father,106887,107489,602,Japan,J14,c,12,11,q
mother,101368,103745,2377,Japan,J14,o,13,1,a
father,108547,109226,679,Japan,J14,NA,14,1,a
child,111084,111932,848,Japan,J14,m,14,2,a
mother,111984,113042,1058,Japan,J14,c,14,3,a
child,114882,115466,584,Japan,J14,m,15,1,q
mother,115438,116126,688,Japan,J14,NA,16,1,a
mother,116195,122726,6531,Japan,J14,NA,17,1,i
mother,127072,128079,1007,Japan,J14,b,18,1,a
child,129263,129908,645,Japan,J14,m,19,1,a
mother,130122,130704,582,Japan,J14,c,19,2,a
father,153379,154216,837,Japan,J14,o,20,1,a
father,156812,157620,808,Japan,J14,o,20,2,a
mother,159778,160447,669,Japan,J14,m,20,3,a
father,160689,161749,1060,Japan,J14,m,20,4,q
mother,161783,162701,918,Japan,J14,f,20,5,a
father,162726,164498,1772,Japan,J14,m,20,6,a
child,185661,186590,929,Japan,J14,NA,21,1,q
mother,186811,188490,1679,Japan,J14,NA,21,2,a
child,189595,192847,3252,Japan,J14,m,21,3,q
father,193478,193841,363,Japan,J14,c,21,4,a
mother,193841,199768,5927,Japan,J14,NA,21,5,a
father,200268,200937,669,Japan,J14,m,21,6,q
mother,204659,205244,585,Japan,J14,c,21,7,q
child,206314,207716,1402,Japan,J14,m,21,8,a
child,211638,213846,2208,Japan,J14,NA,21,9,a
mother,214600,215246,646,Japan,J14,NA,21,10,q
child,216186,217039,853,Japan,J14,m,21,11,a
mother,217195,217963,768,Japan,J14,c,21,12,a
father,218611,220679,2068,Japan,J14,NA,21,13,q
child,220946,222401,1455,Japan,J14,m,22,1,q
mother,225405,225989,584,Japan,J14,c,22,2,q
child,228347,228821,474,Japan,J14,m,22,3,a
mother,234636,235749,1113,Japan,J14,c,22,4,q
father,241178,242027,849,Japan,J14,c,23,1,a
father,247490,248459,969,Japan,J14,NA,24,1,a
child,249414,257487,8073,Japan,J14,b,25,1,a
father,253170,253755,585,Japan,J14,c,25,2,a
mother,255455,256028,573,Japan,J14,c,25,3,a
child,262432,264174,1742,Japan,J14,b,26,1,i
child,266211,268593,2382,Japan,J14,m,26,2,i
mother,270818,273084,2266,Japan,J14,c,26,3,a
child,273657,274695,1038,Japan,J14,m,26,4,q
mother,274569,274990,421,Japan,J14,c,26,5,a
child,276237,277774,1537,Japan,J14,m,26,6,q
father,288408,289790,1382,Japan,J14,m,27,1,a
mother,294130,305742,11612,Japan,J14,f,28,1,a
father,298022,298410,388,Japan,J14,m,28,2,a
father,301890,302443,553,Japan,J14,m,28,3,a
father,305958,306504,546,Japan,J14,m,28,4,q
mother,307030,307342,312,Japan,J14,f,28,5,q
father,307553,308157,604,Japan,J14,m,28,6,a
child,311225,312168,943,Japan,J14,b,29,1,a
father,313963,315405,1442,Japan,J14,o,30,1,a
child,326531,327571,1040,Japan,J14,b,31,1,a
father,327902,328269,367,Japan,J14,c,31,2,a
father,331750,334326,2576,Japan,J14,c,31,3,a
mother,335176,338603,3427,Japan,J14,c,31,4,a
mother,340765,341926,1161,Japan,J14,c,32,1,a
mother,344937,347294,2357,Japan,J14,f,32,2,a
father,347770,348187,417,Japan,J14,c,32,3,a
mother,347840,348734,894,Japan,J14,c,32,4,a
child,349037,349400,363,Japan,J14,m,32,5,a
mother,351720,353128,1408,Japan,J14,f,32,6,a
father,355137,357026,1889,Japan,J14,m,33,1,a
mother,357280,358947,1667,Japan,J14,f,33,2,a
father,359100,359524,424,Japan,J14,m,33,3,a
mother,359647,361563,1916,Japan,J14,f,33,4,a
child,360838,361907,1069,Japan,J14,c,33,5,a
father,361590,362947,1357,Japan,J14,c,33,6,q
child,363147,363520,373,Japan,J14,f,33,7,a
father,363646,364254,608,Japan,J14,c,33,8,q
child,365205,365730,525,Japan,J14,f,33,9,a
father,370790,372700,1910,Japan,J14,c,33,10,a
mother,374221,375379,1158,Japan,J14,c,34,1,i
mother,378642,380895,2253,Japan,J14,c,34,2,a
child,381319,381780,461,Japan,J14,m,34,3,a
mother,382138,382722,584,Japan,J14,NA,34,4,q
mother,387821,396626,8805,Japan,J14,c,35,1,q
child,396710,397026,316,Japan,J14,m,35,2,a
mother,400216,401305,1089,Japan,J14,f,35,3,q
father,401129,403142,2013,Japan,J14,o,36,1,a
father,407831,411979,4148,Japan,J14,o,36,2,a
mother,411573,413911,2338,Japan,J14,c,37,1,a
father,430037,431765,1728,Japan,J14,m,38,1,a
mother,432226,432746,520,Japan,J14,f,38,2,q
father,433368,433793,425,Japan,J14,NA,38,3,a
mother,433904,434863,959,Japan,J14,f,38,4,a
mother,435988,436601,613,Japan,J14,c,38,5,q
child,436637,437243,606,Japan,J14,m,38,6,a
mother,440777,442268,1491,Japan,J14,f,38,7,a
mother,456472,458395,1923,Japan,J14,f,39,1,a
father,458494,458939,445,Japan,J14,m,39,2,a
child,467508,468916,1408,Japan,J14,m,40,1,a
mother,469111,474703,5592,Japan,J14,c,40,2,a
mother,478035,479847,1812,Japan,J14,c,40,3,i
child,481567,482516,949,Japan,J14,m,40,4,q
mother,482601,485695,3094,Japan,J14,c,40,5,q
mother,486417,487286,869,Japan,J14,f,40,6,a
mother,488690,490047,1357,Japan,J14,c,40,7,i
child,491186,492050,864,Japan,J14,m,40,8,a
mother,492000,493711,1711,Japan,J14,c,40,9,a
child,494522,495657,1135,Japan,J14,f,40,10,a
father,495790,497200,1410,Japan,J14,c,40,11,a
mother,496883,498048,1165,Japan,J14,f,40,12,a
child,498337,499463,1126,Japan,J14,m,41,1,a
child,502600,506584,3984,Japan,J14,m,41,2,a
mother,500126,501468,1342,Japan,J14,f,42,1,a
child,508942,510520,1578,Japan,J14,m,43,1,a
father,512614,513203,589,Japan,J14,c,43,2,a
mother,513032,514700,1668,Japan,J14,c,43,3,a
child,517326,519126,1800,Japan,J14,f,44,1,a
mother,520445,525093,4648,Japan,J14,c,44,2,a
child,526882,531526,4644,Japan,J14,f,44,3,a
father,529244,529479,235,Japan,J14,c,44,4,q
father,531041,531638,597,Japan,J14,c,44,5,a
mother,519079,520315,1236,Japan,J14,o,45,1,a
father,541840,543474,1634,Japan,J14,o,46,1,a
father,556374,557221,847,Japan,J14,o,46,2,a
mother,558861,559535,674,Japan,J14,c,47,1,a
mother,561729,562955,1226,Japan,J14,c,47,2,q
mother,564815,565713,898,Japan,J14,c,47,3,a
mother,568928,569819,891,Japan,J14,c,47,4,a
mother,571895,573974,2079,Japan,J14,c,47,5,i
mother,576765,580784,4019,Japan,J14,c,47,6,i
father,586195,589666,3471,Japan,J14,c,48,1,q
child,590111,590758,647,Japan,J14,f,48,2,a
father,591034,591340,306,Japan,J14,c,48,3,q
child,591369,592690,1321,Japan,J14,f,48,4,a
father,592677,594989,2312,Japan,J14,c,48,5,q
child,596684,597158,474,Japan,J14,f,48,6,a
father,597568,597959,391,Japan,J14,c,48,7,a
father,599358,599974,616,Japan,J14,c,48,8,q
child_gesture,4076,5598,1522,Japan,J14,NA,NA,NA,NA
silence,10947,11871,924,Japan,J14,NA,NA,NA,NA
silence,13042,13144,102,Japan,J14,NA,NA,NA,NA
mother_gesture,14521,15737,1216,Japan,J14,NA,NA,NA,NA
silence,18368,18500,132,Japan,J14,NA,NA,NA,NA
silence,20928,21294,366,Japan,J14,NA,NA,NA,NA
silence,22434,23058,624,Japan,J14,NA,NA,NA,NA
silence,23833,23839,6,Japan,J14,NA,NA,NA,NA
silence,28250,28384,134,Japan,J14,NA,NA,NA,NA
silence,29432,29832,400,Japan,J14,NA,NA,NA,NA
silence,31672,32621,949,Japan,J14,NA,NA,NA,NA
silence,34015,35345,1330,Japan,J14,NA,NA,NA,NA
silence,36887,38140,1253,Japan,J14,NA,NA,NA,NA
silence,39552,40343,791,Japan,J14,NA,NA,NA,NA
silence,41148,41305,157,Japan,J14,NA,NA,NA,NA
silence,42833,44868,2035,Japan,J14,NA,NA,NA,NA
silence,45979,46247,268,Japan,J14,NA,NA,NA,NA
father_gesture,47537,49784,2247,Japan,J14,NA,NA,NA,NA
child,56391,57495,1104,Japan,J14,NA,NA,NA,a
silence,57495,58590,1095,Japan,J14,NA,NA,NA,NA
silence,60474,60511,37,Japan,J14,NA,NA,NA,NA
silence,62785,63084,299,Japan,J14,NA,NA,NA,NA
mother_gesture,67500,69272,1772,Japan,J14,NA,NA,NA,NA
silence,69539,70763,1224,Japan,J14,NA,NA,NA,NA
silence,74546,75414,868,Japan,J14,NA,NA,NA,NA
silence,75964,76595,631,Japan,J14,NA,NA,NA,NA
silence,79016,79288,272,Japan,J14,NA,NA,NA,NA
silence,80178,80285,107,Japan,J14,NA,NA,NA,NA
silence,80758,80850,92,Japan,J14,NA,NA,NA,NA
child_gesture,81568,83866,2298,Japan,J14,NA,NA,NA,NA
child_gesture,84595,85807,1212,Japan,J14,NA,NA,NA,NA
silence,84768,84770,2,Japan,J14,NA,NA,NA,NA
silence,89258,89326,68,Japan,J14,NA,NA,NA,NA
silence,89937,90028,91,Japan,J14,NA,NA,NA,NA
silence,90374,90405,31,Japan,J14,NA,NA,NA,NA
silence,91648,92152,504,Japan,J14,NA,NA,NA,NA
silence,94053,94224,171,Japan,J14,NA,NA,NA,NA
silence,95722,95839,117,Japan,J14,NA,NA,NA,NA
silence,97092,97495,403,Japan,J14,NA,NA,NA,NA
child,97495,98526,1031,Japan,J14,NA,NA,NA,a
child_gesture,97505,100158,2653,Japan,J14,NA,NA,NA,NA
silence,98526,99495,969,Japan,J14,NA,NA,NA,NA
silence,99890,101368,1478,Japan,J14,NA,NA,NA,NA
silence,103745,106887,3142,Japan,J14,NA,NA,NA,NA
silence,107489,108547,1058,Japan,J14,NA,NA,NA,NA
silence,109226,111084,1858,Japan,J14,NA,NA,NA,NA
silence,111932,111984,52,Japan,J14,NA,NA,NA,NA
silence,113042,114882,1840,Japan,J14,NA,NA,NA,NA
child_gesture,113507,115817,2310,Japan,J14,NA,NA,NA,NA
silence,116126,116195,69,Japan,J14,NA,NA,NA,NA
silence,122726,127072,4346,Japan,J14,NA,NA,NA,NA
silence,128079,129263,1184,Japan,J14,NA,NA,NA,NA
silence,129908,130122,214,Japan,J14,NA,NA,NA,NA
silence,130704,153379,22675,Japan,J14,NA,NA,NA,NA
father_gesture,152847,154335,1488,Japan,J14,NA,NA,NA,NA
silence,154216,156812,2596,Japan,J14,NA,NA,NA,NA
silence,157620,159778,2158,Japan,J14,NA,NA,NA,NA
silence,160447,160689,242,Japan,J14,NA,NA,NA,NA
silence,161749,161783,34,Japan,J14,NA,NA,NA,NA
silence,162701,162726,25,Japan,J14,NA,NA,NA,NA
silence,164498,185661,21163,Japan,J14,NA,NA,NA,NA
child_gesture,185474,191237,5763,Japan,J14,NA,NA,NA,NA
silence,186590,186811,221,Japan,J14,NA,NA,NA,NA
silence,188490,189595,1105,Japan,J14,NA,NA,NA,NA
silence,192847,193478,631,Japan,J14,NA,NA,NA,NA
silence,199768,200268,500,Japan,J14,NA,NA,NA,NA
silence,200937,204659,3722,Japan,J14,NA,NA,NA,NA
silence,205244,206314,1070,Japan,J14,NA,NA,NA,NA
silence,207716,211638,3922,Japan,J14,NA,NA,NA,NA
silence,213846,214600,754,Japan,J14,NA,NA,NA,NA
silence,215246,216186,940,Japan,J14,NA,NA,NA,NA
silence,217039,217195,156,Japan,J14,NA,NA,NA,NA
silence,217963,218611,648,Japan,J14,NA,NA,NA,NA
silence,220679,220946,267,Japan,J14,NA,NA,NA,NA
silence,222401,225405,3004,Japan,J14,NA,NA,NA,NA
silence,225989,228347,2358,Japan,J14,NA,NA,NA,NA
silence,228821,234636,5815,Japan,J14,NA,NA,NA,NA
silence,235749,241178,5429,Japan,J14,NA,NA,NA,NA
silence,242027,247490,5463,Japan,J14,NA,NA,NA,NA
silence,248459,249414,955,Japan,J14,NA,NA,NA,NA
silence,257487,262432,4945,Japan,J14,NA,NA,NA,NA
child_gesture,262237,265405,3168,Japan,J14,NA,NA,NA,NA
silence,264174,266211,2037,Japan,J14,NA,NA,NA,NA
silence,268593,270818,2225,Japan,J14,NA,NA,NA,NA
silence,273084,273657,573,Japan,J14,NA,NA,NA,NA
silence,274990,276237,1247,Japan,J14,NA,NA,NA,NA
silence,277774,277981,207,Japan,J14,NA,NA,NA,NA
mother,277981,278838,857,Japan,J14,c,NA,NA,a
silence,278838,288408,9570,Japan,J14,NA,NA,NA,NA
silence,289790,290357,567,Japan,J14,NA,NA,NA,NA
mother,290357,291262,905,Japan,J14,f,NA,NA,a
silence,291262,294130,2868,Japan,J14,NA,NA,NA,NA
silence,305742,305958,216,Japan,J14,NA,NA,NA,NA
silence,306504,307030,526,Japan,J14,NA,NA,NA,NA
silence,307342,307553,211,Japan,J14,NA,NA,NA,NA
silence,308157,311225,3068,Japan,J14,NA,NA,NA,NA
silence,312168,313963,1795,Japan,J14,NA,NA,NA,NA
silence,315405,326531,11126,Japan,J14,NA,NA,NA,NA
silence,327571,327902,331,Japan,J14,NA,NA,NA,NA
silence,328269,331750,3481,Japan,J14,NA,NA,NA,NA
silence,334326,335176,850,Japan,J14,NA,NA,NA,NA
silence,338603,340765,2162,Japan,J14,NA,NA,NA,NA
silence,341926,344937,3011,Japan,J14,NA,NA,NA,NA
silence,347294,347770,476,Japan,J14,NA,NA,NA,NA
silence,348734,349037,303,Japan,J14,NA,NA,NA,NA
silence,349400,351720,2320,Japan,J14,NA,NA,NA,NA
silence,353128,355137,2009,Japan,J14,NA,NA,NA,NA
silence,357026,357280,254,Japan,J14,NA,NA,NA,NA
silence,358947,359100,153,Japan,J14,NA,NA,NA,NA
silence,359524,359647,123,Japan,J14,NA,NA,NA,NA
child_gesture,360230,362121,1891,Japan,J14,NA,NA,NA,NA
silence,362947,363147,200,Japan,J14,NA,NA,NA,NA
silence,363520,363646,126,Japan,J14,NA,NA,NA,NA
father_gesture,363621,364409,788,Japan,J14,NA,NA,NA,NA
silence,364254,365205,951,Japan,J14,NA,NA,NA,NA
silence,365730,366960,1230,Japan,J14,NA,NA,NA,NA
mother,366960,367937,977,Japan,J14,c,NA,NA,q
silence,367937,368600,663,Japan,J14,NA,NA,NA,NA
child,368600,370990,2390,Japan,J14,b,NA,NA,a
silence,372700,374221,1521,Japan,J14,NA,NA,NA,NA
silence,375379,378642,3263,Japan,J14,NA,NA,NA,NA
mother_gesture,378588,380870,2282,Japan,J14,NA,NA,NA,NA
silence,380895,381319,424,Japan,J14,NA,NA,NA,NA
silence,381780,382138,358,Japan,J14,NA,NA,NA,NA
silence,382722,387821,5099,Japan,J14,NA,NA,NA,NA
silence,396626,396710,84,Japan,J14,NA,NA,NA,NA
silence,397026,400216,3190,Japan,J14,NA,NA,NA,NA
silence,403142,407831,4689,Japan,J14,NA,NA,NA,NA
silence,413911,430037,16126,Japan,J14,NA,NA,NA,NA
father_gesture,429793,431442,1649,Japan,J14,NA,NA,NA,NA
silence,431765,432226,461,Japan,J14,NA,NA,NA,NA
silence,432746,433368,622,Japan,J14,NA,NA,NA,NA
silence,433793,433904,111,Japan,J14,NA,NA,NA,NA
silence,434863,435988,1125,Japan,J14,NA,NA,NA,NA
silence,436601,436637,36,Japan,J14,NA,NA,NA,NA
silence,437243,440777,3534,Japan,J14,NA,NA,NA,NA
silence,442268,456472,14204,Japan,J14,NA,NA,NA,NA
silence,458395,458494,99,Japan,J14,NA,NA,NA,NA
silence,458939,467508,8569,Japan,J14,NA,NA,NA,NA
child_gesture,461600,462996,1396,Japan,J14,NA,NA,NA,NA
child_gesture,465646,475126,9480,Japan,J14,NA,NA,NA,NA
silence,468916,469111,195,Japan,J14,NA,NA,NA,NA
silence,474703,475142,439,Japan,J14,NA,NA,NA,NA
child,475142,475636,494,Japan,J14,m,NA,NA,a
silence,475636,476479,843,Japan,J14,NA,NA,NA,NA
child_gesture,476201,485643,9442,Japan,J14,NA,NA,NA,NA
child,476479,477168,689,Japan,J14,m,NA,NA,q
silence,477168,478035,867,Japan,J14,NA,NA,NA,NA
silence,479847,481567,1720,Japan,J14,NA,NA,NA,NA
silence,482516,482601,85,Japan,J14,NA,NA,NA,NA
silence,485695,486417,722,Japan,J14,NA,NA,NA,NA
silence,487286,488690,1404,Japan,J14,NA,NA,NA,NA
silence,490047,491186,1139,Japan,J14,NA,NA,NA,NA
silence,493711,494522,811,Japan,J14,NA,NA,NA,NA
silence,495657,495790,133,Japan,J14,NA,NA,NA,NA
silence,498048,498337,289,Japan,J14,NA,NA,NA,NA
father,498900,500056,1156,Japan,J14,m,NA,NA,q
silence,500056,500126,70,Japan,J14,NA,NA,NA,NA
silence,501468,502600,1132,Japan,J14,NA,NA,NA,NA
child_gesture,502595,505238,2643,Japan,J14,NA,NA,NA,NA
silence,506584,508942,2358,Japan,J14,NA,NA,NA,NA
silence,510520,512614,2094,Japan,J14,NA,NA,NA,NA
silence,514700,517326,2626,Japan,J14,NA,NA,NA,NA
child_gesture,517907,520240,2333,Japan,J14,NA,NA,NA,NA
child_gesture,520258,521379,1121,Japan,J14,NA,NA,NA,NA
silence,520315,520445,130,Japan,J14,NA,NA,NA,NA
mother_gesture,523184,524224,1040,Japan,J14,NA,NA,NA,NA
silence,525093,526539,1446,Japan,J14,NA,NA,NA,NA
mother,526539,529963,3424,Japan,J14,c,NA,NA,i
silence,531638,541840,10202,Japan,J14,NA,NA,NA,NA
father_gesture,541605,543296,1691,Japan,J14,NA,NA,NA,NA
silence,543474,556374,12900,Japan,J14,NA,NA,NA,NA
silence,557221,558861,1640,Japan,J14,NA,NA,NA,NA
silence,559535,561729,2194,Japan,J14,NA,NA,NA,NA
mother_gesture,561433,563070,1637,Japan,J14,NA,NA,NA,NA
silence,562955,564815,1860,Japan,J14,NA,NA,NA,NA
silence,565713,568928,3215,Japan,J14,NA,NA,NA,NA
silence,569819,571895,2076,Japan,J14,NA,NA,NA,NA
silence,573974,576765,2791,Japan,J14,NA,NA,NA,NA
silence,580784,586195,5411,Japan,J14,NA,NA,NA,NA
silence,589666,590111,445,Japan,J14,NA,NA,NA,NA
silence,590758,591034,276,Japan,J14,NA,NA,NA,NA
silence,591340,591369,29,Japan,J14,NA,NA,NA,NA
silence,594989,596684,1695,Japan,J14,NA,NA,NA,NA
silence,597158,597568,410,Japan,J14,NA,NA,NA,NA
silence,597959,599358,1399,Japan,J14,NA,NA,NA,NA
father,545,1134,589,Japan,J15,m,1,1,q
mother,940,1822,882,Japan,J15,f,1,2,a
father,2725,3174,449,Japan,J15,m,1,3,q
mother,3274,3537,263,Japan,J15,f,1,4,a
father,4340,5121,781,Japan,J15,m,1,5,a
mother,7045,8205,1160,Japan,J15,f,1,6,a
father,8510,9366,856,Japan,J15,m,1,7,a
mother,10061,10492,431,Japan,J15,f,1,8,a
father,10288,10569,281,Japan,J15,m,1,9,a
mother,12534,14168,1634,Japan,J15,f,1,10,a
father,14697,17229,2532,Japan,J15,m,1,11,a
mother,22555,26234,3679,Japan,J15,o,2,1,q
mother,27440,30697,3257,Japan,J15,f,3,1,a
father,30240,31207,967,Japan,J15,m,3,2,a
mother,32750,35540,2790,Japan,J15,f,4,1,a
father,35846,36345,499,Japan,J15,m,4,2,q
mother,36871,38055,1184,Japan,J15,f,4,3,a
father,38201,38554,353,Japan,J15,m,4,4,a
mother,39266,40697,1431,Japan,J15,f,4,5,a
mother,42261,45349,3088,Japan,J15,o,5,1,q
father,45629,46750,1121,Japan,J15,m,5,2,q
mother,48146,63663,15517,Japan,J15,o,5,3,a
mother,63781,66045,2264,Japan,J15,f,5,4,a
father,65755,66429,674,Japan,J15,m,5,5,a
mother,67082,67615,533,Japan,J15,f,5,6,a
child,42687,43367,680,Japan,J15,b,6,1,a
child,57634,58176,542,Japan,J15,f,7,1,a
child,68693,69701,1008,Japan,J15,NA,8,1,a
mother,70436,72509,2073,Japan,J15,f,9,1,a
father,72450,74059,1609,Japan,J15,m,9,2,q
child,74459,75684,1225,Japan,J15,f,9,3,a
mother,75703,78266,2563,Japan,J15,f,9,4,a
father,75987,77245,1258,Japan,J15,c,9,5,q
father,78105,81645,3540,Japan,J15,m,9,6,q
child,80424,81344,920,Japan,J15,f,9,7,a
mother,80648,81079,431,Japan,J15,f,9,8,a
father,81845,83412,1567,Japan,J15,c,9,9,q
child,83740,84476,736,Japan,J15,f,9,10,a
mother,84755,85597,842,Japan,J15,f,9,11,a
mother,74026,75355,1329,Japan,J15,o,10,1,a
mother,87234,88854,1620,Japan,J15,c,11,1,a
father,89022,89400,378,Japan,J15,m,11,2,q
mother,90161,91445,1284,Japan,J15,NA,11,3,a
father,91538,95555,4017,Japan,J15,c,11,4,a
child,95887,97937,2050,Japan,J15,NA,12,1,q
father,97243,98518,1275,Japan,J15,c,12,2,q
child,99055,101245,2190,Japan,J15,f,12,3,a
father,101330,105161,3831,Japan,J15,c,13,1,a
father,107708,108829,1121,Japan,J15,m,13,2,a
mother,110883,111954,1071,Japan,J15,f,13,3,a
child,111058,111764,706,Japan,J15,b,14,1,a
mother,112008,113592,1584,Japan,J15,c,14,2,a
father,114366,122966,8600,Japan,J15,c,14,3,a
mother,116246,121892,5646,Japan,J15,c,14,4,a
father,128671,130240,1569,Japan,J15,m,14,5,a
mother,131645,132640,995,Japan,J15,c,14,6,a
child,134297,135117,820,Japan,J15,f,14,7,a
mother,135129,136008,879,Japan,J15,c,14,8,a
father,136389,137052,663,Japan,J15,m,14,9,q
mother,137124,137663,539,Japan,J15,f,14,10,a
child,137324,138997,1673,Japan,J15,f,14,11,a
father,139055,139707,652,Japan,J15,NA,14,12,a
mother,139345,142282,2937,Japan,J15,c,14,13,a
father,140961,141424,463,Japan,J15,m,14,14,a
child,142087,142879,792,Japan,J15,b,14,15,a
father,143579,145662,2083,Japan,J15,c,14,16,a
mother,146092,148618,2526,Japan,J15,c,14,17,q
child,148632,149329,697,Japan,J15,b,14,18,a
mother,151840,152406,566,Japan,J15,f,14,19,a
child,143761,144908,1147,Japan,J15,b,15,1,a
child,151423,151828,405,Japan,J15,b,16,1,a
mother,156971,157494,523,Japan,J15,o,17,1,a
father,167634,168718,1084,Japan,J15,b,18,1,a
mother,168275,169108,833,Japan,J15,c,19,1,q
child,171139,172220,1081,Japan,J15,m,19,2,a
child,174661,175782,1121,Japan,J15,NA,19,3,a
mother,176066,176518,452,Japan,J15,c,19,4,a
child,176950,177603,653,Japan,J15,m,19,5,a
mother,177608,178785,1177,Japan,J15,c,19,6,a
child,179776,181478,1702,Japan,J15,m,19,7,q
mother,181629,182677,1048,Japan,J15,c,19,8,i
father,181645,182624,979,Japan,J15,c,19,9,a
child,183399,184682,1283,Japan,J15,m,19,10,a
mother,185624,187705,2081,Japan,J15,c,19,11,a
mother,189966,190844,878,Japan,J15,c,19,12,a
father,191165,194671,3506,Japan,J15,c,19,13,q
mother,191863,199318,7455,Japan,J15,f,20,1,a
father,200934,201466,532,Japan,J15,m,20,2,q
mother,201681,202599,918,Japan,J15,f,20,3,a
father,204416,205749,1333,Japan,J15,m,20,4,a
mother,205987,206440,453,Japan,J15,f,20,5,a
child,206188,209978,3790,Japan,J15,f,22,1,a
mother,208118,209423,1305,Japan,J15,NA,22,2,a
father,210276,210640,364,Japan,J15,c,22,3,q
mother,210608,210882,274,Japan,J15,c,22,4,q
child,210671,211676,1005,Japan,J15,m,22,5,a
mother,212016,214166,2150,Japan,J15,c,22,6,a
father,213266,213750,484,Japan,J15,c,22,7,q
mother,215813,217597,1784,Japan,J15,NA,22,8,a
father,217849,220738,2889,Japan,J15,c,22,9,a
mother,221618,224737,3119,Japan,J15,c,22,10,a
mother,226824,227204,380,Japan,J15,f,22,11,a
mother,229366,230976,1610,Japan,J15,f,22,12,a
father,230935,233133,2198,Japan,J15,m,22,13,a
mother,233179,235545,2366,Japan,J15,f,22,14,a
father,236061,236403,342,Japan,J15,m,22,15,a
mother,236192,236899,707,Japan,J15,NA,22,16,a
father,236992,237513,521,Japan,J15,m,22,17,a
father,237797,238961,1164,Japan,J15,m,22,18,a
mother,238891,240613,1722,Japan,J15,f,22,19,a
mother,244805,245172,367,Japan,J15,m,22,20,a
father,247167,249697,2530,Japan,J15,m,22,21,a
mother,249829,250439,610,Japan,J15,f,22,22,a
father,250451,250967,516,Japan,J15,m,22,23,a
mother,252442,255645,3203,Japan,J15,f,22,24,a
father,257271,257910,639,Japan,J15,m,22,25,a
father,260273,263927,3654,Japan,J15,f,22,26,a
mother,263221,265634,2413,Japan,J15,f,22,27,a
father,265486,266235,749,Japan,J15,m,22,28,a
mother,267213,269092,1879,Japan,J15,f,22,29,a
father,274057,275284,1227,Japan,J15,m,22,30,a
mother,275906,278697,2791,Japan,J15,f,22,31,a
father,278529,279283,754,Japan,J15,m,22,32,a
mother,280746,281479,733,Japan,J15,o,22,33,a
father,227455,227876,421,Japan,J15,c,23,1,a
child,259145,259734,589,Japan,J15,NA,24,1,a
child,262591,264148,1557,Japan,J15,f,24,2,q
child,273024,276655,3631,Japan,J15,b,25,1,a
child,281572,285061,3489,Japan,J15,m,26,1,a
mother,283050,284258,1208,Japan,J15,c,26,2,a
child,286738,289892,3154,Japan,J15,m,26,3,a
mother,286897,287969,1072,Japan,J15,o,26,4,a
child,293587,299266,5679,Japan,J15,m,26,5,a
mother,300393,300902,509,Japan,J15,c,26,6,q
child,301086,301504,418,Japan,J15,m,26,7,a
father,292334,294955,2621,Japan,J15,m,27,1,a
mother,295040,298140,3100,Japan,J15,f,27,2,a
father,298404,298892,488,Japan,J15,m,27,3,a
father,302092,305992,3900,Japan,J15,m,27,4,a
mother,305245,306134,889,Japan,J15,f,27,5,a
mother,308293,309182,889,Japan,J15,o,28,1,a
father,308544,309807,1263,Japan,J15,m,29,1,a
mother,310887,311385,498,Japan,J15,f,29,2,a
father,313875,314434,559,Japan,J15,m,29,3,a
mother,314455,318234,3779,Japan,J15,f,29,4,a
father,318347,318713,366,Japan,J15,m,29,5,a
mother,319150,321618,2468,Japan,J15,f,29,6,a
father,322047,322334,287,Japan,J15,m,29,7,q
mother,322562,322774,212,Japan,J15,f,29,8,a
father,324003,324434,431,Japan,J15,m,29,9,q
mother,324350,326750,2400,Japan,J15,f,29,10,a
father,326803,327932,1129,Japan,J15,m,29,11,q
mother,328440,330040,1600,Japan,J15,NA,29,12,a
child,310612,311271,659,Japan,J15,NA,30,1,a
child,320100,323145,3045,Japan,J15,b,31,1,a
child,329968,330850,882,Japan,J15,f,32,1,a
father,330934,331362,428,Japan,J15,c,32,2,a
father,332940,334193,1253,Japan,J15,c,32,3,q
father,340450,342187,1737,Japan,J15,m,33,1,a
mother,343199,343755,556,Japan,J15,f,33,2,a
father,344371,345140,769,Japan,J15,m,33,3,a
mother,352845,355030,2185,Japan,J15,NA,34,1,a
mother,356387,357355,968,Japan,J15,o,35,1,q
mother,359376,360476,1100,Japan,J15,NA,36,1,a
father,360592,361240,648,Japan,J15,NA,36,2,a
father,365824,366451,627,Japan,J15,m,36,3,a
mother,368192,369270,1078,Japan,J15,f,36,4,a
father,373282,376129,2847,Japan,J15,m,37,1,q
mother,376197,376612,415,Japan,J15,f,37,2,a
child,378729,381266,2537,Japan,J15,m,38,1,a
mother,379861,381392,1531,Japan,J15,c,38,2,q
father,381368,387492,6124,Japan,J15,c,38,3,a
mother,386562,387397,835,Japan,J15,c,38,4,a
mother,387911,389095,1184,Japan,J15,f,38,5,a
father,389087,389417,330,Japan,J15,m,38,6,a
father,389518,390445,927,Japan,J15,c,38,7,q
father,392592,393012,420,Japan,J15,c,38,8,a
father,395440,396824,1384,Japan,J15,c,38,9,a
child,398884,400392,1508,Japan,J15,NA,38,10,a
father,400222,401355,1133,Japan,J15,c,38,11,q
father,402999,404922,1923,Japan,J15,c,38,12,a
mother,401645,402876,1231,Japan,J15,f,39,1,a
child,405771,406486,715,Japan,J15,b,40,1,a
father,406740,408576,1836,Japan,J15,c,40,2,a
mother,407087,407858,771,Japan,J15,c,40,3,a
father,410733,412940,2207,Japan,J15,m,40,4,a
mother,420797,425034,4237,Japan,J15,NA,40,5,a
father,425596,426657,1061,Japan,J15,m,40,6,q
mother,427129,431515,4386,Japan,J15,f,40,7,a
father,429929,430357,428,Japan,J15,m,40,8,a
father,432613,433440,827,Japan,J15,m,40,9,a
father,438627,440081,1454,Japan,J15,b,40,10,a
child,414571,416203,1632,Japan,J15,f,41,1,a
father,416847,417652,805,Japan,J15,c,41,2,a
child,435933,438161,2228,Japan,J15,m,42,1,a
mother,437108,438250,1142,Japan,J15,c,42,2,a
child,440455,441003,548,Japan,J15,m,42,3,NA
father,441425,442031,606,Japan,J15,c,42,4,a
child,442207,442675,468,Japan,J15,NA,42,5,a
mother,442791,443418,627,Japan,J15,c,42,6,a
father,443408,443977,569,Japan,J15,c,42,7,a
mother,448905,449863,958,Japan,J15,o,43,1,q
mother,452474,453374,900,Japan,J15,o,43,2,a
child,450426,451086,660,Japan,J15,f,44,1,a
mother,451563,452253,690,Japan,J15,c,44,2,a
father,453427,455094,1667,Japan,J15,c,44,3,a
father,459703,460200,497,Japan,J15,c,44,4,q
mother,460034,460800,766,Japan,J15,o,45,1,q
mother,460819,461884,1065,Japan,J15,f,45,2,a
father,466642,468459,1817,Japan,J15,m,45,3,a
mother,471166,473487,2321,Japan,J15,o,45,4,a
father,474196,484749,10553,Japan,J15,c,46,1,a
father,486900,488524,1624,Japan,J15,c,46,2,a
father,490702,495734,5032,Japan,J15,c,46,3,a
mother,495540,497640,2100,Japan,J15,NA,47,1,q
father,497861,499842,1981,Japan,J15,b,47,2,a
child,497206,500192,2986,Japan,J15,f,48,1,a
father,501282,503245,1963,Japan,J15,c,48,2,q
child,503850,504358,508,Japan,J15,f,48,3,a
father,504974,505756,782,Japan,J15,c,48,4,a
child,508262,508777,515,Japan,J15,f,48,5,a
father,511276,512143,867,Japan,J15,f,49,1,a
father,515068,515879,811,Japan,J15,m,49,2,a
mother,516698,518456,1758,Japan,J15,f,49,3,q
father,518494,519318,824,Japan,J15,m,49,4,a
mother,519434,519766,332,Japan,J15,f,49,5,q
father,519776,520557,781,Japan,J15,m,49,6,a
mother,520655,521597,942,Japan,J15,NA,49,7,a
father,525061,528165,3104,Japan,J15,m,49,8,a
child,526408,528534,2126,Japan,J15,m,50,1,a
mother,527738,529645,1907,Japan,J15,c,50,2,q
father,530140,536297,6157,Japan,J15,c,50,3,a
child,534608,536992,2384,Japan,J15,NA,50,4,a
father,536934,537375,441,Japan,J15,c,50,5,a
mother,538087,539305,1218,Japan,J15,c,51,1,q
father,539176,543761,4585,Japan,J15,c,51,2,q
child,544202,545216,1014,Japan,J15,f,51,3,a
mother,544508,545351,843,Japan,J15,c,51,4,q
child,546258,548366,2108,Japan,J15,f,51,5,a
father,546999,547481,482,Japan,J15,NA,51,6,a
father,549054,550554,1500,Japan,J15,NA,51,7,a
child,549857,553097,3240,Japan,J15,f,51,8,a
father,551463,553540,2077,Japan,J15,c,51,9,q
mother,553629,554355,726,Japan,J15,f,51,10,a
child,559208,560449,1241,Japan,J15,f,52,1,a
father,560613,563208,2595,Japan,J15,c,52,2,q
mother,563380,563876,496,Japan,J15,f,52,3,a
father,563955,564708,753,Japan,J15,c,52,4,a
child,565049,565634,585,Japan,J15,f,52,5,a
father,565750,566612,862,Japan,J15,c,52,6,a
child,566771,567469,698,Japan,J15,f,52,7,a
father,567640,568782,1142,Japan,J15,c,52,8,a
child,568645,569947,1302,Japan,J15,f,52,9,a
father,569877,570259,382,Japan,J15,c,52,10,a
mother,571345,573050,1705,Japan,J15,f,53,1,q
father,573620,576592,2972,Japan,J15,m,53,2,i
mother,577571,580134,2563,Japan,J15,o,53,3,a
child,584197,584755,558,Japan,J15,NA,54,1,a
father,585903,586266,363,Japan,J15,c,54,2,a
mother,587776,589355,1579,Japan,J15,f,55,1,i
father,591627,593255,1628,Japan,J15,c,56,1,q
mother,594297,595175,878,Japan,J15,c,56,2,a
father,595430,598624,3194,Japan,J15,c,56,3,a
mother,598870,599748,878,Japan,J15,c,57,1,a
silence,1822,2725,903,Japan,J15,NA,NA,NA,NA
father_gesture,2562,3593,1031,Japan,J15,NA,NA,NA,NA
silence,3174,3274,100,Japan,J15,NA,NA,NA,NA
silence,3537,4340,803,Japan,J15,NA,NA,NA,NA
silence,5121,7045,1924,Japan,J15,NA,NA,NA,NA
silence,8205,8510,305,Japan,J15,NA,NA,NA,NA
silence,9366,10061,695,Japan,J15,NA,NA,NA,NA
silence,10569,12534,1965,Japan,J15,NA,NA,NA,NA
silence,14168,14697,529,Japan,J15,NA,NA,NA,NA
silence,17229,22555,5326,Japan,J15,NA,NA,NA,NA
silence,26234,27440,1206,Japan,J15,NA,NA,NA,NA
silence,31207,32750,1543,Japan,J15,NA,NA,NA,NA
silence,35540,35846,306,Japan,J15,NA,NA,NA,NA
silence,36345,36871,526,Japan,J15,NA,NA,NA,NA
silence,38055,38201,146,Japan,J15,NA,NA,NA,NA
silence,38554,39266,712,Japan,J15,NA,NA,NA,NA
silence,40697,42261,1564,Japan,J15,NA,NA,NA,NA
silence,45349,45629,280,Japan,J15,NA,NA,NA,NA
silence,46750,48146,1396,Japan,J15,NA,NA,NA,NA
silence,63663,63781,118,Japan,J15,NA,NA,NA,NA
silence,66429,67082,653,Japan,J15,NA,NA,NA,NA
silence,67615,68693,1078,Japan,J15,NA,NA,NA,NA
silence,69701,70436,735,Japan,J15,NA,NA,NA,NA
mother_gesture,70440,72318,1878,Japan,J15,NA,NA,NA,NA
silence,75684,75703,19,Japan,J15,NA,NA,NA,NA
mother_gesture,75703,78261,2558,Japan,J15,NA,NA,NA,NA
silence,81645,81845,200,Japan,J15,NA,NA,NA,NA
silence,83412,83740,328,Japan,J15,NA,NA,NA,NA
silence,84476,84755,279,Japan,J15,NA,NA,NA,NA
mother_gesture,84634,85527,893,Japan,J15,NA,NA,NA,NA
silence,85597,87234,1637,Japan,J15,NA,NA,NA,NA
silence,88854,89022,168,Japan,J15,NA,NA,NA,NA
silence,89400,90161,761,Japan,J15,NA,NA,NA,NA
silence,91445,91538,93,Japan,J15,NA,NA,NA,NA
silence,95555,95887,332,Japan,J15,NA,NA,NA,NA
silence,98518,99055,537,Japan,J15,NA,NA,NA,NA
child_gesture,98669,100408,1739,Japan,J15,NA,NA,NA,NA
silence,101245,101330,85,Japan,J15,NA,NA,NA,NA
silence,105161,107708,2547,Japan,J15,NA,NA,NA,NA
silence,108829,110883,2054,Japan,J15,NA,NA,NA,NA
silence,111954,112008,54,Japan,J15,NA,NA,NA,NA
silence,113592,114366,774,Japan,J15,NA,NA,NA,NA
silence,122966,128671,5705,Japan,J15,NA,NA,NA,NA
silence,130240,131645,1405,Japan,J15,NA,NA,NA,NA
silence,132640,134297,1657,Japan,J15,NA,NA,NA,NA
child_gesture,133587,135113,1526,Japan,J15,NA,NA,NA,NA
silence,135117,135129,12,Japan,J15,NA,NA,NA,NA
silence,136008,136389,381,Japan,J15,NA,NA,NA,NA
silence,137052,137124,72,Japan,J15,NA,NA,NA,NA
silence,138997,139055,58,Japan,J15,NA,NA,NA,NA
silence,142879,143579,700,Japan,J15,NA,NA,NA,NA
child_gesture,143799,146104,2305,Japan,J15,NA,NA,NA,NA
silence,145662,146092,430,Japan,J15,NA,NA,NA,NA
father,148441,152315,3874,Japan,J15,m,NA,NA,a
silence,152406,156971,4565,Japan,J15,NA,NA,NA,NA
silence,157494,167634,10140,Japan,J15,NA,NA,NA,NA
silence,169108,171139,2031,Japan,J15,NA,NA,NA,NA
silence,172220,174661,2441,Japan,J15,NA,NA,NA,NA
silence,175782,176066,284,Japan,J15,NA,NA,NA,NA
silence,176518,176950,432,Japan,J15,NA,NA,NA,NA
silence,177603,177608,5,Japan,J15,NA,NA,NA,NA
silence,178785,179776,991,Japan,J15,NA,NA,NA,NA
silence,181478,181629,151,Japan,J15,NA,NA,NA,NA
mother_gesture,181582,182765,1183,Japan,J15,NA,NA,NA,NA
silence,182677,183399,722,Japan,J15,NA,NA,NA,NA
silence,184682,185624,942,Japan,J15,NA,NA,NA,NA
silence,187705,189966,2261,Japan,J15,NA,NA,NA,NA
silence,190844,191165,321,Japan,J15,NA,NA,NA,NA
child,194129,196169,2040,Japan,J15,b,NA,NA,a
silence,199318,200934,1616,Japan,J15,NA,NA,NA,NA
silence,201466,201681,215,Japan,J15,NA,NA,NA,NA
silence,202599,204416,1817,Japan,J15,NA,NA,NA,NA
silence,205749,205987,238,Japan,J15,NA,NA,NA,NA
silence,209978,210276,298,Japan,J15,NA,NA,NA,NA
silence,211676,212016,340,Japan,J15,NA,NA,NA,NA
mother_gesture,212024,214094,2070,Japan,J15,NA,NA,NA,NA
silence,214166,215813,1647,Japan,J15,NA,NA,NA,NA
silence,217597,217849,252,Japan,J15,NA,NA,NA,NA
silence,220738,221618,880,Japan,J15,NA,NA,NA,NA
silence,224737,224758,21,Japan,J15,NA,NA,NA,NA
father,224758,226341,1583,Japan,J15,m,NA,NA,q
silence,226341,226824,483,Japan,J15,NA,NA,NA,NA
silence,227204,227455,251,Japan,J15,NA,NA,NA,NA
silence,227876,229366,1490,Japan,J15,NA,NA,NA,NA
silence,233133,233179,46,Japan,J15,NA,NA,NA,NA
silence,235545,236061,516,Japan,J15,NA,NA,NA,NA
silence,236899,236992,93,Japan,J15,NA,NA,NA,NA
silence,237513,237797,284,Japan,J15,NA,NA,NA,NA
silence,240613,240833,220,Japan,J15,NA,NA,NA,NA
father,240833,244878,4045,Japan,J15,m,NA,NA,a
silence,245172,247167,1995,Japan,J15,NA,NA,NA,NA
silence,249697,249829,132,Japan,J15,NA,NA,NA,NA
silence,250439,250451,12,Japan,J15,NA,NA,NA,NA
silence,250967,252442,1475,Japan,J15,NA,NA,NA,NA
silence,255645,257271,1626,Japan,J15,NA,NA,NA,NA
silence,257910,259145,1235,Japan,J15,NA,NA,NA,NA
silence,259734,260273,539,Japan,J15,NA,NA,NA,NA
silence,266235,267213,978,Japan,J15,NA,NA,NA,NA
silence,269092,271708,2616,Japan,J15,NA,NA,NA,NA
mother,271708,273445,1737,Japan,J15,f,NA,NA,a
silence,279283,280746,1463,Japan,J15,NA,NA,NA,NA
silence,281479,281572,93,Japan,J15,NA,NA,NA,NA
silence,285061,286738,1677,Japan,J15,NA,NA,NA,NA
silence,289892,292334,2442,Japan,J15,NA,NA,NA,NA
silence,299266,300393,1127,Japan,J15,NA,NA,NA,NA
silence,300902,301086,184,Japan,J15,NA,NA,NA,NA
silence,301504,302092,588,Japan,J15,NA,NA,NA,NA
silence,306134,308293,2159,Japan,J15,NA,NA,NA,NA
silence,309807,310612,805,Japan,J15,NA,NA,NA,NA
silence,311385,313875,2490,Japan,J15,NA,NA,NA,NA
silence,314434,314455,21,Japan,J15,NA,NA,NA,NA
silence,318234,318347,113,Japan,J15,NA,NA,NA,NA
silence,318713,319150,437,Japan,J15,NA,NA,NA,NA
silence,323145,324003,858,Japan,J15,NA,NA,NA,NA
silence,326750,326803,53,Japan,J15,NA,NA,NA,NA
silence,327932,328440,508,Japan,J15,NA,NA,NA,NA
silence,330850,330934,84,Japan,J15,NA,NA,NA,NA
silence,331362,332940,1578,Japan,J15,NA,NA,NA,NA
silence,334193,340450,6257,Japan,J15,NA,NA,NA,NA
silence,342187,343199,1012,Japan,J15,NA,NA,NA,NA
silence,343755,344371,616,Japan,J15,NA,NA,NA,NA
silence,345140,352845,7705,Japan,J15,NA,NA,NA,NA
silence,355030,356387,1357,Japan,J15,NA,NA,NA,NA
silence,357355,359376,2021,Japan,J15,NA,NA,NA,NA
silence,360476,360592,116,Japan,J15,NA,NA,NA,NA
silence,361240,365824,4584,Japan,J15,NA,NA,NA,NA
silence,366451,368192,1741,Japan,J15,NA,NA,NA,NA
silence,369270,373282,4012,Japan,J15,NA,NA,NA,NA
silence,376129,376197,68,Japan,J15,NA,NA,NA,NA
silence,376612,378729,2117,Japan,J15,NA,NA,NA,NA
father_gesture,381494,383199,1705,Japan,J15,NA,NA,NA,NA
silence,387492,387911,419,Japan,J15,NA,NA,NA,NA
silence,389417,389518,101,Japan,J15,NA,NA,NA,NA
silence,390445,392592,2147,Japan,J15,NA,NA,NA,NA
silence,393012,395440,2428,Japan,J15,NA,NA,NA,NA
silence,396824,398884,2060,Japan,J15,NA,NA,NA,NA
silence,401355,401645,290,Japan,J15,NA,NA,NA,NA
silence,402876,402999,123,Japan,J15,NA,NA,NA,NA
silence,404922,405771,849,Japan,J15,NA,NA,NA,NA
silence,406486,406740,254,Japan,J15,NA,NA,NA,NA
silence,408576,410733,2157,Japan,J15,NA,NA,NA,NA
silence,412940,414571,1631,Japan,J15,NA,NA,NA,NA
silence,416203,416847,644,Japan,J15,NA,NA,NA,NA
silence,417652,420797,3145,Japan,J15,NA,NA,NA,NA
silence,425034,425596,562,Japan,J15,NA,NA,NA,NA
silence,426657,427129,472,Japan,J15,NA,NA,NA,NA
silence,431515,432613,1098,Japan,J15,NA,NA,NA,NA
silence,433440,435933,2493,Japan,J15,NA,NA,NA,NA
silence,438250,438627,377,Japan,J15,NA,NA,NA,NA
silence,440081,440455,374,Japan,J15,NA,NA,NA,NA
silence,441003,441425,422,Japan,J15,NA,NA,NA,NA
silence,442031,442207,176,Japan,J15,NA,NA,NA,NA
silence,442675,442791,116,Japan,J15,NA,NA,NA,NA
silence,443977,448905,4928,Japan,J15,NA,NA,NA,NA
silence,449863,450426,563,Japan,J15,NA,NA,NA,NA
silence,451086,451563,477,Japan,J15,NA,NA,NA,NA
silence,452253,452474,221,Japan,J15,NA,NA,NA,NA
silence,453374,453427,53,Japan,J15,NA,NA,NA,NA
silence,455094,459703,4609,Japan,J15,NA,NA,NA,NA
silence,460800,460819,19,Japan,J15,NA,NA,NA,NA
silence,461884,466642,4758,Japan,J15,NA,NA,NA,NA
silence,468459,471166,2707,Japan,J15,NA,NA,NA,NA
silence,473487,474196,709,Japan,J15,NA,NA,NA,NA
silence,484749,486900,2151,Japan,J15,NA,NA,NA,NA
silence,488524,490702,2178,Japan,J15,NA,NA,NA,NA
mother_gesture,495428,498967,3539,Japan,J15,NA,NA,NA,NA
child_gesture,497087,499380,2293,Japan,J15,NA,NA,NA,NA
silence,500192,501282,1090,Japan,J15,NA,NA,NA,NA
silence,503245,503850,605,Japan,J15,NA,NA,NA,NA
child_gesture,503655,504622,967,Japan,J15,NA,NA,NA,NA
silence,504358,504974,616,Japan,J15,NA,NA,NA,NA
silence,505756,508262,2506,Japan,J15,NA,NA,NA,NA
silence,508777,511276,2499,Japan,J15,NA,NA,NA,NA
silence,512143,515068,2925,Japan,J15,NA,NA,NA,NA
silence,515879,516698,819,Japan,J15,NA,NA,NA,NA
silence,518456,518494,38,Japan,J15,NA,NA,NA,NA
silence,519318,519434,116,Japan,J15,NA,NA,NA,NA
silence,519766,519776,10,Japan,J15,NA,NA,NA,NA
silence,520557,520655,98,Japan,J15,NA,NA,NA,NA
silence,521597,525061,3464,Japan,J15,NA,NA,NA,NA
child_gesture,526044,527703,1659,Japan,J15,NA,NA,NA,NA
silence,529645,530140,495,Japan,J15,NA,NA,NA,NA
father_gesture,530145,532405,2260,Japan,J15,NA,NA,NA,NA
silence,537375,538087,712,Japan,J15,NA,NA,NA,NA
silence,543761,544202,441,Japan,J15,NA,NA,NA,NA
silence,545351,546258,907,Japan,J15,NA,NA,NA,NA
silence,548366,549054,688,Japan,J15,NA,NA,NA,NA
silence,553540,553629,89,Japan,J15,NA,NA,NA,NA
silence,554355,554460,105,Japan,J15,NA,NA,NA,NA
father,554460,556318,1858,Japan,J15,c,NA,NA,NA
father_gesture,554461,557174,2713,Japan,J15,NA,NA,NA,NA
silence,556318,559208,2890,Japan,J15,NA,NA,NA,NA
silence,560449,560613,164,Japan,J15,NA,NA,NA,NA
silence,563208,563380,172,Japan,J15,NA,NA,NA,NA
silence,563876,563955,79,Japan,J15,NA,NA,NA,NA
silence,564708,565049,341,Japan,J15,NA,NA,NA,NA
silence,565634,565750,116,Japan,J15,NA,NA,NA,NA
father_gesture,565634,567000,1366,Japan,J15,NA,NA,NA,NA
silence,566612,566771,159,Japan,J15,NA,NA,NA,NA
silence,567469,567640,171,Japan,J15,NA,NA,NA,NA
silence,570259,571345,1086,Japan,J15,NA,NA,NA,NA
silence,573050,573620,570,Japan,J15,NA,NA,NA,NA
silence,576592,577571,979,Japan,J15,NA,NA,NA,NA
silence,580134,584197,4063,Japan,J15,NA,NA,NA,NA
silence,584755,585903,1148,Japan,J15,NA,NA,NA,NA
silence,586266,587776,1510,Japan,J15,NA,NA,NA,NA
mother_gesture,587597,589361,1764,Japan,J15,NA,NA,NA,NA
silence,589355,591627,2272,Japan,J15,NA,NA,NA,NA
silence,593255,594297,1042,Japan,J15,NA,NA,NA,NA
silence,595175,595430,255,Japan,J15,NA,NA,NA,NA
mother_gesture,598555,599755,1200,Japan,J15,NA,NA,NA,NA
silence,598624,598870,246,Japan,J15,NA,NA,NA,NA
father,222,2958,2736,Japan,J16,m,1,1,a
mother,3221,3598,377,Japan,J16,f,1,2,a
father,3708,4722,1014,Japan,J16,c,2,1,q
child,7377,7748,371,Japan,J16,f,2,2,q
mother,8856,10149,1293,Japan,J16,c,2,3,a
mother,12167,12978,811,Japan,J16,b,3,1,a
child,13169,14165,996,Japan,J16,f,4,1,a
father,13539,15198,1659,Japan,J16,m,5,1,i
mother,23098,25448,2350,Japan,J16,f,5,2,q
father,25528,26563,1035,Japan,J16,m,5,3,a
father,30966,31704,738,Japan,J16,m,5,4,a
father,33551,34825,1274,Japan,J16,c,6,1,q
father,40485,43596,3111,Japan,J16,c,6,2,a
mother,41814,42793,979,Japan,J16,c,6,3,a
father,48124,49504,1380,Japan,J16,c,6,4,a
father,51292,52175,883,Japan,J16,m,7,1,a
mother,52216,53170,954,Japan,J16,f,7,2,a
child,52895,53844,949,Japan,J16,f,8,1,a
father,55204,55863,659,Japan,J16,o,9,1,a
father,56866,57601,735,Japan,J16,c,10,1,a
child,62191,62857,666,Japan,J16,f,10,2,a
father,63292,63994,702,Japan,J16,c,10,3,a
mother,64062,68902,4840,Japan,J16,c,10,4,a
child,66990,68850,1860,Japan,J16,m,10,5,a
mother,69845,70386,541,Japan,J16,NA,10,6,a
father,70734,71303,569,Japan,J16,c,10,7,q
mother,71386,71714,328,Japan,J16,c,10,8,a
father,73908,79791,5883,Japan,J16,c,10,9,a
father,60905,61583,678,Japan,J16,b,11,1,a
mother,92990,98172,5182,Japan,J16,f,12,1,a
father,95977,100878,4901,Japan,J16,m,12,2,a
child,104051,107448,3397,Japan,J16,m,13,1,a
mother,105969,106617,648,Japan,J16,c,13,2,a
mother,110443,110685,242,Japan,J16,o,14,1,a
father,113181,113496,315,Japan,J16,m,14,2,q
mother,113979,114778,799,Japan,J16,f,14,3,a
father,115541,115811,270,Japan,J16,m,14,4,q
mother,116417,117928,1511,Japan,J16,f,14,5,a
mother,119850,121402,1552,Japan,J16,f,14,6,a
father,121639,122093,454,Japan,J16,m,14,7,a
mother,125907,130943,5036,Japan,J16,f,14,8,a
mother,134592,135962,1370,Japan,J16,f,14,9,a
father,137380,139609,2229,Japan,J16,m,15,1,q
mother,141103,142005,902,Japan,J16,f,15,2,a
father,142635,143491,856,Japan,J16,m,15,3,q
father,145368,146450,1082,Japan,J16,m,16,1,q
mother,147258,149289,2031,Japan,J16,m,16,2,a
father,150104,150411,307,Japan,J16,m,16,3,a
mother,151567,156241,4674,Japan,J16,f,16,4,a
father,152373,152774,401,Japan,J16,m,16,5,a
father,154195,154694,499,Japan,J16,m,16,6,a
father,155349,155641,292,Japan,J16,m,16,7,a
father,156288,157362,1074,Japan,J16,m,16,8,a
mother,157272,158868,1596,Japan,J16,f,16,9,a
father,160302,162795,2493,Japan,J16,m,16,10,a
mother,162994,163931,937,Japan,J16,f,16,11,a
father,167988,169447,1459,Japan,J16,m,17,1,a
mother,169536,170242,706,Japan,J16,f,17,2,q
father,170380,172469,2089,Japan,J16,m,17,3,a
mother,172271,173799,1528,Japan,J16,f,17,4,q
father,173944,174994,1050,Japan,J16,m,17,5,a
father,176408,178773,2365,Japan,J16,m,17,6,q
mother,178912,181495,2583,Japan,J16,f,17,7,a
father,182143,182940,797,Japan,J16,o,17,8,a
father,184728,189889,5161,Japan,J16,m,18,1,a
father,193027,200590,7563,Japan,J16,m,18,2,q
mother,196469,196891,422,Japan,J16,f,18,3,a
mother,201335,202402,1067,Japan,J16,f,18,4,a
father,202137,203082,945,Japan,J16,m,18,5,a
mother,203132,205288,2156,Japan,J16,f,18,6,q
father,205502,205883,381,Japan,J16,m,18,7,a
mother,205907,206326,419,Japan,J16,f,18,8,a
father,206358,207380,1022,Japan,J16,m,18,9,a
mother,207421,207794,373,Japan,J16,f,18,10,a
father,207911,209297,1386,Japan,J16,m,18,11,a
mother,209707,210139,432,Japan,J16,f,18,12,a
father,210198,213192,2994,Japan,J16,m,18,13,a
mother,211058,211317,259,Japan,J16,f,18,14,a
mother,213173,213977,804,Japan,J16,f,18,15,a
father,214911,218496,3585,Japan,J16,m,18,16,a
mother,218953,220158,1205,Japan,J16,f,18,17,q
father,221651,225491,3840,Japan,J16,m,18,18,a
mother,225701,226068,367,Japan,J16,f,18,19,a
father,233883,237192,3309,Japan,J16,m,19,1,a
mother,237355,238269,914,Japan,J16,f,19,2,a
father,239453,241253,1800,Japan,J16,m,19,3,a
mother,241402,241799,397,Japan,J16,f,19,4,a
father,242231,243975,1744,Japan,J16,m,19,5,a
mother,244009,244593,584,Japan,J16,f,19,6,q
father,244975,245941,966,Japan,J16,m,19,7,a
father,246754,250344,3590,Japan,J16,c,20,1,a
mother,250386,251702,1316,Japan,J16,f,20,2,a
father,251901,252386,485,Japan,J16,m,20,3,a
child,249794,250517,723,Japan,J16,f,21,1,a
father,252861,253255,394,Japan,J16,c,21,2,q
child,257387,257749,362,Japan,J16,f,21,3,q
father,258988,259566,578,Japan,J16,c,21,4,q
child,259984,260366,382,Japan,J16,f,21,5,a
father,260397,261900,1503,Japan,J16,c,21,6,a
father,264292,264762,470,Japan,J16,c,21,7,a
mother,264459,266380,1921,Japan,J16,f,21,8,a
father,266381,266953,572,Japan,J16,m,21,9,a
mother,267778,268205,427,Japan,J16,f,21,10,a
father,267902,271850,3948,Japan,J16,c,21,11,i
mother,272175,273252,1077,Japan,J16,c,21,12,a
father,273613,276827,3214,Japan,J16,c,21,13,a
child,277227,278428,1201,Japan,J16,b,22,1,a
father,278093,278963,870,Japan,J16,c,22,2,a
child,280512,280808,296,Japan,J16,b,23,1,q
father,281159,285314,4155,Japan,J16,c,23,2,q
mother,288153,289643,1490,Japan,J16,f,24,1,a
father,289797,290093,296,Japan,J16,m,24,2,q
mother,290191,292330,2139,Japan,J16,f,24,3,a
mother,293634,295044,1410,Japan,J16,f,24,4,a
father,295660,297392,1732,Japan,J16,m,24,5,q
mother,297607,300578,2971,Japan,J16,f,24,6,a
father,300886,302902,2016,Japan,J16,m,24,7,q
mother,304258,306789,2531,Japan,J16,f,24,8,a
father,305943,306945,1002,Japan,J16,m,24,9,q
mother,306912,307304,392,Japan,J16,f,24,10,a
mother,309858,311448,1590,Japan,J16,f,24,11,a
father,313554,315799,2245,Japan,J16,m,24,12,a
mother,316299,317146,847,Japan,J16,f,24,13,a
mother,321885,327397,5512,Japan,J16,f,24,14,a
father,327490,327869,379,Japan,J16,m,24,15,a
child,309060,310289,1229,Japan,J16,f,25,1,a
father,311087,311821,734,Japan,J16,c,25,2,a
mother,319778,320696,918,Japan,J16,c,25,3,q
father,329201,331103,1902,Japan,J16,o,26,1,a
mother,334979,335696,717,Japan,J16,f,27,1,a
father,336354,336742,388,Japan,J16,m,27,2,a
mother,337768,339585,1817,Japan,J16,f,27,3,a
father,340077,340378,301,Japan,J16,m,27,4,q
father,342928,343496,568,Japan,J16,m,27,5,a
mother,348490,351433,2943,Japan,J16,f,27,6,a
father,353087,354087,1000,Japan,J16,m,27,7,a
father,354680,360587,5907,Japan,J16,m,27,8,a
mother,363510,364850,1340,Japan,J16,f,27,9,a
father,364892,365157,265,Japan,J16,m,27,10,a
mother,365386,373629,8243,Japan,J16,f,27,11,q
father,372428,376696,4268,Japan,J16,m,27,12,a
mother,391062,391275,213,Japan,J16,c,28,1,a
mother,399396,404206,4810,Japan,J16,c,28,2,q
father,394593,395012,419,Japan,J16,o,29,1,a
mother,407144,408061,917,Japan,J16,c,30,1,a
father,409087,410218,1131,Japan,J16,m,30,2,a
mother,413582,415188,1606,Japan,J16,f,31,1,a
father,417185,418562,1377,Japan,J16,m,31,2,q
mother,418505,419809,1304,Japan,J16,f,31,3,a
father,420735,421577,842,Japan,J16,m,31,4,q
mother,421268,423376,2108,Japan,J16,f,31,5,a
father,422438,423572,1134,Japan,J16,m,31,6,a
mother,424366,427345,2979,Japan,J16,f,31,7,a
father,427381,427857,476,Japan,J16,m,31,8,a
mother,427876,428269,393,Japan,J16,f,31,9,a
father,428546,431386,2840,Japan,J16,NA,31,10,a
mother,430464,431488,1024,Japan,J16,f,31,11,a
father,434317,436582,2265,Japan,J16,o,32,1,a
father,437191,440654,3463,Japan,J16,m,33,1,a
mother,440670,441087,417,Japan,J16,f,33,2,a
father,451171,451482,311,Japan,J16,c,34,1,a
child,453499,455000,1501,Japan,J16,f,34,2,a
father,460691,461111,420,Japan,J16,c,34,3,a
father,464763,474335,9572,Japan,J16,m,35,1,a
mother,474167,475327,1160,Japan,J16,f,35,2,a
father,478744,482495,3751,Japan,J16,m,36,1,a
mother,482680,483309,629,Japan,J16,f,36,2,a
father,483515,483794,279,Japan,J16,m,36,3,q
mother,484023,485109,1086,Japan,J16,f,36,4,q
father,484948,485577,629,Japan,J16,m,36,5,a
mother,485598,485959,361,Japan,J16,f,36,6,a
father,486057,486728,671,Japan,J16,m,36,7,q
mother,487366,489185,1819,Japan,J16,f,36,8,a
father,489221,491455,2234,Japan,J16,m,36,9,q
mother,494364,494725,361,Japan,J16,f,36,10,q
father,494804,496340,1536,Japan,J16,m,36,11,q
mother,498350,499634,1284,Japan,J16,f,36,12,i
father,500585,502295,1710,Japan,J16,m,36,13,a
mother,502634,502964,330,Japan,J16,f,36,14,q
father,504258,505593,1335,Japan,J16,m,36,15,a
mother,506000,507201,1201,Japan,J16,f,36,16,a
father,507593,508593,1000,Japan,J16,m,36,17,a
father,510484,512479,1995,Japan,J16,c,37,1,a
child,514090,514597,507,Japan,J16,f,37,2,a
father,514871,515180,309,Japan,J16,c,37,3,a
mother,515165,515610,445,Japan,J16,c,37,4,a
mother,517345,518325,980,Japan,J16,f,38,1,q
father,518362,518662,300,Japan,J16,m,38,2,q
mother,518647,519739,1092,Japan,J16,f,38,3,q
father,520341,520732,391,Japan,J16,m,38,4,q
mother,520840,521196,356,Japan,J16,f,38,5,q
father,521242,524294,3052,Japan,J16,m,38,6,a
mother,524580,525405,825,Japan,J16,f,38,7,a
father,525572,525854,282,Japan,J16,m,38,8,q
mother,525936,528860,2924,Japan,J16,f,38,9,q
father,529505,545333,15828,Japan,J16,m,38,10,a
mother,537917,538332,415,Japan,J16,f,38,11,a
mother,543385,544853,1468,Japan,J16,f,38,12,a
mother,547897,548472,575,Japan,J16,c,39,1,a
father,551676,552276,600,Japan,J16,c,39,2,i
mother,552964,553799,835,Japan,J16,c,39,3,q
child,556046,556654,608,Japan,J16,m,39,4,a
mother,556862,557350,488,Japan,J16,c,39,5,q
child,557397,557696,299,Japan,J16,m,39,6,a
mother,557557,557794,237,Japan,J16,c,39,7,q
father,558392,559876,1484,Japan,J16,m,40,1,a
child,558840,559572,732,Japan,J16,o,41,1,a
child,567598,569179,1581,Japan,J16,o,42,1,a
mother,569232,576294,7062,Japan,J16,c,42,2,a
father,576417,576747,330,Japan,J16,m,42,3,a
child,585740,586501,761,Japan,J16,m,42,4,a
mother,586805,590063,3258,Japan,J16,c,42,5,a
father,578763,579886,1123,Japan,J16,o,43,1,a
child,593278,593587,309,Japan,J16,b,44,1,q
father,595590,596706,1116,Japan,J16,o,45,1,a
silence,2958,3221,263,Japan,J16,NA,NA,NA,NA
silence,3598,3708,110,Japan,J16,NA,NA,NA,NA
silence,4722,7377,2655,Japan,J16,NA,NA,NA,NA
child_gesture,7197,10314,3117,Japan,J16,NA,NA,NA,NA
silence,7748,8381,633,Japan,J16,NA,NA,NA,NA
father,8381,9188,807,Japan,J16,c,NA,NA,a
silence,10149,12167,2018,Japan,J16,NA,NA,NA,NA
silence,12978,13169,191,Japan,J16,NA,NA,NA,NA
father_gesture,13363,14915,1552,Japan,J16,NA,NA,NA,NA
silence,15198,23098,7900,Japan,J16,NA,NA,NA,NA
silence,25448,25528,80,Japan,J16,NA,NA,NA,NA
silence,26563,30966,4403,Japan,J16,NA,NA,NA,NA
silence,31704,33551,1847,Japan,J16,NA,NA,NA,NA
silence,34825,40485,5660,Japan,J16,NA,NA,NA,NA
silence,43596,48124,4528,Japan,J16,NA,NA,NA,NA
silence,49504,51292,1788,Japan,J16,NA,NA,NA,NA
silence,52175,52216,41,Japan,J16,NA,NA,NA,NA
silence,53844,55204,1360,Japan,J16,NA,NA,NA,NA
silence,55863,56866,1003,Japan,J16,NA,NA,NA,NA
mother,57393,60046,2653,Japan,J16,c,NA,NA,a
father,59673,60596,923,Japan,J16,c,NA,NA,a
silence,60596,60905,309,Japan,J16,NA,NA,NA,NA
silence,61583,62191,608,Japan,J16,NA,NA,NA,NA
silence,62857,63292,435,Japan,J16,NA,NA,NA,NA
silence,63994,64062,68,Japan,J16,NA,NA,NA,NA
silence,68902,69845,943,Japan,J16,NA,NA,NA,NA
silence,70386,70734,348,Japan,J16,NA,NA,NA,NA
silence,71303,71386,83,Japan,J16,NA,NA,NA,NA
silence,71714,73908,2194,Japan,J16,NA,NA,NA,NA
silence,79791,80506,715,Japan,J16,NA,NA,NA,NA
father,80506,81386,880,Japan,J16,c,NA,NA,a
silence,81386,92990,11604,Japan,J16,NA,NA,NA,NA
mother_gesture,92696,95367,2671,Japan,J16,NA,NA,NA,NA
silence,100878,104051,3173,Japan,J16,NA,NA,NA,NA
child_gesture,101959,107897,5938,Japan,J16,NA,NA,NA,NA
silence,107448,110443,2995,Japan,J16,NA,NA,NA,NA
silence,110685,113181,2496,Japan,J16,NA,NA,NA,NA
silence,113496,113979,483,Japan,J16,NA,NA,NA,NA
silence,114778,115541,763,Japan,J16,NA,NA,NA,NA
silence,115811,116417,606,Japan,J16,NA,NA,NA,NA
silence,117928,117939,11,Japan,J16,NA,NA,NA,NA
father,117939,119292,1353,Japan,J16,m,NA,NA,q
silence,119292,119850,558,Japan,J16,NA,NA,NA,NA
mother_gesture,119861,121407,1546,Japan,J16,NA,NA,NA,NA
silence,121402,121639,237,Japan,J16,NA,NA,NA,NA
silence,122093,125907,3814,Japan,J16,NA,NA,NA,NA
silence,130943,134592,3649,Japan,J16,NA,NA,NA,NA
silence,135962,137380,1418,Japan,J16,NA,NA,NA,NA
silence,139609,141103,1494,Japan,J16,NA,NA,NA,NA
mother_gesture,140701,143821,3120,Japan,J16,NA,NA,NA,NA
silence,142005,142635,630,Japan,J16,NA,NA,NA,NA
silence,143491,145368,1877,Japan,J16,NA,NA,NA,NA
silence,146450,147258,808,Japan,J16,NA,NA,NA,NA
silence,149289,150104,815,Japan,J16,NA,NA,NA,NA
silence,150411,151567,1156,Japan,J16,NA,NA,NA,NA
silence,156241,156288,47,Japan,J16,NA,NA,NA,NA
silence,158868,160302,1434,Japan,J16,NA,NA,NA,NA
silence,162795,162994,199,Japan,J16,NA,NA,NA,NA
silence,163931,167988,4057,Japan,J16,NA,NA,NA,NA
silence,169447,169536,89,Japan,J16,NA,NA,NA,NA
silence,170242,170380,138,Japan,J16,NA,NA,NA,NA
silence,173799,173944,145,Japan,J16,NA,NA,NA,NA
silence,174994,176408,1414,Japan,J16,NA,NA,NA,NA
silence,178773,178912,139,Japan,J16,NA,NA,NA,NA
silence,181495,182143,648,Japan,J16,NA,NA,NA,NA
silence,182940,184728,1788,Japan,J16,NA,NA,NA,NA
silence,189889,193027,3138,Japan,J16,NA,NA,NA,NA
silence,200590,201335,745,Japan,J16,NA,NA,NA,NA
silence,203082,203132,50,Japan,J16,NA,NA,NA,NA
silence,205288,205502,214,Japan,J16,NA,NA,NA,NA
silence,205883,205907,24,Japan,J16,NA,NA,NA,NA
silence,206326,206358,32,Japan,J16,NA,NA,NA,NA
silence,207380,207421,41,Japan,J16,NA,NA,NA,NA
silence,207794,207911,117,Japan,J16,NA,NA,NA,NA
silence,209297,209707,410,Japan,J16,NA,NA,NA,NA
silence,210139,210198,59,Japan,J16,NA,NA,NA,NA
silence,213977,214911,934,Japan,J16,NA,NA,NA,NA
silence,218496,218953,457,Japan,J16,NA,NA,NA,NA
silence,220158,221651,1493,Japan,J16,NA,NA,NA,NA
silence,225491,225701,210,Japan,J16,NA,NA,NA,NA
silence,226068,233883,7815,Japan,J16,NA,NA,NA,NA
silence,237192,237355,163,Japan,J16,NA,NA,NA,NA
silence,238269,239453,1184,Japan,J16,NA,NA,NA,NA
silence,241253,241402,149,Japan,J16,NA,NA,NA,NA
silence,241799,242231,432,Japan,J16,NA,NA,NA,NA
silence,243975,244009,34,Japan,J16,NA,NA,NA,NA
silence,244593,244975,382,Japan,J16,NA,NA,NA,NA
silence,245941,246754,813,Japan,J16,NA,NA,NA,NA
child_gesture,248653,254307,5654,Japan,J16,NA,NA,NA,NA
mother_gesture,249948,251789,1841,Japan,J16,NA,NA,NA,NA
silence,251702,251901,199,Japan,J16,NA,NA,NA,NA
silence,252386,252861,475,Japan,J16,NA,NA,NA,NA
silence,253255,257387,4132,Japan,J16,NA,NA,NA,NA
silence,257749,258988,1239,Japan,J16,NA,NA,NA,NA
silence,259566,259984,418,Japan,J16,NA,NA,NA,NA
silence,260366,260397,31,Japan,J16,NA,NA,NA,NA
silence,261900,264292,2392,Japan,J16,NA,NA,NA,NA
mother_gesture,264098,265582,1484,Japan,J16,NA,NA,NA,NA
silence,266380,266381,1,Japan,J16,NA,NA,NA,NA
silence,266953,267778,825,Japan,J16,NA,NA,NA,NA
silence,271850,272175,325,Japan,J16,NA,NA,NA,NA
silence,273252,273613,361,Japan,J16,NA,NA,NA,NA
silence,276827,277227,400,Japan,J16,NA,NA,NA,NA
silence,278963,280512,1549,Japan,J16,NA,NA,NA,NA
silence,280808,281159,351,Japan,J16,NA,NA,NA,NA
silence,285314,288153,2839,Japan,J16,NA,NA,NA,NA
mother_gesture,287850,288841,991,Japan,J16,NA,NA,NA,NA
silence,289643,289797,154,Japan,J16,NA,NA,NA,NA
mother_gesture,289799,290990,1191,Japan,J16,NA,NA,NA,NA
silence,290093,290191,98,Japan,J16,NA,NA,NA,NA
father,291434,292500,1066,Japan,J16,m,NA,NA,a
silence,292500,293634,1134,Japan,J16,NA,NA,NA,NA
silence,295044,295660,616,Japan,J16,NA,NA,NA,NA
silence,297392,297607,215,Japan,J16,NA,NA,NA,NA
silence,300578,300886,308,Japan,J16,NA,NA,NA,NA
silence,302902,304258,1356,Japan,J16,NA,NA,NA,NA
silence,307304,309060,1756,Japan,J16,NA,NA,NA,NA
silence,311821,313554,1733,Japan,J16,NA,NA,NA,NA
silence,315799,316299,500,Japan,J16,NA,NA,NA,NA
silence,317146,319778,2632,Japan,J16,NA,NA,NA,NA
silence,320696,321885,1189,Japan,J16,NA,NA,NA,NA
silence,327397,327490,93,Japan,J16,NA,NA,NA,NA
silence,327869,329201,1332,Japan,J16,NA,NA,NA,NA
silence,331103,334979,3876,Japan,J16,NA,NA,NA,NA
silence,335696,336354,658,Japan,J16,NA,NA,NA,NA
silence,336742,337768,1026,Japan,J16,NA,NA,NA,NA
silence,339585,340077,492,Japan,J16,NA,NA,NA,NA
mother,340144,342152,2008,Japan,J16,f,NA,NA,a
silence,342152,342928,776,Japan,J16,NA,NA,NA,NA
silence,343496,348490,4994,Japan,J16,NA,NA,NA,NA
silence,351433,353087,1654,Japan,J16,NA,NA,NA,NA
silence,354087,354680,593,Japan,J16,NA,NA,NA,NA
silence,360587,363510,2923,Japan,J16,NA,NA,NA,NA
silence,364850,364892,42,Japan,J16,NA,NA,NA,NA
silence,365157,365386,229,Japan,J16,NA,NA,NA,NA
silence,376696,391062,14366,Japan,J16,NA,NA,NA,NA
silence,391275,394593,3318,Japan,J16,NA,NA,NA,NA
silence,395012,399396,4384,Japan,J16,NA,NA,NA,NA
silence,404206,407144,2938,Japan,J16,NA,NA,NA,NA
silence,408061,409087,1026,Japan,J16,NA,NA,NA,NA
silence,410218,413582,3364,Japan,J16,NA,NA,NA,NA
silence,415188,417185,1997,Japan,J16,NA,NA,NA,NA
mother_gesture,418305,420078,1773,Japan,J16,NA,NA,NA,NA
silence,419809,420735,926,Japan,J16,NA,NA,NA,NA
mother_gesture,421768,423289,1521,Japan,J16,NA,NA,NA,NA
silence,423572,424366,794,Japan,J16,NA,NA,NA,NA
silence,427345,427381,36,Japan,J16,NA,NA,NA,NA
silence,427857,427876,19,Japan,J16,NA,NA,NA,NA
silence,428269,428546,277,Japan,J16,NA,NA,NA,NA
silence,431488,434317,2829,Japan,J16,NA,NA,NA,NA
silence,436582,437191,609,Japan,J16,NA,NA,NA,NA
silence,440654,440670,16,Japan,J16,NA,NA,NA,NA
silence,441087,451171,10084,Japan,J16,NA,NA,NA,NA
silence,451482,453499,2017,Japan,J16,NA,NA,NA,NA
father,454651,456701,2050,Japan,J16,c,NA,NA,a
silence,456701,460691,3990,Japan,J16,NA,NA,NA,NA
silence,461111,464763,3652,Japan,J16,NA,NA,NA,NA
silence,475327,478744,3417,Japan,J16,NA,NA,NA,NA
father_gesture,478758,480737,1979,Japan,J16,NA,NA,NA,NA
silence,482495,482680,185,Japan,J16,NA,NA,NA,NA
mother_gesture,482680,483304,624,Japan,J16,NA,NA,NA,NA
silence,483309,483515,206,Japan,J16,NA,NA,NA,NA
silence,483794,484023,229,Japan,J16,NA,NA,NA,NA
mother_gesture,484020,485897,1877,Japan,J16,NA,NA,NA,NA
silence,485577,485598,21,Japan,J16,NA,NA,NA,NA
silence,485959,486057,98,Japan,J16,NA,NA,NA,NA
silence,486728,487366,638,Japan,J16,NA,NA,NA,NA
silence,489185,489221,36,Japan,J16,NA,NA,NA,NA
silence,491455,494364,2909,Japan,J16,NA,NA,NA,NA
silence,494725,494804,79,Japan,J16,NA,NA,NA,NA
silence,496340,498350,2010,Japan,J16,NA,NA,NA,NA
mother_gesture,498356,499489,1133,Japan,J16,NA,NA,NA,NA
silence,499634,500585,951,Japan,J16,NA,NA,NA,NA
silence,502295,502634,339,Japan,J16,NA,NA,NA,NA
silence,502964,504258,1294,Japan,J16,NA,NA,NA,NA
silence,505593,506000,407,Japan,J16,NA,NA,NA,NA
silence,507201,507593,392,Japan,J16,NA,NA,NA,NA
silence,508593,510484,1891,Japan,J16,NA,NA,NA,NA
silence,512479,514090,1611,Japan,J16,NA,NA,NA,NA
silence,514597,514871,274,Japan,J16,NA,NA,NA,NA
silence,515610,517345,1735,Japan,J16,NA,NA,NA,NA
mother_gesture,517340,518335,995,Japan,J16,NA,NA,NA,NA
silence,518325,518362,37,Japan,J16,NA,NA,NA,NA
mother_gesture,518649,520098,1449,Japan,J16,NA,NA,NA,NA
silence,519739,520341,602,Japan,J16,NA,NA,NA,NA
silence,520732,520840,108,Japan,J16,NA,NA,NA,NA
mother_gesture,520783,522804,2021,Japan,J16,NA,NA,NA,NA
silence,521196,521242,46,Japan,J16,NA,NA,NA,NA
silence,524294,524580,286,Japan,J16,NA,NA,NA,NA
silence,525405,525572,167,Japan,J16,NA,NA,NA,NA
silence,525854,525936,82,Japan,J16,NA,NA,NA,NA
silence,528860,529505,645,Japan,J16,NA,NA,NA,NA
father_gesture,540323,542295,1972,Japan,J16,NA,NA,NA,NA
silence,545333,547897,2564,Japan,J16,NA,NA,NA,NA
silence,548472,551676,3204,Japan,J16,NA,NA,NA,NA
silence,552276,552964,688,Japan,J16,NA,NA,NA,NA
silence,553799,556046,2247,Japan,J16,NA,NA,NA,NA
silence,556654,556862,208,Japan,J16,NA,NA,NA,NA
silence,557350,557397,47,Japan,J16,NA,NA,NA,NA
silence,557794,558392,598,Japan,J16,NA,NA,NA,NA
silence,559876,567598,7722,Japan,J16,NA,NA,NA,NA
silence,569179,569232,53,Japan,J16,NA,NA,NA,NA
silence,576294,576417,123,Japan,J16,NA,NA,NA,NA
silence,576747,578763,2016,Japan,J16,NA,NA,NA,NA
silence,579886,585740,5854,Japan,J16,NA,NA,NA,NA
silence,586501,586805,304,Japan,J16,NA,NA,NA,NA
silence,590063,590397,334,Japan,J16,NA,NA,NA,NA
father,590397,593333,2936,Japan,J16,m,NA,NA,a
silence,593587,595590,2003,Japan,J16,NA,NA,NA,NA
silence,596706,597068,362,Japan,J16,NA,NA,NA,NA
mother,1755,2500,745,Japan,J17,c,1,1,a
mother,4507,5155,648,Japan,J17,c,1,2,a
child,8118,8829,711,Japan,J17,m,1,3,a
mother,9003,12031,3028,Japan,J17,c,1,4,a
child,14991,15776,785,Japan,J17,m,1,5,a
mother,15769,16257,488,Japan,J17,c,1,6,a
father,16472,17035,563,Japan,J17,c,1,7,a
child,37770,39123,1353,Japan,J17,b,2,1,q
father,39438,42176,2738,Japan,J17,c,2,2,a
mother,40134,42652,2518,Japan,J17,c,2,3,a
child,44691,45404,713,Japan,J17,o,2,4,a
father,45472,47169,1697,Japan,J17,c,2,5,a
mother,45914,46521,607,Japan,J17,c,2,6,a
father,48810,51269,2459,Japan,J17,m,2,7,a
father,53431,54286,855,Japan,J17,m,2,8,a
mother,54769,56872,2103,Japan,J17,f,2,9,a
mother,64245,66101,1856,Japan,J17,f,2,10,q
father,67362,68479,1117,Japan,J17,m,2,11,a
father,74748,75760,1012,Japan,J17,m,2,12,a
mother,76134,77100,966,Japan,J17,f,2,13,q
father,78555,80657,2102,Japan,J17,m,2,14,a
mother,80500,81066,566,Japan,J17,f,2,15,a
father,81812,83208,1396,Japan,J17,m,2,16,a
mother,83493,84196,703,Japan,J17,f,2,17,a
mother,86603,87378,775,Japan,J17,f,2,18,q
father,87749,89391,1642,Japan,J17,m,2,19,a
mother,59265,60493,1228,Japan,J17,c,3,1,a
child,88948,89760,812,Japan,J17,m,4,1,a
child,96221,97130,909,Japan,J17,m,4,2,a
mother,97224,99707,2483,Japan,J17,c,4,3,q
child,100806,102406,1600,Japan,J17,m,4,4,a
mother,102665,106859,4194,Japan,J17,c,4,5,a
child,103272,103912,640,Japan,J17,m,4,6,a
child,107206,108391,1185,Japan,J17,m,4,7,a
mother,108449,109265,816,Japan,J17,c,4,8,a
child,109309,110129,820,Japan,J17,m,4,9,a
mother,110486,111521,1035,Japan,J17,c,4,10,a
father,110567,111089,522,Japan,J17,c,4,11,a
child,112007,112735,728,Japan,J17,m,4,12,a
child,113743,114773,1030,Japan,J17,f,4,13,a
father,114890,115601,711,Japan,J17,c,4,14,a
mother,115872,117769,1897,Japan,J17,f,4,15,q
father,123314,123810,496,Japan,J17,c,4,16,a
child,125037,126300,1263,Japan,J17,f,4,17,a
mother,126528,127279,751,Japan,J17,c,4,18,q
child,127184,127787,603,Japan,J17,f,4,19,a
mother,128438,129413,975,Japan,J17,c,4,20,a
child,139596,140484,888,Japan,J17,m,4,21,a
mother,140617,141622,1005,Japan,J17,c,4,22,a
mother,153079,155030,1951,Japan,J17,c,4,23,a
father,153128,156805,3677,Japan,J17,m,4,24,a
mother,165465,168656,3191,Japan,J17,c,5,1,q
father,169776,170601,825,Japan,J17,c,5,2,q
father,171265,172480,1215,Japan,J17,m,5,3,a
father,173990,174567,577,Japan,J17,m,5,4,a
mother,174610,174934,324,Japan,J17,f,5,5,q
mother,177438,177990,552,Japan,J17,f,5,6,q
father,178031,179817,1786,Japan,J17,m,5,7,a
child,180360,181144,784,Japan,J17,f,6,1,a
father,181962,183996,2034,Japan,J17,c,6,2,i
child,184588,185447,859,Japan,J17,b,7,1,a
father,185580,186205,625,Japan,J17,c,7,2,a
mother,185734,186561,827,Japan,J17,c,7,3,a
child,189221,190074,853,Japan,J17,b,7,4,a
mother,190217,194921,4704,Japan,J17,c,7,5,i
father,200010,201027,1017,Japan,J17,b,8,1,a
father,206169,206403,234,Japan,J17,c,9,1,a
mother,207590,208107,517,Japan,J17,f,9,2,a
father,208790,209452,662,Japan,J17,c,9,3,a
mother,209541,210659,1118,Japan,J17,c,9,4,a
child,209794,210934,1140,Japan,J17,m,9,5,a
mother,210810,212886,2076,Japan,J17,c,9,6,a
mother,217755,219721,1966,Japan,J17,b,9,7,a
mother,224472,225044,572,Japan,J17,o,9,8,a
mother,230756,231350,594,Japan,J17,o,9,9,a
mother,214796,215693,897,Japan,J17,b,10,1,a
mother,234628,236088,1460,Japan,J17,c,11,1,a
child,237354,238091,737,Japan,J17,m,12,1,a
mother,238755,241831,3076,Japan,J17,c,12,2,i
mother,244486,245970,1484,Japan,J17,c,12,3,a
father,249452,250424,972,Japan,J17,m,13,1,a
mother,250393,251190,797,Japan,J17,f,13,2,a
father,251403,252459,1056,Japan,J17,m,13,3,a
mother,254517,255101,584,Japan,J17,c,13,4,q
mother,262762,263419,657,Japan,J17,c,13,5,q
child,299029,300581,1552,Japan,J17,m,14,1,a
mother,300045,301852,1807,Japan,J17,c,14,2,a
mother,304390,305548,1158,Japan,J17,c,14,3,q
mother,309962,312941,2979,Japan,J17,c,14,4,q
child,312794,314105,1311,Japan,J17,m,14,5,a
mother,315617,316230,613,Japan,J17,c,14,6,a
child,316757,318228,1471,Japan,J17,m,14,7,a
mother,318500,319121,621,Japan,J17,c,14,8,q
child,319386,320125,739,Japan,J17,m,14,9,a
mother,320928,321727,799,Japan,J17,f,14,10,a
child,324960,326037,1077,Japan,J17,b,14,11,a
mother,326265,326950,685,Japan,J17,c,14,12,q
father,326534,327700,1166,Japan,J17,c,14,13,a
child,328316,329088,772,Japan,J17,b,14,14,a
mother,328941,331293,2352,Japan,J17,c,14,15,a
father,332772,334854,2082,Japan,J17,c,14,16,a
father,338539,341362,2823,Japan,J17,c,14,17,a
mother,339035,339683,648,Japan,J17,c,14,18,a
father,342328,344532,2204,Japan,J17,c,14,19,a
child,346860,347652,792,Japan,J17,b,14,20,a
mother,348376,349141,765,Japan,J17,c,14,21,q
child,349000,349716,716,Japan,J17,m,14,22,a
mother,350328,351603,1275,Japan,J17,c,14,23,q
child,352309,352840,531,Japan,J17,b,14,24,a
mother,352863,353573,710,Japan,J17,c,14,25,q
mother,356727,357134,407,Japan,J17,c,14,26,q
child,358125,358746,621,Japan,J17,m,14,27,a
father,359187,360087,900,Japan,J17,c,14,28,a
father,361990,363615,1625,Japan,J17,m,14,29,q
mother,364141,364864,723,Japan,J17,c,14,30,q
father,365003,365462,459,Japan,J17,c,14,31,a
father,372003,373590,1587,Japan,J17,c,15,1,i
mother,374245,375824,1579,Japan,J17,c,15,2,i
mother,398948,399626,678,Japan,J17,c,16,1,i
mother,404190,404569,379,Japan,J17,c,16,2,q
child,404698,405220,522,Japan,J17,m,16,3,a
mother,405528,408314,2786,Japan,J17,c,16,4,a
mother,412493,412788,295,Japan,J17,c,16,5,a
child,412971,413698,727,Japan,J17,m,18,1,a
mother,418762,421286,2524,Japan,J17,c,18,2,q
child,420875,421985,1110,Japan,J17,m,18,3,a
mother,422017,423776,1759,Japan,J17,c,18,4,a
mother,426534,426801,267,Japan,J17,c,18,5,a
child,433883,434296,413,Japan,J17,m,18,6,a
mother,434376,434778,402,Japan,J17,c,18,7,a
mother,416038,417934,1896,Japan,J17,c,19,1,i
child,451816,452447,631,Japan,J17,m,19,2,a
mother,453059,454300,1241,Japan,J17,c,19,3,a
mother,457610,457907,297,Japan,J17,c,19,4,a
child,459103,459868,765,Japan,J17,m,19,5,a
mother,564907,566114,1207,Japan,J17,c,20,1,i
mother,570038,571072,1034,Japan,J17,c,20,2,a
child,572493,573125,632,Japan,J17,m,20,3,a
mother,573328,573679,351,Japan,J17,c,20,4,a
child,574401,574978,577,Japan,J17,m,20,5,a
mother,575148,575730,582,Japan,J17,c,20,6,a
child,578564,579602,1038,Japan,J17,m,20,7,a
mother,579852,580141,289,Japan,J17,c,20,8,a
father,580383,581155,772,Japan,J17,c,20,9,a
child,582162,583134,972,Japan,J17,f,20,10,a
child,585825,586592,767,Japan,J17,m,20,11,a
mother,586672,587559,887,Japan,J17,c,20,12,a
child,588625,590654,2029,Japan,J17,m,20,13,a
mother,591231,593197,1966,Japan,J17,c,20,14,q
child,593985,595502,1517,Japan,J17,m,20,15,a
mother,595521,598321,2800,Japan,J17,c,20,16,q
child,598331,599625,1294,Japan,J17,m,20,17,a
mother,599128,600245,1117,Japan,J17,c,20,18,i
mother,273969,275085,1116,Japan,J17,f,21,1,q
father,277424,278463,1039,Japan,J17,c,21,2,a
mother,572355,573190,835,Japan,J17,c,21,3,i
child,471412,472000,588,Japan,J17,m,22,1,a
child,473147,473603,456,Japan,J17,m,22,2,a
mother,473769,474386,617,Japan,J17,NA,22,3,q
child,474434,475032,598,Japan,J17,m,22,4,a
mother,475176,478562,3386,Japan,J17,c,22,5,a
mother,498955,499914,959,Japan,J17,c,22,6,a
child,516073,516920,847,Japan,J17,m,22,7,a
mother,517500,518295,795,Japan,J17,c,22,8,a
mother,521178,524671,3493,Japan,J17,c,22,9,a
mother,528376,528869,493,Japan,J17,c,22,10,i
mother,533944,535900,1956,Japan,J17,c,22,11,i
child,547390,548030,640,Japan,J17,m,22,12,a
mother,547921,548304,383,Japan,J17,c,22,13,a
silence,2500,4507,2007,Japan,J17,NA,NA,NA,NA
silence,5155,8118,2963,Japan,J17,NA,NA,NA,NA
silence,8829,9003,174,Japan,J17,NA,NA,NA,NA
silence,12031,14991,2960,Japan,J17,NA,NA,NA,NA
silence,16257,16472,215,Japan,J17,NA,NA,NA,NA
silence,17035,37770,20735,Japan,J17,NA,NA,NA,NA
silence,39123,39438,315,Japan,J17,NA,NA,NA,NA
silence,42652,44691,2039,Japan,J17,NA,NA,NA,NA
silence,45404,45472,68,Japan,J17,NA,NA,NA,NA
silence,47169,48810,1641,Japan,J17,NA,NA,NA,NA
silence,51269,53431,2162,Japan,J17,NA,NA,NA,NA
silence,54286,54769,483,Japan,J17,NA,NA,NA,NA
silence,56872,59265,2393,Japan,J17,NA,NA,NA,NA
silence,60493,64245,3752,Japan,J17,NA,NA,NA,NA
silence,66101,67362,1261,Japan,J17,NA,NA,NA,NA
silence,68479,74748,6269,Japan,J17,NA,NA,NA,NA
silence,75760,76134,374,Japan,J17,NA,NA,NA,NA
silence,77100,78555,1455,Japan,J17,NA,NA,NA,NA
silence,81066,81812,746,Japan,J17,NA,NA,NA,NA
silence,83208,83493,285,Japan,J17,NA,NA,NA,NA
silence,84196,86603,2407,Japan,J17,NA,NA,NA,NA
silence,87378,87749,371,Japan,J17,NA,NA,NA,NA
silence,89760,90107,347,Japan,J17,NA,NA,NA,NA
mother,90107,93701,3594,Japan,J17,c,NA,NA,a
silence,93701,96221,2520,Japan,J17,NA,NA,NA,NA
silence,97130,97224,94,Japan,J17,NA,NA,NA,NA
silence,99707,99852,145,Japan,J17,NA,NA,NA,NA
father,99852,101087,1235,Japan,J17,c,NA,NA,a
child_gesture,101103,104503,3400,Japan,J17,NA,NA,NA,NA
silence,102406,102665,259,Japan,J17,NA,NA,NA,NA
silence,106859,107206,347,Japan,J17,NA,NA,NA,NA
silence,108391,108449,58,Japan,J17,NA,NA,NA,NA
silence,109265,109309,44,Japan,J17,NA,NA,NA,NA
silence,110129,110486,357,Japan,J17,NA,NA,NA,NA
silence,111521,112007,486,Japan,J17,NA,NA,NA,NA
mother,112110,114107,1997,Japan,J17,c,NA,NA,a
silence,114773,114890,117,Japan,J17,NA,NA,NA,NA
silence,115601,115872,271,Japan,J17,NA,NA,NA,NA
silence,117769,119010,1241,Japan,J17,NA,NA,NA,NA
father,119010,120645,1635,Japan,J17,m,NA,NA,a
silence,120645,120730,85,Japan,J17,NA,NA,NA,NA
mother,120730,121298,568,Japan,J17,f,NA,NA,a
silence,121298,123314,2016,Japan,J17,NA,NA,NA,NA
silence,123810,125037,1227,Japan,J17,NA,NA,NA,NA
silence,126300,126528,228,Japan,J17,NA,NA,NA,NA
father,127093,127465,372,Japan,J17,c,NA,NA,a
silence,127787,128438,651,Japan,J17,NA,NA,NA,NA
silence,129413,139596,10183,Japan,J17,NA,NA,NA,NA
silence,140484,140617,133,Japan,J17,NA,NA,NA,NA
silence,141622,143369,1747,Japan,J17,NA,NA,NA,NA
father,143369,146065,2696,Japan,J17,c,NA,NA,a
silence,146065,153079,7014,Japan,J17,NA,NA,NA,NA
silence,156805,165465,8660,Japan,J17,NA,NA,NA,NA
silence,168656,169776,1120,Japan,J17,NA,NA,NA,NA
silence,170601,170624,23,Japan,J17,NA,NA,NA,NA
mother,170624,170976,352,Japan,J17,c,NA,NA,a
silence,170976,171265,289,Japan,J17,NA,NA,NA,NA
silence,172480,173341,861,Japan,J17,NA,NA,NA,NA
mother,173341,173796,455,Japan,J17,f,NA,NA,q
silence,173796,173990,194,Japan,J17,NA,NA,NA,NA
silence,174567,174610,43,Japan,J17,NA,NA,NA,NA
silence,174934,177438,2504,Japan,J17,NA,NA,NA,NA
silence,177990,178031,41,Japan,J17,NA,NA,NA,NA
silence,179817,180360,543,Japan,J17,NA,NA,NA,NA
child_gesture,180270,181558,1288,Japan,J17,NA,NA,NA,NA
silence,181144,181326,182,Japan,J17,NA,NA,NA,NA
mother,181326,181917,591,Japan,J17,c,NA,NA,q
silence,181917,181962,45,Japan,J17,NA,NA,NA,NA
silence,183996,184588,592,Japan,J17,NA,NA,NA,NA
child_gesture,184565,193471,8906,Japan,J17,NA,NA,NA,NA
silence,185447,185580,133,Japan,J17,NA,NA,NA,NA
silence,186561,189221,2660,Japan,J17,NA,NA,NA,NA
silence,190074,190217,143,Japan,J17,NA,NA,NA,NA
mother_gesture,190221,192394,2173,Japan,J17,NA,NA,NA,NA
silence,194921,200010,5089,Japan,J17,NA,NA,NA,NA
silence,201027,206169,5142,Japan,J17,NA,NA,NA,NA
silence,206403,207590,1187,Japan,J17,NA,NA,NA,NA
silence,208107,208790,683,Japan,J17,NA,NA,NA,NA
silence,209452,209541,89,Japan,J17,NA,NA,NA,NA
silence,212886,214796,1910,Japan,J17,NA,NA,NA,NA
silence,215693,217755,2062,Japan,J17,NA,NA,NA,NA
silence,219721,224472,4751,Japan,J17,NA,NA,NA,NA
silence,225044,230756,5712,Japan,J17,NA,NA,NA,NA
silence,231350,234628,3278,Japan,J17,NA,NA,NA,NA
silence,236088,237354,1266,Japan,J17,NA,NA,NA,NA
silence,238091,238755,664,Japan,J17,NA,NA,NA,NA
child_gesture,240036,241114,1078,Japan,J17,NA,NA,NA,NA
mother_gesture,241136,242147,1011,Japan,J17,NA,NA,NA,NA
silence,241831,244486,2655,Japan,J17,NA,NA,NA,NA
mother_gesture,244482,245733,1251,Japan,J17,NA,NA,NA,NA
silence,245970,249452,3482,Japan,J17,NA,NA,NA,NA
silence,251190,251403,213,Japan,J17,NA,NA,NA,NA
silence,252459,254517,2058,Japan,J17,NA,NA,NA,NA
silence,255101,259314,4213,Japan,J17,NA,NA,NA,NA
father,259314,260934,1620,Japan,J17,c,NA,NA,a
silence,260934,262762,1828,Japan,J17,NA,NA,NA,NA
silence,263419,273969,10550,Japan,J17,NA,NA,NA,NA
silence,275085,277424,2339,Japan,J17,NA,NA,NA,NA
silence,278463,299029,20566,Japan,J17,NA,NA,NA,NA
child_gesture,298821,300829,2008,Japan,J17,NA,NA,NA,NA
child_gesture,301491,302333,842,Japan,J17,NA,NA,NA,NA
child,301610,302162,552,Japan,J17,m,NA,NA,a
silence,302162,302169,7,Japan,J17,NA,NA,NA,NA
mother,302169,302528,359,Japan,J17,c,NA,NA,a
silence,302528,303994,1466,Japan,J17,NA,NA,NA,NA
child_gesture,303871,304991,1120,Japan,J17,NA,NA,NA,NA
child,303994,304809,815,Japan,J17,m,NA,NA,a
silence,305548,309962,4414,Japan,J17,NA,NA,NA,NA
child_gesture,312518,316601,4083,Japan,J17,NA,NA,NA,NA
mother,313514,314668,1154,Japan,J17,c,NA,NA,a
silence,314668,315000,332,Japan,J17,NA,NA,NA,NA
child,315000,315610,610,Japan,J17,m,NA,NA,a
silence,315610,315617,7,Japan,J17,NA,NA,NA,NA
silence,316230,316757,527,Japan,J17,NA,NA,NA,NA
child_gesture,317066,319871,2805,Japan,J17,NA,NA,NA,NA
silence,318228,318500,272,Japan,J17,NA,NA,NA,NA
silence,319121,319386,265,Japan,J17,NA,NA,NA,NA
silence,320125,320928,803,Japan,J17,NA,NA,NA,NA
silence,321727,322983,1256,Japan,J17,NA,NA,NA,NA
father,322983,325149,2166,Japan,J17,c,NA,NA,q
child_gesture,324525,329944,5419,Japan,J17,NA,NA,NA,NA
silence,326037,326265,228,Japan,J17,NA,NA,NA,NA
silence,327700,328316,616,Japan,J17,NA,NA,NA,NA
silence,331293,332772,1479,Japan,J17,NA,NA,NA,NA
silence,334854,338539,3685,Japan,J17,NA,NA,NA,NA
silence,341362,342328,966,Japan,J17,NA,NA,NA,NA
child_gesture,343338,351367,8029,Japan,J17,NA,NA,NA,NA
silence,344532,346860,2328,Japan,J17,NA,NA,NA,NA
silence,347652,348376,724,Japan,J17,NA,NA,NA,NA
silence,349716,350328,612,Japan,J17,NA,NA,NA,NA
silence,351603,352309,706,Japan,J17,NA,NA,NA,NA
silence,352840,352863,23,Japan,J17,NA,NA,NA,NA
silence,353573,354555,982,Japan,J17,NA,NA,NA,NA
father,354555,355065,510,Japan,J17,c,NA,NA,a
child_gesture,354951,358957,4006,Japan,J17,NA,NA,NA,NA
silence,355065,356727,1662,Japan,J17,NA,NA,NA,NA
silence,357134,358125,991,Japan,J17,NA,NA,NA,NA
silence,358746,359141,395,Japan,J17,NA,NA,NA,NA
mother,359141,361521,2380,Japan,J17,c,NA,NA,a
silence,361521,361990,469,Japan,J17,NA,NA,NA,NA
silence,363615,364141,526,Japan,J17,NA,NA,NA,NA
silence,364864,365003,139,Japan,J17,NA,NA,NA,NA
silence,365462,372003,6541,Japan,J17,NA,NA,NA,NA
silence,373590,374245,655,Japan,J17,NA,NA,NA,NA
silence,375824,398948,23124,Japan,J17,NA,NA,NA,NA
silence,399626,404190,4564,Japan,J17,NA,NA,NA,NA
silence,404569,404698,129,Japan,J17,NA,NA,NA,NA
silence,405220,405528,308,Japan,J17,NA,NA,NA,NA
silence,408314,412493,4179,Japan,J17,NA,NA,NA,NA
silence,412788,412971,183,Japan,J17,NA,NA,NA,NA
child_gesture,412818,415000,2182,Japan,J17,NA,NA,NA,NA
mother,413617,414996,1379,Japan,J17,c,NA,NA,a
silence,414996,416038,1042,Japan,J17,NA,NA,NA,NA
silence,417934,418762,828,Japan,J17,NA,NA,NA,NA
silence,421985,422017,32,Japan,J17,NA,NA,NA,NA
silence,423776,426534,2758,Japan,J17,NA,NA,NA,NA
silence,426801,433883,7082,Japan,J17,NA,NA,NA,NA
silence,434296,434376,80,Japan,J17,NA,NA,NA,NA
silence,434778,451816,17038,Japan,J17,NA,NA,NA,NA
silence,452447,453059,612,Japan,J17,NA,NA,NA,NA
silence,454300,457610,3310,Japan,J17,NA,NA,NA,NA
silence,457907,459103,1196,Japan,J17,NA,NA,NA,NA
silence,459868,459898,30,Japan,J17,NA,NA,NA,NA
mother,459898,460660,762,Japan,J17,c,NA,NA,a
silence,460660,471412,10752,Japan,J17,NA,NA,NA,NA
mother,471610,472704,1094,Japan,J17,c,NA,NA,q
silence,472704,473147,443,Japan,J17,NA,NA,NA,NA
silence,473603,473769,166,Japan,J17,NA,NA,NA,NA
silence,474386,474434,48,Japan,J17,NA,NA,NA,NA
silence,475032,475176,144,Japan,J17,NA,NA,NA,NA
mother_gesture,476933,478524,1591,Japan,J17,NA,NA,NA,NA
silence,478562,498955,20393,Japan,J17,NA,NA,NA,NA
silence,499914,516073,16159,Japan,J17,NA,NA,NA,NA
silence,516920,517500,580,Japan,J17,NA,NA,NA,NA
silence,518295,521178,2883,Japan,J17,NA,NA,NA,NA
silence,524671,528376,3705,Japan,J17,NA,NA,NA,NA
silence,528869,533944,5075,Japan,J17,NA,NA,NA,NA
mother_gesture,533814,535284,1470,Japan,J17,NA,NA,NA,NA
silence,535900,547390,11490,Japan,J17,NA,NA,NA,NA
silence,548304,562397,14093,Japan,J17,NA,NA,NA,NA
mother,562397,562790,393,Japan,J17,c,NA,NA,a
silence,562790,564338,1548,Japan,J17,NA,NA,NA,NA
child,564338,564890,552,Japan,J17,m,NA,NA,a
silence,564890,564907,17,Japan,J17,NA,NA,NA,NA
silence,566114,569316,3202,Japan,J17,NA,NA,NA,NA
child,569316,570009,693,Japan,J17,m,NA,NA,a
silence,570009,570038,29,Japan,J17,NA,NA,NA,NA
silence,571072,572355,1283,Japan,J17,NA,NA,NA,NA
silence,573190,573328,138,Japan,J17,NA,NA,NA,NA
silence,573679,574401,722,Japan,J17,NA,NA,NA,NA
silence,574978,575148,170,Japan,J17,NA,NA,NA,NA
silence,575730,578564,2834,Japan,J17,NA,NA,NA,NA
silence,579602,579852,250,Japan,J17,NA,NA,NA,NA
silence,580141,580383,242,Japan,J17,NA,NA,NA,NA
silence,581155,582162,1007,Japan,J17,NA,NA,NA,NA
silence,583134,585825,2691,Japan,J17,NA,NA,NA,NA
silence,586592,586672,80,Japan,J17,NA,NA,NA,NA
silence,587559,588625,1066,Japan,J17,NA,NA,NA,NA
child_gesture,589561,591552,1991,Japan,J17,NA,NA,NA,NA
silence,590654,591231,577,Japan,J17,NA,NA,NA,NA
child_gesture,592888,596126,3238,Japan,J17,NA,NA,NA,NA
silence,593197,593985,788,Japan,J17,NA,NA,NA,NA
silence,595502,595521,19,Japan,J17,NA,NA,NA,NA
silence,598321,598331,10,Japan,J17,NA,NA,NA,NA
mother,1105,3086,1981,Japan,J18,b,1,1,a
father,3509,4182,673,Japan,J18,m,1,2,a
father,5718,8170,2452,Japan,J18,c,2,1,i
mother,9284,10301,1017,Japan,J18,f,3,1,a
child,9561,11048,1487,Japan,J18,f,3,2,a
father,10392,11101,709,Japan,J18,c,3,3,q
mother,11134,13444,2310,Japan,J18,f,3,4,q
father,13495,13947,452,Japan,J18,m,3,5,a
child,14048,16509,2461,Japan,J18,f,3,6,a
mother,14451,15360,909,Japan,J18,f,3,7,a
father,16593,16949,356,Japan,J18,c,3,8,q
mother,17373,18548,1175,Japan,J18,m,3,9,q
father,20495,23127,2632,Japan,J18,c,3,10,q
mother,20620,22056,1436,Japan,J18,c,3,11,a
child,23373,23737,364,Japan,J18,m,3,12,a
father,24292,26335,2043,Japan,J18,b,3,13,a
mother,27230,28529,1299,Japan,J18,f,3,14,q
child,28661,29805,1144,Japan,J18,b,3,15,a
mother,35074,36433,1359,Japan,J18,c,3,16,a
child,38367,40139,1772,Japan,J18,b,3,17,a
mother,39626,40970,1344,Japan,J18,c,3,18,a
child,41684,42126,442,Japan,J18,m,4,1,q
mother,42878,43741,863,Japan,J18,c,4,2,a
child,45444,46061,617,Japan,J18,m,4,3,q
mother,46034,48055,2021,Japan,J18,c,4,4,a
child,48736,49527,791,Japan,J18,m,4,5,q
mother,49468,50170,702,Japan,J18,c,4,6,q
child,50217,51535,1318,Japan,J18,m,5,1,i
mother,52571,53315,744,Japan,J18,c,5,2,q
child,53145,53574,429,Japan,J18,m,5,3,a
mother,58251,59025,774,Japan,J18,c,5,4,a
child,59304,59953,649,Japan,J18,m,5,5,a
mother,62204,63265,1061,Japan,J18,c,5,6,a
child,84457,86237,1780,Japan,J18,b,6,1,q
mother,86152,86672,520,Japan,J18,c,6,2,q
father,86237,86687,450,Japan,J18,c,6,3,q
child,86847,87600,753,Japan,J18,b,6,4,a
mother,87970,88665,695,Japan,J18,c,6,5,q
father,87973,88466,493,Japan,J18,c,6,6,q
child,88704,89055,351,Japan,J18,b,6,7,a
mother,89132,90106,974,Japan,J18,c,6,8,q
child,90459,90797,338,Japan,J18,c,6,9,a
father,91009,92010,1001,Japan,J18,c,6,10,a
mother,92519,92832,313,Japan,J18,f,6,11,q
father,92869,95863,2994,Japan,J18,b,6,12,a
mother,94446,95532,1086,Japan,J18,c,6,13,q
mother,98299,102973,4674,Japan,J18,c,6,14,q
mother,107595,108622,1027,Japan,J18,b,7,1,a
child,108457,109553,1096,Japan,J18,m,8,1,q
mother,110609,111299,690,Japan,J18,c,8,2,a
child,112272,113750,1478,Japan,J18,m,8,3,q
mother,114164,115986,1822,Japan,J18,c,8,4,a
father,115465,116034,569,Japan,J18,c,8,5,a
child,116717,118152,1435,Japan,J18,b,8,6,a
mother,118403,118838,435,Japan,J18,c,8,7,a
child,123262,124533,1271,Japan,J18,m,8,8,q
mother,124679,126154,1475,Japan,J18,c,8,9,a
child,130308,134769,4461,Japan,J18,m,8,10,q
mother,135090,135501,411,Japan,J18,c,8,11,a
child,139178,144511,5333,Japan,J18,b,8,12,i
father,143918,146378,2460,Japan,J18,c,8,13,a
child,151792,155437,3645,Japan,J18,f,8,14,a
father,139550,140214,664,Japan,J18,m,9,1,a
mother,140280,141869,1589,Japan,J18,f,9,2,a
mother,151881,153728,1847,Japan,J18,f,9,3,q
father,153992,154458,466,Japan,J18,m,9,4,q
mother,154642,155875,1233,Japan,J18,f,9,5,NA
father,155888,156381,493,Japan,J18,m,9,6,a
mother,157234,158548,1314,Japan,J18,f,9,7,a
father,160036,161083,1047,Japan,J18,m,9,8,a
mother,161348,161704,356,Japan,J18,f,9,9,a
mother,169600,170671,1071,Japan,J18,c,10,1,q
mother,173428,174527,1099,Japan,J18,c,10,2,q
child,176750,178191,1441,Japan,J18,m,10,3,a
mother,178225,179519,1294,Japan,J18,c,10,4,a
father,179551,180102,551,Japan,J18,c,10,5,a
child,212022,216250,4228,Japan,J18,f,11,1,q
father,216369,216807,438,Japan,J18,c,11,2,q
child,216857,217853,996,Japan,J18,f,11,3,q
mother,217869,218443,574,Japan,J18,c,11,4,q
father,218495,219084,589,Japan,J18,c,11,5,a
child,219530,221028,1498,Japan,J18,b,11,6,a
mother,221170,221832,662,Japan,J18,c,11,7,q
child,222043,222359,316,Japan,J18,c,11,8,a
child,224652,227966,3314,Japan,J18,b,11,9,a
mother,225794,226127,333,Japan,J18,c,11,10,a
mother,228128,229924,1796,Japan,J18,c,11,11,a
father,233483,234058,575,Japan,J18,c,11,12,a
mother,234317,235110,793,Japan,J18,c,11,13,a
mother,237280,238645,1365,Japan,J18,c,11,14,a
mother,242272,243125,853,Japan,J18,c,11,15,a
father,243550,245099,1549,Japan,J18,m,12,1,q
mother,245536,245875,339,Japan,J18,f,12,2,a
mother,250464,253256,2792,Japan,J18,f,12,3,q
father,253670,254515,845,Japan,J18,m,12,4,q
mother,255168,259115,3947,Japan,J18,f,12,5,a
father,259538,260070,532,Japan,J18,m,12,6,q
mother,261734,263691,1957,Japan,J18,f,12,7,a
father,263765,264499,734,Japan,J18,m,12,8,a
mother,267998,270286,2288,Japan,J18,f,12,9,q
father,270366,272556,2190,Japan,J18,m,12,10,a
child,271680,272951,1271,Japan,J18,m,12,11,a
mother,272902,273720,818,Japan,J18,c,12,12,q
child,273848,275756,1908,Japan,J18,m,12,13,a
mother,275151,276366,1215,Japan,J18,c,12,14,a
father,277090,277881,791,Japan,J18,c,13,1,q
child,278659,280120,1461,Japan,J18,f,13,2,a
mother,280139,280918,779,Japan,J18,c,13,3,q
child,281685,282801,1116,Japan,J18,m,13,4,a
child,288834,289548,714,Japan,J18,f,14,1,a
father,289556,290181,625,Japan,J18,c,14,2,a
mother,290593,292820,2227,Japan,J18,c,14,3,a
father,292771,293220,449,Japan,J18,b,14,4,a
child,295308,295561,253,Japan,J18,b,15,1,a
mother,300078,301866,1788,Japan,J18,f,16,1,a
mother,306881,309182,2301,Japan,J18,c,16,2,q
child,309765,310208,443,Japan,J18,m,16,3,a
mother,311182,311685,503,Japan,J18,c,16,4,q
child,315462,315970,508,Japan,J18,m,16,5,a
mother,323704,324564,860,Japan,J18,c,16,6,a
mother,329704,331346,1642,Japan,J18,c,16,7,q
child,331860,332315,455,Japan,J18,m,16,8,a
father,336810,337741,931,Japan,J18,m,16,9,q
mother,338225,338654,429,Japan,J18,f,16,10,a
mother,342468,343424,956,Japan,J18,c,16,11,a
child,345405,346724,1319,Japan,J18,m,16,12,a
mother,347378,349550,2172,Japan,J18,c,16,13,a
child,353696,355385,1689,Japan,J18,m,16,14,a
child,356464,356997,533,Japan,J18,m,16,15,a
mother,358182,360759,2577,Japan,J18,c,16,16,a
child,361901,365042,3141,Japan,J18,m,16,17,a
mother,365391,366108,717,Japan,J18,c,16,18,q
child,366128,366567,439,Japan,J18,m,16,19,a
mother,376391,376875,484,Japan,J18,c,16,20,q
child,377790,379652,1862,Japan,J18,m,16,21,a
mother,379716,380636,920,Japan,J18,c,16,22,q
mother,381446,382695,1249,Japan,J18,f,16,23,q
mother,384980,386513,1533,Japan,J18,c,16,24,q
child,397650,399886,2236,Japan,J18,f,16,25,i
child,403756,404347,591,Japan,J18,f,16,26,a
father,404599,405348,749,Japan,J18,c,16,27,a
mother,404955,406134,1179,Japan,J18,c,16,28,a
child,409957,410760,803,Japan,J18,f,16,29,i
father,411378,411820,442,Japan,J18,c,16,30,q
mother,411802,413811,2009,Japan,J18,c,16,31,q
child,429659,431034,1375,Japan,J18,m,16,32,a
father,436272,436812,540,Japan,J18,c,16,33,q
child,437061,437641,580,Japan,J18,f,16,34,a
father,451434,452158,724,Japan,J18,NA,16,35,a
child,452860,453673,813,Japan,J18,f,16,36,a
father,453980,454673,693,Japan,J18,c,16,37,a
child,454784,456076,1292,Japan,J18,f,16,38,a
mother,456139,459164,3025,Japan,J18,c,16,39,a
father,456250,457053,803,Japan,J18,c,16,40,a
child,461750,463860,2110,Japan,J18,f,17,1,a
father,463734,465440,1706,Japan,J18,c,17,2,q
father,489077,490067,990,Japan,J18,c,18,1,a
child,489951,491139,1188,Japan,J18,f,18,2,a
mother,490331,490716,385,Japan,J18,f,18,3,a
father,491200,491446,246,Japan,J18,c,18,4,q
mother,491562,492922,1360,Japan,J18,c,18,5,a
child,492841,493730,889,Japan,J18,f,18,6,a
father,495059,496248,1189,Japan,J18,c,18,7,q
mother,497440,500033,2593,Japan,J18,c,18,8,q
child,502464,503580,1116,Japan,J18,m,18,9,a
child,505097,506759,1662,Japan,J18,b,19,1,q
father,506925,507887,962,Japan,J18,c,19,2,q
child,509363,509957,594,Japan,J18,f,19,3,a
father,509973,511359,1386,Japan,J18,c,19,4,q
child,511660,512371,711,Japan,J18,f,19,5,a
child,517862,519730,1868,Japan,J18,m,20,1,a
mother,521662,522381,719,Japan,J18,c,20,2,q
child,524285,525707,1422,Japan,J18,NA,20,3,q
mother,526023,526912,889,Japan,J18,c,20,4,a
child,527911,528720,809,Japan,J18,m,20,5,a
mother,528972,529337,365,Japan,J18,c,20,6,a
child,530253,531399,1146,Japan,J18,m,20,7,a
mother,531875,532457,582,Japan,J18,c,20,8,a
child,536449,537393,944,Japan,J18,m,20,9,q
mother,537564,538235,671,Japan,J18,c,20,10,a
child,539964,540704,740,Japan,J18,m,20,11,a
father,541667,542429,762,Japan,J18,m,20,12,a
child,542243,543788,1545,Japan,J18,f,20,13,q
father,543771,544072,301,Japan,J18,c,20,14,a
mother,544188,545500,1312,Japan,J18,f,20,15,i
mother,548225,550539,2314,Japan,J18,f,20,16,a
child,552347,553456,1109,Japan,J18,m,20,17,q
mother,553648,553993,345,Japan,J18,c,20,18,a
child,556191,557275,1084,Japan,J18,m,20,19,q
mother,557589,558200,611,Japan,J18,c,20,20,a
child,559892,560406,514,Japan,J18,m,20,21,q
mother,560976,561518,542,Japan,J18,c,20,22,a
child,561978,562808,830,Japan,J18,m,20,23,a
mother,563101,564070,969,Japan,J18,c,20,24,a
child,565464,566357,893,Japan,J18,c,20,25,a
child,571529,572146,617,Japan,J18,m,20,26,q
mother,573280,574306,1026,Japan,J18,c,20,27,a
mother,577595,578185,590,Japan,J18,c,20,28,q
child,578199,578653,454,Japan,J18,m,20,29,a
mother,579281,579885,604,Japan,J18,NA,20,30,a
child,579970,580763,793,Japan,J18,m,20,31,a
mother,581632,584093,2461,Japan,J18,c,20,32,q
child,584555,585001,446,Japan,J18,m,20,33,a
mother,584904,585967,1063,Japan,J18,c,20,34,q
child,586527,587768,1241,Japan,J18,m,20,35,a
child,590316,591723,1407,Japan,J18,m,20,36,q
mother,591994,592420,426,Japan,J18,NA,20,37,a
father,60760,62796,2036,Japan,J18,c,21,1,a
father,67986,68926,940,Japan,J18,m,22,1,q
mother,69048,70328,1280,Japan,J18,f,22,2,a
father,71691,74734,3043,Japan,J18,m,22,3,a
mother,72814,73195,381,Japan,J18,f,22,4,a
mother,74756,76483,1727,Japan,J18,f,22,5,a
father,76763,78380,1617,Japan,J18,m,22,6,a
father,180778,187194,6416,Japan,J18,c,23,1,q
child,189678,190548,870,Japan,J18,m,23,2,a
mother,190869,191164,295,Japan,J18,c,23,3,q
father,190946,191440,494,Japan,J18,c,23,4,q
child,191667,192267,600,Japan,J18,f,23,5,a
father,192636,193280,644,Japan,J18,c,23,6,q
mother,192685,194906,2221,Japan,J18,c,23,7,q
father,195473,196918,1445,Japan,J18,c,23,8,q
child,197389,197825,436,Japan,J18,f,23,9,a
mother,198912,199466,554,Japan,J18,f,23,10,a
mother,199556,202413,2857,Japan,J18,f,23,11,q
child,202645,203512,867,Japan,J18,m,23,12,a
mother,203470,206900,3430,Japan,J18,c,23,13,i
child,207888,208660,772,Japan,J18,m,23,14,a
mother,209059,209950,891,Japan,J18,c,23,15,a
silence,3086,3509,423,Japan,J18,NA,NA,NA,NA
silence,4182,4444,262,Japan,J18,NA,NA,NA,NA
child,4444,5178,734,Japan,J18,m,NA,NA,i
silence,5178,5718,540,Japan,J18,NA,NA,NA,NA
silence,8170,9284,1114,Japan,J18,NA,NA,NA,NA
silence,11101,11134,33,Japan,J18,NA,NA,NA,NA
silence,13444,13495,51,Japan,J18,NA,NA,NA,NA
silence,13947,14048,101,Japan,J18,NA,NA,NA,NA
child_gesture,14051,16522,2471,Japan,J18,NA,NA,NA,NA
silence,16509,16593,84,Japan,J18,NA,NA,NA,NA
silence,16949,17373,424,Japan,J18,NA,NA,NA,NA
silence,18548,20495,1947,Japan,J18,NA,NA,NA,NA
silence,23127,23373,246,Japan,J18,NA,NA,NA,NA
silence,23737,24292,555,Japan,J18,NA,NA,NA,NA
silence,26335,27230,895,Japan,J18,NA,NA,NA,NA
silence,28529,28661,132,Japan,J18,NA,NA,NA,NA
silence,29805,35074,5269,Japan,J18,NA,NA,NA,NA
silence,36433,38367,1934,Japan,J18,NA,NA,NA,NA
silence,40970,41684,714,Japan,J18,NA,NA,NA,NA
silence,42126,42878,752,Japan,J18,NA,NA,NA,NA
silence,43741,45444,1703,Japan,J18,NA,NA,NA,NA
silence,48055,48736,681,Japan,J18,NA,NA,NA,NA
silence,50170,50217,47,Japan,J18,NA,NA,NA,NA
silence,51535,52571,1036,Japan,J18,NA,NA,NA,NA
silence,53574,58251,4677,Japan,J18,NA,NA,NA,NA
child_gesture,58095,60477,2382,Japan,J18,NA,NA,NA,NA
silence,59025,59304,279,Japan,J18,NA,NA,NA,NA
silence,59953,60760,807,Japan,J18,NA,NA,NA,NA
silence,63265,67986,4721,Japan,J18,NA,NA,NA,NA
silence,68926,69048,122,Japan,J18,NA,NA,NA,NA
silence,70328,71691,1363,Japan,J18,NA,NA,NA,NA
silence,74734,74756,22,Japan,J18,NA,NA,NA,NA
silence,76483,76763,280,Japan,J18,NA,NA,NA,NA
silence,78380,84457,6077,Japan,J18,NA,NA,NA,NA
silence,86687,86847,160,Japan,J18,NA,NA,NA,NA
silence,87600,87970,370,Japan,J18,NA,NA,NA,NA
silence,88665,88704,39,Japan,J18,NA,NA,NA,NA
silence,89055,89132,77,Japan,J18,NA,NA,NA,NA
silence,90106,90459,353,Japan,J18,NA,NA,NA,NA
silence,90797,91009,212,Japan,J18,NA,NA,NA,NA
silence,92010,92519,509,Japan,J18,NA,NA,NA,NA
silence,92832,92869,37,Japan,J18,NA,NA,NA,NA
mother_gesture,94308,95658,1350,Japan,J18,NA,NA,NA,NA
silence,95863,98299,2436,Japan,J18,NA,NA,NA,NA
silence,102973,107595,4622,Japan,J18,NA,NA,NA,NA
child_gesture,107703,111703,4000,Japan,J18,NA,NA,NA,NA
silence,109553,110609,1056,Japan,J18,NA,NA,NA,NA
silence,111299,112272,973,Japan,J18,NA,NA,NA,NA
silence,113750,114164,414,Japan,J18,NA,NA,NA,NA
silence,116034,116717,683,Japan,J18,NA,NA,NA,NA
silence,118152,118403,251,Japan,J18,NA,NA,NA,NA
silence,118838,123262,4424,Japan,J18,NA,NA,NA,NA
silence,124533,124679,146,Japan,J18,NA,NA,NA,NA
silence,126154,130308,4154,Japan,J18,NA,NA,NA,NA
silence,134769,135090,321,Japan,J18,NA,NA,NA,NA
silence,135501,139178,3677,Japan,J18,NA,NA,NA,NA
father_gesture,144570,146117,1547,Japan,J18,NA,NA,NA,NA
silence,146378,151792,5414,Japan,J18,NA,NA,NA,NA
mother_gesture,151808,154079,2271,Japan,J18,NA,NA,NA,NA
silence,155875,155888,13,Japan,J18,NA,NA,NA,NA
silence,156381,157234,853,Japan,J18,NA,NA,NA,NA
silence,158548,160036,1488,Japan,J18,NA,NA,NA,NA
father_gesture,159912,161088,1176,Japan,J18,NA,NA,NA,NA
silence,161083,161348,265,Japan,J18,NA,NA,NA,NA
silence,161704,162023,319,Japan,J18,NA,NA,NA,NA
father,162023,162875,852,Japan,J18,m,NA,NA,a
silence,162875,169600,6725,Japan,J18,NA,NA,NA,NA
silence,170671,173428,2757,Japan,J18,NA,NA,NA,NA
silence,174527,176750,2223,Japan,J18,NA,NA,NA,NA
silence,178191,178225,34,Japan,J18,NA,NA,NA,NA
silence,179519,179551,32,Japan,J18,NA,NA,NA,NA
silence,180102,180778,676,Japan,J18,NA,NA,NA,NA
silence,187194,189678,2484,Japan,J18,NA,NA,NA,NA
silence,190548,190869,321,Japan,J18,NA,NA,NA,NA
silence,191440,191667,227,Japan,J18,NA,NA,NA,NA
child_gesture,191679,192514,835,Japan,J18,NA,NA,NA,NA
silence,192267,192636,369,Japan,J18,NA,NA,NA,NA
silence,194906,195473,567,Japan,J18,NA,NA,NA,NA
silence,196918,197389,471,Japan,J18,NA,NA,NA,NA
father,197753,199269,1516,Japan,J18,c,NA,NA,a
silence,199466,199556,90,Japan,J18,NA,NA,NA,NA
silence,202413,202645,232,Japan,J18,NA,NA,NA,NA
child_gesture,202639,203514,875,Japan,J18,NA,NA,NA,NA
silence,206900,207888,988,Japan,J18,NA,NA,NA,NA
silence,208660,209059,399,Japan,J18,NA,NA,NA,NA
silence,209950,212022,2072,Japan,J18,NA,NA,NA,NA
child_gesture,212169,219451,7282,Japan,J18,NA,NA,NA,NA
silence,216250,216369,119,Japan,J18,NA,NA,NA,NA
silence,216807,216857,50,Japan,J18,NA,NA,NA,NA
silence,217853,217869,16,Japan,J18,NA,NA,NA,NA
silence,218443,218495,52,Japan,J18,NA,NA,NA,NA
silence,219084,219530,446,Japan,J18,NA,NA,NA,NA
silence,221028,221170,142,Japan,J18,NA,NA,NA,NA
silence,221832,222043,211,Japan,J18,NA,NA,NA,NA
silence,222359,224652,2293,Japan,J18,NA,NA,NA,NA
silence,227966,228128,162,Japan,J18,NA,NA,NA,NA
silence,229924,233483,3559,Japan,J18,NA,NA,NA,NA
silence,234058,234317,259,Japan,J18,NA,NA,NA,NA
silence,235110,237280,2170,Japan,J18,NA,NA,NA,NA
silence,238645,242272,3627,Japan,J18,NA,NA,NA,NA
silence,243125,243550,425,Japan,J18,NA,NA,NA,NA
father_gesture,243735,245095,1360,Japan,J18,NA,NA,NA,NA
silence,245099,245536,437,Japan,J18,NA,NA,NA,NA
silence,245875,250464,4589,Japan,J18,NA,NA,NA,NA
silence,253256,253670,414,Japan,J18,NA,NA,NA,NA
silence,254515,255168,653,Japan,J18,NA,NA,NA,NA
silence,259115,259538,423,Japan,J18,NA,NA,NA,NA
silence,260070,261734,1664,Japan,J18,NA,NA,NA,NA
silence,263691,263765,74,Japan,J18,NA,NA,NA,NA
silence,264499,267998,3499,Japan,J18,NA,NA,NA,NA
silence,270286,270366,80,Japan,J18,NA,NA,NA,NA
silence,273720,273848,128,Japan,J18,NA,NA,NA,NA
silence,276366,277090,724,Japan,J18,NA,NA,NA,NA
father_gesture,277227,278777,1550,Japan,J18,NA,NA,NA,NA
silence,277881,278659,778,Japan,J18,NA,NA,NA,NA
silence,280120,280139,19,Japan,J18,NA,NA,NA,NA
silence,280918,281685,767,Japan,J18,NA,NA,NA,NA
silence,282801,288834,6033,Japan,J18,NA,NA,NA,NA
silence,289548,289556,8,Japan,J18,NA,NA,NA,NA
silence,290181,290593,412,Japan,J18,NA,NA,NA,NA
child,292107,292969,862,Japan,J18,b,NA,NA,a
silence,293220,295308,2088,Japan,J18,NA,NA,NA,NA
silence,295561,300078,4517,Japan,J18,NA,NA,NA,NA
silence,301866,306881,5015,Japan,J18,NA,NA,NA,NA
silence,309182,309765,583,Japan,J18,NA,NA,NA,NA
silence,310208,311182,974,Japan,J18,NA,NA,NA,NA
silence,311685,315462,3777,Japan,J18,NA,NA,NA,NA
silence,315970,323704,7734,Japan,J18,NA,NA,NA,NA
silence,324564,329704,5140,Japan,J18,NA,NA,NA,NA
silence,331346,331860,514,Japan,J18,NA,NA,NA,NA
silence,332315,336810,4495,Japan,J18,NA,NA,NA,NA
silence,337741,338225,484,Japan,J18,NA,NA,NA,NA
silence,338654,342468,3814,Japan,J18,NA,NA,NA,NA
silence,343424,345405,1981,Japan,J18,NA,NA,NA,NA
silence,346724,347378,654,Japan,J18,NA,NA,NA,NA
silence,349550,353696,4146,Japan,J18,NA,NA,NA,NA
silence,355385,355957,572,Japan,J18,NA,NA,NA,NA
mother,355957,356818,861,Japan,J18,c,NA,NA,q
silence,356997,358182,1185,Japan,J18,NA,NA,NA,NA
silence,360759,361901,1142,Japan,J18,NA,NA,NA,NA
child_gesture,363514,364882,1368,Japan,J18,NA,NA,NA,NA
silence,365042,365391,349,Japan,J18,NA,NA,NA,NA
silence,366108,366128,20,Japan,J18,NA,NA,NA,NA
silence,366567,369378,2811,Japan,J18,NA,NA,NA,NA
child,369378,370964,1586,Japan,J18,m,NA,NA,a
silence,370964,376391,5427,Japan,J18,NA,NA,NA,NA
silence,376875,377790,915,Japan,J18,NA,NA,NA,NA
child_gesture,377205,378637,1432,Japan,J18,NA,NA,NA,NA
silence,379652,379716,64,Japan,J18,NA,NA,NA,NA
silence,380636,381446,810,Japan,J18,NA,NA,NA,NA
silence,382695,384980,2285,Japan,J18,NA,NA,NA,NA
silence,386513,397650,11137,Japan,J18,NA,NA,NA,NA
silence,399886,403756,3870,Japan,J18,NA,NA,NA,NA
silence,404347,404599,252,Japan,J18,NA,NA,NA,NA
silence,406134,409957,3823,Japan,J18,NA,NA,NA,NA
silence,410760,411378,618,Japan,J18,NA,NA,NA,NA
silence,413811,429659,15848,Japan,J18,NA,NA,NA,NA
silence,431034,432654,1620,Japan,J18,NA,NA,NA,NA
mother,432654,433753,1099,Japan,J18,c,NA,NA,a
silence,433753,436272,2519,Japan,J18,NA,NA,NA,NA
silence,436812,437061,249,Japan,J18,NA,NA,NA,NA
silence,437641,450295,12654,Japan,J18,NA,NA,NA,NA
child,450295,451204,909,Japan,J18,f,NA,NA,a
child_gesture,450629,452308,1679,Japan,J18,NA,NA,NA,NA
silence,451204,451434,230,Japan,J18,NA,NA,NA,NA
silence,452158,452860,702,Japan,J18,NA,NA,NA,NA
silence,453673,453980,307,Japan,J18,NA,NA,NA,NA
silence,454673,454784,111,Japan,J18,NA,NA,NA,NA
silence,456076,456139,63,Japan,J18,NA,NA,NA,NA
silence,459164,461750,2586,Japan,J18,NA,NA,NA,NA
silence,465440,489077,23637,Japan,J18,NA,NA,NA,NA
child_gesture,489847,492961,3114,Japan,J18,NA,NA,NA,NA
silence,491139,491200,61,Japan,J18,NA,NA,NA,NA
silence,491446,491562,116,Japan,J18,NA,NA,NA,NA
silence,493730,495059,1329,Japan,J18,NA,NA,NA,NA
silence,496248,497440,1192,Japan,J18,NA,NA,NA,NA
silence,500033,502464,2431,Japan,J18,NA,NA,NA,NA
silence,503580,505097,1517,Japan,J18,NA,NA,NA,NA
child_gesture,504735,508503,3768,Japan,J18,NA,NA,NA,NA
silence,506759,506925,166,Japan,J18,NA,NA,NA,NA
silence,507887,509363,1476,Japan,J18,NA,NA,NA,NA
silence,509957,509973,16,Japan,J18,NA,NA,NA,NA
silence,511359,511660,301,Japan,J18,NA,NA,NA,NA
silence,512371,517862,5491,Japan,J18,NA,NA,NA,NA
silence,519730,521662,1932,Japan,J18,NA,NA,NA,NA
silence,522381,524285,1904,Japan,J18,NA,NA,NA,NA
child_gesture,524412,527659,3247,Japan,J18,NA,NA,NA,NA
silence,525707,526023,316,Japan,J18,NA,NA,NA,NA
silence,526912,527911,999,Japan,J18,NA,NA,NA,NA
silence,528720,528972,252,Japan,J18,NA,NA,NA,NA
silence,529337,530253,916,Japan,J18,NA,NA,NA,NA
silence,531399,531875,476,Japan,J18,NA,NA,NA,NA
silence,532457,536449,3992,Japan,J18,NA,NA,NA,NA
child_gesture,536073,538399,2326,Japan,J18,NA,NA,NA,NA
silence,537393,537564,171,Japan,J18,NA,NA,NA,NA
silence,538235,539964,1729,Japan,J18,NA,NA,NA,NA
silence,540704,541667,963,Japan,J18,NA,NA,NA,NA
silence,544072,544188,116,Japan,J18,NA,NA,NA,NA
silence,545500,548225,2725,Japan,J18,NA,NA,NA,NA
silence,550539,552347,1808,Japan,J18,NA,NA,NA,NA
child_gesture,552360,556000,3640,Japan,J18,NA,NA,NA,NA
silence,553456,553648,192,Japan,J18,NA,NA,NA,NA
silence,553993,556191,2198,Japan,J18,NA,NA,NA,NA
silence,557275,557589,314,Japan,J18,NA,NA,NA,NA
silence,558200,559892,1692,Japan,J18,NA,NA,NA,NA
child_gesture,559904,562566,2662,Japan,J18,NA,NA,NA,NA
silence,560406,560976,570,Japan,J18,NA,NA,NA,NA
silence,561518,561978,460,Japan,J18,NA,NA,NA,NA
silence,562808,563101,293,Japan,J18,NA,NA,NA,NA
silence,564070,565464,1394,Japan,J18,NA,NA,NA,NA
child_gesture,564522,566166,1644,Japan,J18,NA,NA,NA,NA
silence,566357,571529,5172,Japan,J18,NA,NA,NA,NA
child_gesture,571345,573117,1772,Japan,J18,NA,NA,NA,NA
silence,572146,573280,1134,Japan,J18,NA,NA,NA,NA
silence,574306,575860,1554,Japan,J18,NA,NA,NA,NA
child,575860,577561,1701,Japan,J18,m,NA,NA,q
silence,577561,577595,34,Japan,J18,NA,NA,NA,NA
silence,578185,578199,14,Japan,J18,NA,NA,NA,NA
silence,578653,579281,628,Japan,J18,NA,NA,NA,NA
silence,579885,579970,85,Japan,J18,NA,NA,NA,NA
silence,580763,581632,869,Japan,J18,NA,NA,NA,NA
silence,584093,584555,462,Japan,J18,NA,NA,NA,NA
silence,585967,586527,560,Japan,J18,NA,NA,NA,NA
silence,587768,590316,2548,Japan,J18,NA,NA,NA,NA
silence,591723,591994,271,Japan,J18,NA,NA,NA,NA
child,9377,9759,382,Japan,J19,m,1,1,a
mother,14935,15200,265,Japan,J19,c,1,2,a
mother,17161,19222,2061,Japan,J19,c,1,3,i
mother,22311,29846,7535,Japan,J19,c,1,4,a
mother,36602,38736,2134,Japan,J19,c,1,5,a
mother,48200,48866,666,Japan,J19,c,1,6,q
father,12183,12920,737,Japan,J19,o,2,1,a
father,57001,62018,5017,Japan,J19,m,3,1,a
child,68987,69773,786,Japan,J19,f,4,1,a
mother,70067,70561,494,Japan,J19,c,4,2,q
child,70635,71780,1145,Japan,J19,b,4,3,a
mother,71946,72587,641,Japan,J19,c,4,4,q
mother,75029,75719,690,Japan,J19,c,4,5,q
child,77252,78047,795,Japan,J19,m,4,6,a
mother,78355,78907,552,Japan,J19,c,4,7,q
child,79171,80392,1221,Japan,J19,m,4,8,a
mother,80653,84338,3685,Japan,J19,c,4,9,q
mother,90078,95935,5857,Japan,J19,c,4,10,a
father,97827,98675,848,Japan,J19,m,5,1,a
father,100084,101410,1326,Japan,J19,m,5,2,a
mother,102570,104482,1912,Japan,J19,c,5,3,a
father,121940,122835,895,Japan,J19,m,6,1,i
mother,123388,123808,420,Japan,J19,f,6,2,a
child,128647,128866,219,Japan,J19,f,7,1,a
father,129758,130114,356,Japan,J19,c,7,2,a
mother,134648,135393,745,Japan,J19,o,8,1,a
mother,138084,140128,2044,Japan,J19,o,8,2,a
mother,142175,146062,3887,Japan,J19,f,9,1,a
father,146703,148810,2107,Japan,J19,m,9,2,a
mother,148896,149975,1079,Japan,J19,f,9,3,a
father,149250,150504,1254,Japan,J19,m,9,4,a
mother,151940,154465,2525,Japan,J19,f,9,5,a
mother,160537,161902,1365,Japan,J19,o,10,1,i
mother,186106,188067,1961,Japan,J19,b,11,1,a
mother,188880,191165,2285,Japan,J19,b,12,1,a
child,191166,192304,1138,Japan,J19,b,13,1,a
father,192581,193156,575,Japan,J19,c,13,2,a
mother,207449,209543,2094,Japan,J19,c,14,1,a
father,211161,212946,1785,Japan,J19,m,14,2,a
mother,213073,216067,2994,Japan,J19,f,14,3,a
father,220090,222023,1933,Japan,J19,c,14,4,a
child,227449,227775,326,Japan,J19,b,15,1,a
mother,228857,229239,382,Japan,J19,c,15,2,a
child,230845,231902,1057,Japan,J19,b,15,3,a
mother,232598,232918,320,Japan,J19,c,15,4,q
child,233239,233520,281,Japan,J19,b,15,5,a
child,235692,235979,287,Japan,J19,b,15,6,a
mother,241056,243625,2569,Japan,J19,c,15,7,i
father,250951,251957,1006,Japan,J19,m,16,1,a
father,254846,256189,1343,Japan,J19,m,16,2,q
mother,256835,258393,1558,Japan,J19,f,16,3,a
father,259067,260587,1520,Japan,J19,m,16,4,q
mother,262935,263913,978,Japan,J19,f,16,5,q
father,263940,264189,249,Japan,J19,m,16,6,a
mother,264294,265294,1000,Japan,J19,f,16,7,q
father,265333,265614,281,Japan,J19,m,16,8,a
mother,265863,266935,1072,Japan,J19,f,16,9,a
father,267007,268962,1955,Japan,J19,m,16,10,a
mother,270244,276532,6288,Japan,J19,f,16,11,a
father,292117,293224,1107,Japan,J19,m,16,12,a
mother,293609,294172,563,Japan,J19,f,16,13,q
father,294167,294537,370,Japan,J19,m,16,14,a
mother,294791,295481,690,Japan,J19,f,16,15,a
mother,296940,301570,4630,Japan,J19,c,16,16,q
father,303007,303852,845,Japan,J19,c,17,1,a
mother,304371,305219,848,Japan,J19,c,17,2,q
father,305659,306050,391,Japan,J19,m,17,3,a
mother,306344,311078,4734,Japan,J19,c,17,4,a
mother,314686,315410,724,Japan,J19,c,17,5,q
child,321045,322007,962,Japan,J19,b,18,1,a
mother,321620,323692,2072,Japan,J19,c,18,2,a
father,324194,325957,1763,Japan,J19,c,18,3,a
child,324970,326201,1231,Japan,J19,f,18,4,a
mother,325946,328526,2580,Japan,J19,b,18,5,a
father,328311,330498,2187,Japan,J19,c,18,6,a
mother,333156,333333,177,Japan,J19,f,18,7,a
father,333316,334219,903,Japan,J19,c,18,8,a
child,335332,336140,808,Japan,J19,f,18,9,a
child,338732,338938,206,Japan,J19,f,18,10,a
father,347670,349172,1502,Japan,J19,c,18,11,a
child,356656,356966,310,Japan,J19,m,18,12,a
mother,357327,361393,4066,Japan,J19,c,18,13,a
mother,364940,366570,1630,Japan,J19,o,19,1,a
father,369101,370929,1828,Japan,J19,m,20,1,a
mother,371084,371614,530,Japan,J19,f,20,2,q
father,372078,372316,238,Japan,J19,NA,20,3,a
father,367946,368548,602,Japan,J19,c,21,1,a
mother,385951,388979,3028,Japan,J19,b,22,1,a
child,392068,392348,280,Japan,J19,b,23,1,a
father,393139,393360,221,Japan,J19,c,23,2,q
father,402570,402980,410,Japan,J19,c,23,3,a
child,452387,454401,2014,Japan,J19,f,23,4,a
child,470794,474745,3951,Japan,J19,f,24,1,a
father,472028,472313,285,Japan,J19,c,24,2,a
child,479869,481490,1621,Japan,J19,f,24,3,a
father,487340,487842,502,Japan,J19,NA,24,4,i
father,494631,494929,298,Japan,J19,c,24,5,a
father,497625,498189,564,Japan,J19,NA,25,1,a
child,498265,498952,687,Japan,J19,f,25,2,a
father,499305,500351,1046,Japan,J19,c,25,3,a
child,525187,528642,3455,Japan,J19,f,26,1,a
mother,552167,552741,574,Japan,J19,c,27,1,q
mother,561017,561368,351,Japan,J19,c,27,2,a
mother,564979,567421,2442,Japan,J19,f,28,1,a
father,568388,568940,552,Japan,J19,m,28,2,q
mother,569101,569590,489,Japan,J19,f,28,3,a
mother,576200,577962,1762,Japan,J19,c,29,1,a
father,591885,592396,511,Japan,J19,c,30,1,a
mother,50012,50791,779,Japan,J19,f,31,1,a
father,53222,53725,503,Japan,J19,m,31,2,q
mother,53869,54598,729,Japan,J19,f,31,3,a
silence,9759,10686,927,Japan,J19,NA,NA,NA,NA
mother,10686,11692,1006,Japan,J19,c,NA,NA,q
silence,11692,12183,491,Japan,J19,NA,NA,NA,NA
silence,12920,14935,2015,Japan,J19,NA,NA,NA,NA
silence,15200,17161,1961,Japan,J19,NA,NA,NA,NA
silence,19222,22311,3089,Japan,J19,NA,NA,NA,NA
silence,29846,36602,6756,Japan,J19,NA,NA,NA,NA
silence,38736,48200,9464,Japan,J19,NA,NA,NA,NA
silence,48866,50012,1146,Japan,J19,NA,NA,NA,NA
silence,50791,53222,2431,Japan,J19,NA,NA,NA,NA
silence,53725,53869,144,Japan,J19,NA,NA,NA,NA
silence,54598,57001,2403,Japan,J19,NA,NA,NA,NA
silence,62018,68987,6969,Japan,J19,NA,NA,NA,NA
silence,69773,70067,294,Japan,J19,NA,NA,NA,NA
silence,70561,70635,74,Japan,J19,NA,NA,NA,NA
silence,71780,71946,166,Japan,J19,NA,NA,NA,NA
silence,72587,75029,2442,Japan,J19,NA,NA,NA,NA
silence,75719,77255,1536,Japan,J19,NA,NA,NA,NA
silence,78007,78355,348,Japan,J19,NA,NA,NA,NA
silence,78907,79167,260,Japan,J19,NA,NA,NA,NA
mother_gesture,80055,81778,1723,Japan,J19,NA,NA,NA,NA
silence,80382,80653,271,Japan,J19,NA,NA,NA,NA
mother_gesture,82277,83592,1315,Japan,J19,NA,NA,NA,NA
silence,84338,90078,5740,Japan,J19,NA,NA,NA,NA
silence,95935,97827,1892,Japan,J19,NA,NA,NA,NA
silence,98675,100084,1409,Japan,J19,NA,NA,NA,NA
silence,101410,102570,1160,Japan,J19,NA,NA,NA,NA
silence,104482,121940,17458,Japan,J19,NA,NA,NA,NA
silence,122835,123388,553,Japan,J19,NA,NA,NA,NA
silence,123808,128647,4839,Japan,J19,NA,NA,NA,NA
silence,128866,129758,892,Japan,J19,NA,NA,NA,NA
silence,130114,134648,4534,Japan,J19,NA,NA,NA,NA
silence,135393,138084,2691,Japan,J19,NA,NA,NA,NA
silence,140128,142175,2047,Japan,J19,NA,NA,NA,NA
silence,146062,146703,641,Japan,J19,NA,NA,NA,NA
father_gesture,147653,150763,3110,Japan,J19,NA,NA,NA,NA
silence,148810,148896,86,Japan,J19,NA,NA,NA,NA
silence,150504,151940,1436,Japan,J19,NA,NA,NA,NA
silence,154465,160537,6072,Japan,J19,NA,NA,NA,NA
silence,161902,186106,24204,Japan,J19,NA,NA,NA,NA
silence,188067,188880,813,Japan,J19,NA,NA,NA,NA
child_gesture,190885,195056,4171,Japan,J19,NA,NA,NA,NA
silence,191165,191166,1,Japan,J19,NA,NA,NA,NA
silence,192304,192581,277,Japan,J19,NA,NA,NA,NA
silence,193156,207449,14293,Japan,J19,NA,NA,NA,NA
silence,209543,211161,1618,Japan,J19,NA,NA,NA,NA
silence,212946,213073,127,Japan,J19,NA,NA,NA,NA
silence,216067,220090,4023,Japan,J19,NA,NA,NA,NA
silence,222023,227449,5426,Japan,J19,NA,NA,NA,NA
silence,227775,228857,1082,Japan,J19,NA,NA,NA,NA
silence,229239,230845,1606,Japan,J19,NA,NA,NA,NA
silence,231902,232598,696,Japan,J19,NA,NA,NA,NA
silence,232918,233239,321,Japan,J19,NA,NA,NA,NA
silence,233520,235692,2172,Japan,J19,NA,NA,NA,NA
silence,235979,241056,5077,Japan,J19,NA,NA,NA,NA
silence,243625,250951,7326,Japan,J19,NA,NA,NA,NA
silence,251957,252526,569,Japan,J19,NA,NA,NA,NA
mother,252526,254526,2000,Japan,J19,NA,NA,NA,q
silence,254526,254846,320,Japan,J19,NA,NA,NA,NA
silence,256189,256835,646,Japan,J19,NA,NA,NA,NA
silence,258393,259067,674,Japan,J19,NA,NA,NA,NA
silence,260587,262935,2348,Japan,J19,NA,NA,NA,NA
mother_gesture,262940,264338,1398,Japan,J19,NA,NA,NA,NA
silence,263913,263940,27,Japan,J19,NA,NA,NA,NA
silence,264189,264294,105,Japan,J19,NA,NA,NA,NA
silence,265294,265333,39,Japan,J19,NA,NA,NA,NA
silence,265614,265863,249,Japan,J19,NA,NA,NA,NA
silence,266935,267007,72,Japan,J19,NA,NA,NA,NA
father_gesture,267007,269084,2077,Japan,J19,NA,NA,NA,NA
mother,267714,268996,1282,Japan,J19,f,NA,NA,a
silence,268996,270244,1248,Japan,J19,NA,NA,NA,NA
silence,276532,292117,15585,Japan,J19,NA,NA,NA,NA
silence,293224,293609,385,Japan,J19,NA,NA,NA,NA
silence,294537,294791,254,Japan,J19,NA,NA,NA,NA
silence,295481,296940,1459,Japan,J19,NA,NA,NA,NA
silence,301570,303007,1437,Japan,J19,NA,NA,NA,NA
silence,303852,304371,519,Japan,J19,NA,NA,NA,NA
silence,305219,305659,440,Japan,J19,NA,NA,NA,NA
silence,306050,306344,294,Japan,J19,NA,NA,NA,NA
silence,311078,314686,3608,Japan,J19,NA,NA,NA,NA
silence,315410,321045,5635,Japan,J19,NA,NA,NA,NA
child_gesture,321410,323642,2232,Japan,J19,NA,NA,NA,NA
silence,323692,324194,502,Japan,J19,NA,NA,NA,NA
silence,330498,333156,2658,Japan,J19,NA,NA,NA,NA
silence,334219,335332,1113,Japan,J19,NA,NA,NA,NA
silence,336140,338732,2592,Japan,J19,NA,NA,NA,NA
silence,338938,344603,5665,Japan,J19,NA,NA,NA,NA
father,344603,344852,249,Japan,J19,c,NA,NA,a
silence,344852,347670,2818,Japan,J19,NA,NA,NA,NA
silence,349172,356656,7484,Japan,J19,NA,NA,NA,NA
child_gesture,356703,359111,2408,Japan,J19,NA,NA,NA,NA
silence,356966,357327,361,Japan,J19,NA,NA,NA,NA
silence,361393,364940,3547,Japan,J19,NA,NA,NA,NA
silence,366570,367333,763,Japan,J19,NA,NA,NA,NA
mother,367333,368549,1216,Japan,J19,f,NA,NA,q
silence,368549,369101,552,Japan,J19,NA,NA,NA,NA
mother_gesture,370276,372173,1897,Japan,J19,NA,NA,NA,NA
silence,370929,371084,155,Japan,J19,NA,NA,NA,NA
silence,371614,372078,464,Japan,J19,NA,NA,NA,NA
silence,372316,385951,13635,Japan,J19,NA,NA,NA,NA
silence,388979,392068,3089,Japan,J19,NA,NA,NA,NA
silence,392348,393139,791,Japan,J19,NA,NA,NA,NA
silence,393360,402570,9210,Japan,J19,NA,NA,NA,NA
silence,402980,452387,49407,Japan,J19,NA,NA,NA,NA
silence,454401,470794,16393,Japan,J19,NA,NA,NA,NA
silence,474745,479869,5124,Japan,J19,NA,NA,NA,NA
silence,481490,487340,5850,Japan,J19,NA,NA,NA,NA
silence,487842,494631,6789,Japan,J19,NA,NA,NA,NA
silence,494929,497625,2696,Japan,J19,NA,NA,NA,NA
silence,498189,498265,76,Japan,J19,NA,NA,NA,NA
silence,498952,499305,353,Japan,J19,NA,NA,NA,NA
silence,500351,525187,24836,Japan,J19,NA,NA,NA,NA
child_gesture,525189,529678,4489,Japan,J19,NA,NA,NA,NA
silence,528642,552167,23525,Japan,J19,NA,NA,NA,NA
silence,552741,561017,8276,Japan,J19,NA,NA,NA,NA
silence,561368,564979,3611,Japan,J19,NA,NA,NA,NA
silence,567421,568388,967,Japan,J19,NA,NA,NA,NA
silence,568940,569101,161,Japan,J19,NA,NA,NA,NA
silence,569590,576200,6610,Japan,J19,NA,NA,NA,NA
silence,577962,591885,13923,Japan,J19,NA,NA,NA,NA
father,1831,2803,972,Japan,J20,b,1,1,a
mother,18561,18896,335,Japan,J20,f,2,1,a
father,19153,19908,755,Japan,J20,m,2,2,a
mother,20433,22942,2509,Japan,J20,f,2,3,a
father,23234,24024,790,Japan,J20,m,2,4,a
mother,24335,27611,3276,Japan,J20,f,2,5,a
father,27682,28179,497,Japan,J20,m,2,6,a
father,30063,32378,2315,Japan,J20,m,2,7,a
mother,32470,32985,515,Japan,J20,f,2,8,a
mother,36549,38451,1902,Japan,J20,f,2,9,a
father,38588,39179,591,Japan,J20,m,2,10,a
mother,40202,40770,568,Japan,J20,f,2,11,a
father,41234,45820,4586,Japan,J20,m,2,12,a
mother,46206,47102,896,Japan,J20,f,2,13,a
father,48019,48704,685,Japan,J20,m,2,14,a
mother,52451,54384,1933,Japan,J20,f,2,15,a
father,54538,57726,3188,Japan,J20,m,2,16,a
mother,57046,57496,450,Japan,J20,f,2,17,a
mother,64169,67525,3356,Japan,J20,c,3,1,q
mother,83016,85402,2386,Japan,J20,c,3,2,a
mother,91151,99611,8460,Japan,J20,c,3,3,a
child,91280,92439,1159,Japan,J20,m,3,4,a
child,101246,102275,1029,Japan,J20,m,3,5,a
mother,102273,104942,2669,Japan,J20,c,3,6,a
father,107002,107439,437,Japan,J20,c,3,7,a
mother,111611,114039,2428,Japan,J20,f,3,8,a
mother,115052,117365,2313,Japan,J20,c,3,9,a
father,117593,118052,459,Japan,J20,c,3,10,a
mother,119119,120163,1044,Japan,J20,f,3,11,a
father,120152,124179,4027,Japan,J20,m,3,12,a
mother,131776,132928,1152,Japan,J20,c,3,13,a
mother,135384,138329,2945,Japan,J20,c,3,14,q
child,139020,139755,735,Japan,J20,m,3,15,a
mother,139715,140727,1012,Japan,J20,c,3,16,q
mother,149378,150225,847,Japan,J20,o,3,17,a
father,154516,155107,591,Japan,J20,m,3,18,a
mother,200617,201908,1291,Japan,J20,c,4,1,a
father,202004,202466,462,Japan,J20,c,4,2,a
mother,203678,206860,3182,Japan,J20,c,4,3,a
mother,207586,209421,1835,Japan,J20,f,5,1,q
father,209135,211047,1912,Japan,J20,m,5,2,a
mother,218568,220525,1957,Japan,J20,f,6,1,a
father,220527,221814,1287,Japan,J20,m,6,2,a
mother,221856,223169,1313,Japan,J20,f,6,3,a
father,224593,227726,3133,Japan,J20,m,7,1,q
mother,226053,226322,269,Japan,J20,f,7,2,a
mother,227715,229076,1361,Japan,J20,f,7,3,a
father,228803,229434,631,Japan,J20,m,7,4,q
mother,229273,230505,1232,Japan,J20,NA,7,5,a
father,230566,231373,807,Japan,J20,m,7,6,q
mother,231303,231692,389,Japan,J20,f,7,7,a
father,231803,233947,2144,Japan,J20,m,7,8,a
mother,233615,235506,1891,Japan,J20,f,7,9,a
father,235925,236490,565,Japan,J20,m,7,10,a
mother,236257,236850,593,Japan,J20,f,7,11,a
child,244798,246377,1579,Japan,J20,m,8,1,a
mother,246954,251703,4749,Japan,J20,c,8,2,a
mother,254206,255826,1620,Japan,J20,c,8,3,a
mother,256948,258733,1785,Japan,J20,f,9,1,a
father,258185,258907,722,Japan,J20,m,9,2,a
mother,265053,266483,1430,Japan,J20,f,9,3,a
mother,282359,285605,3246,Japan,J20,f,10,1,a
father,285991,287708,1717,Japan,J20,m,10,2,a
mother,290899,298715,7816,Japan,J20,c,11,1,a
mother,304446,305691,1245,Japan,J20,c,11,2,i
child,316929,317722,793,Japan,J20,m,11,3,a
mother,317888,319549,1661,Japan,J20,c,11,4,q
mother,323605,324679,1074,Japan,J20,c,11,5,q
child,331501,332509,1008,Japan,J20,m,11,6,a
mother,333470,333764,294,Japan,J20,c,11,7,a
father,348185,351500,3315,Japan,J20,m,12,1,a
mother,351556,352181,625,Japan,J20,f,12,2,a
father,353616,355605,1989,Japan,J20,m,12,3,a
father,357058,369814,12756,Japan,J20,m,12,4,a
mother,362151,363145,994,Japan,J20,f,12,5,a
mother,367071,367347,276,Japan,J20,f,12,6,a
mother,369856,370187,331,Japan,J20,f,12,7,a
father,370940,376748,5808,Japan,J20,m,12,8,a
mother,376776,377083,307,Japan,J20,f,12,9,a
father,379770,383529,3759,Japan,J20,m,12,10,a
mother,384359,385807,1448,Japan,J20,f,12,11,q
father,385953,387842,1889,Japan,J20,m,12,12,a
mother,388483,389224,741,Japan,J20,f,12,13,a
father,389284,389947,663,Japan,J20,m,12,14,a
mother,393400,395376,1976,Japan,J20,f,12,15,q
father,404737,411505,6768,Japan,J20,m,12,16,a
father,413980,424118,10138,Japan,J20,m,12,17,a
mother,420911,423611,2700,Japan,J20,f,12,18,a
mother,387414,388445,1031,Japan,J20,c,13,1,a
mother,391470,392997,1527,Japan,J20,c,13,2,i
mother,397435,400567,3132,Japan,J20,NA,13,3,a
child,438143,438992,849,Japan,J20,m,15,1,a
father,439372,439759,387,Japan,J20,c,15,2,a
mother,446938,451197,4259,Japan,J20,c,15,3,a
mother,458358,463358,5000,Japan,J20,c,15,4,a
father,463698,464384,686,Japan,J20,m,16,1,q
mother,464925,465697,772,Japan,J20,f,16,2,a
father,465466,466013,547,Japan,J20,m,16,3,a
mother,467907,469049,1142,Japan,J20,f,16,4,i
father,469328,469665,337,Japan,J20,m,16,5,a
mother,477123,478993,1870,Japan,J20,c,17,1,a
mother,499301,500086,785,Japan,J20,c,18,1,q
mother,502543,503266,723,Japan,J20,c,18,2,q
father,504754,505312,558,Japan,J20,c,18,3,a
mother,505308,507580,2272,Japan,J20,c,18,4,a
father,507853,508301,448,Japan,J20,NA,18,5,a
father,515384,518063,2679,Japan,J20,m,19,1,q
mother,517592,518124,532,Japan,J20,f,19,2,a
mother,518919,522246,3327,Japan,J20,f,19,3,q
father,522096,524428,2332,Japan,J20,m,19,4,q
mother,524716,525246,530,Japan,J20,f,19,5,q
father,525262,525749,487,Japan,J20,m,19,6,q
mother,526207,534875,8668,Japan,J20,f,20,1,a
father,530141,530432,291,Japan,J20,m,20,2,a
father,534955,535325,370,Japan,J20,m,20,3,a
mother,536063,543715,7652,Japan,J20,f,20,4,a
father,537859,538113,254,Japan,J20,m,20,5,a
father,541654,542069,415,Japan,J20,m,20,6,a
father,543422,544301,879,Japan,J20,m,20,7,a
mother,545422,550253,4831,Japan,J20,f,20,8,a
father,549107,551058,1951,Japan,J20,m,20,9,a
mother,552823,553950,1127,Japan,J20,f,20,10,a
father,554140,556201,2061,Japan,J20,m,20,11,a
mother,556919,557358,439,Japan,J20,f,20,12,a
father,558256,559834,1578,Japan,J20,m,20,13,a
father,562536,566941,4405,Japan,J20,m,20,14,a
mother,570716,571339,623,Japan,J20,f,20,15,q
father,572284,575269,2985,Japan,J20,m,20,16,a
mother,535190,536019,829,Japan,J20,c,21,1,a
father,536035,536295,260,Japan,J20,m,21,2,a
mother,585779,586749,970,Japan,J20,c,21,3,q
mother,592308,595376,3068,Japan,J20,c,21,4,i
mother,348093,348480,387,Japan,J20,c,22,1,a
silence,2803,17422,14619,Japan,J20,NA,NA,NA,NA
father,17422,18393,971,Japan,J20,m,NA,NA,a
silence,18393,18561,168,Japan,J20,NA,NA,NA,NA
silence,18896,19153,257,Japan,J20,NA,NA,NA,NA
silence,19908,20433,525,Japan,J20,NA,NA,NA,NA
silence,22942,23234,292,Japan,J20,NA,NA,NA,NA
silence,24024,24335,311,Japan,J20,NA,NA,NA,NA
silence,27611,27682,71,Japan,J20,NA,NA,NA,NA
silence,28179,30063,1884,Japan,J20,NA,NA,NA,NA
silence,32378,32470,92,Japan,J20,NA,NA,NA,NA
silence,32985,36549,3564,Japan,J20,NA,NA,NA,NA
silence,38451,38588,137,Japan,J20,NA,NA,NA,NA
silence,39179,40202,1023,Japan,J20,NA,NA,NA,NA
silence,40770,41234,464,Japan,J20,NA,NA,NA,NA
silence,45820,46206,386,Japan,J20,NA,NA,NA,NA
silence,47102,48019,917,Japan,J20,NA,NA,NA,NA
silence,48704,52451,3747,Japan,J20,NA,NA,NA,NA
silence,54384,54538,154,Japan,J20,NA,NA,NA,NA
silence,57726,64169,6443,Japan,J20,NA,NA,NA,NA
mother_gesture,64280,65237,957,Japan,J20,NA,NA,NA,NA
silence,67525,83016,15491,Japan,J20,NA,NA,NA,NA
silence,85402,91151,5749,Japan,J20,NA,NA,NA,NA
silence,99611,101246,1635,Japan,J20,NA,NA,NA,NA
silence,104942,107002,2060,Japan,J20,NA,NA,NA,NA
silence,107439,111611,4172,Japan,J20,NA,NA,NA,NA
silence,114039,115052,1013,Japan,J20,NA,NA,NA,NA
silence,117365,117593,228,Japan,J20,NA,NA,NA,NA
silence,118052,119119,1067,Japan,J20,NA,NA,NA,NA
silence,124179,131776,7597,Japan,J20,NA,NA,NA,NA
silence,132928,135384,2456,Japan,J20,NA,NA,NA,NA
mother_gesture,137218,138438,1220,Japan,J20,NA,NA,NA,NA
silence,138329,139020,691,Japan,J20,NA,NA,NA,NA
silence,140727,149378,8651,Japan,J20,NA,NA,NA,NA
silence,150225,153261,3036,Japan,J20,NA,NA,NA,NA
mother,153261,154284,1023,Japan,J20,f,NA,NA,a
silence,154284,154516,232,Japan,J20,NA,NA,NA,NA
silence,155107,200617,45510,Japan,J20,NA,NA,NA,NA
silence,201908,202004,96,Japan,J20,NA,NA,NA,NA
silence,202466,203678,1212,Japan,J20,NA,NA,NA,NA
silence,206860,207586,726,Japan,J20,NA,NA,NA,NA
silence,211047,218568,7521,Japan,J20,NA,NA,NA,NA
silence,220525,220527,2,Japan,J20,NA,NA,NA,NA
silence,221814,221856,42,Japan,J20,NA,NA,NA,NA
silence,223169,224593,1424,Japan,J20,NA,NA,NA,NA
father_gesture,226346,227863,1517,Japan,J20,NA,NA,NA,NA
mother_gesture,228018,229418,1400,Japan,J20,NA,NA,NA,NA
silence,230505,230566,61,Japan,J20,NA,NA,NA,NA
silence,231692,231803,111,Japan,J20,NA,NA,NA,NA
silence,235506,235925,419,Japan,J20,NA,NA,NA,NA
silence,236850,244798,7948,Japan,J20,NA,NA,NA,NA
child_gesture,244618,248417,3799,Japan,J20,NA,NA,NA,NA
silence,246377,246954,577,Japan,J20,NA,NA,NA,NA
silence,251703,254206,2503,Japan,J20,NA,NA,NA,NA
silence,255826,256948,1122,Japan,J20,NA,NA,NA,NA
silence,258907,259924,1017,Japan,J20,NA,NA,NA,NA
mother,259924,261340,1416,Japan,J20,f,NA,NA,a
silence,261340,265053,3713,Japan,J20,NA,NA,NA,NA
father,266393,266720,327,Japan,J20,m,NA,NA,a
silence,266720,282359,15639,Japan,J20,NA,NA,NA,NA
silence,285605,285991,386,Japan,J20,NA,NA,NA,NA
silence,287708,288819,1111,Japan,J20,NA,NA,NA,NA
mother,288819,289390,571,Japan,J20,c,NA,NA,q
silence,289390,290899,1509,Japan,J20,NA,NA,NA,NA
silence,298715,304446,5731,Japan,J20,NA,NA,NA,NA
silence,305691,316929,11238,Japan,J20,NA,NA,NA,NA
silence,317722,317888,166,Japan,J20,NA,NA,NA,NA
silence,319549,323605,4056,Japan,J20,NA,NA,NA,NA
silence,324679,331501,6822,Japan,J20,NA,NA,NA,NA
silence,332509,333470,961,Japan,J20,NA,NA,NA,NA
silence,333764,348093,14329,Japan,J20,NA,NA,NA,NA
silence,351500,351556,56,Japan,J20,NA,NA,NA,NA
silence,352181,353616,1435,Japan,J20,NA,NA,NA,NA
silence,355605,355727,122,Japan,J20,NA,NA,NA,NA
mother,355727,356862,1135,Japan,J20,f,NA,NA,q
silence,356862,357058,196,Japan,J20,NA,NA,NA,NA
silence,369814,369856,42,Japan,J20,NA,NA,NA,NA
silence,370187,370940,753,Japan,J20,NA,NA,NA,NA
silence,376748,376776,28,Japan,J20,NA,NA,NA,NA
silence,377083,379770,2687,Japan,J20,NA,NA,NA,NA
silence,383529,384359,830,Japan,J20,NA,NA,NA,NA
silence,385807,385953,146,Japan,J20,NA,NA,NA,NA
silence,388445,388483,38,Japan,J20,NA,NA,NA,NA
silence,389224,389284,60,Japan,J20,NA,NA,NA,NA
silence,389947,391470,1523,Japan,J20,NA,NA,NA,NA
silence,392997,393400,403,Japan,J20,NA,NA,NA,NA
silence,395376,397435,2059,Japan,J20,NA,NA,NA,NA
silence,400567,404737,4170,Japan,J20,NA,NA,NA,NA
silence,411505,413980,2475,Japan,J20,NA,NA,NA,NA
silence,424118,431086,6968,Japan,J20,NA,NA,NA,NA
mother,431086,431685,599,Japan,J20,c,NA,NA,q
silence,431685,438143,6458,Japan,J20,NA,NA,NA,NA
child_gesture,437675,440025,2350,Japan,J20,NA,NA,NA,NA
silence,438992,439372,380,Japan,J20,NA,NA,NA,NA
silence,439759,446938,7179,Japan,J20,NA,NA,NA,NA
silence,451197,458358,7161,Japan,J20,NA,NA,NA,NA
silence,463358,463698,340,Japan,J20,NA,NA,NA,NA
silence,464384,464925,541,Japan,J20,NA,NA,NA,NA
silence,466013,467907,1894,Japan,J20,NA,NA,NA,NA
silence,469049,469328,279,Japan,J20,NA,NA,NA,NA
silence,469665,477123,7458,Japan,J20,NA,NA,NA,NA
silence,478993,499301,20308,Japan,J20,NA,NA,NA,NA
silence,500086,502543,2457,Japan,J20,NA,NA,NA,NA
silence,503266,504754,1488,Japan,J20,NA,NA,NA,NA
silence,507580,507853,273,Japan,J20,NA,NA,NA,NA
silence,508301,515384,7083,Japan,J20,NA,NA,NA,NA
silence,518124,518919,795,Japan,J20,NA,NA,NA,NA
silence,524428,524716,288,Japan,J20,NA,NA,NA,NA
silence,525246,525262,16,Japan,J20,NA,NA,NA,NA
silence,525749,526207,458,Japan,J20,NA,NA,NA,NA
father,528207,528411,204,Japan,J20,m,NA,NA,a
silence,534875,534955,80,Japan,J20,NA,NA,NA,NA
silence,536019,536035,16,Japan,J20,NA,NA,NA,NA
silence,544301,545422,1121,Japan,J20,NA,NA,NA,NA
silence,551058,552823,1765,Japan,J20,NA,NA,NA,NA
silence,553950,554140,190,Japan,J20,NA,NA,NA,NA
silence,556201,556919,718,Japan,J20,NA,NA,NA,NA
silence,557358,558256,898,Japan,J20,NA,NA,NA,NA
silence,559834,562536,2702,Japan,J20,NA,NA,NA,NA
silence,566941,570716,3775,Japan,J20,NA,NA,NA,NA
silence,571339,572284,945,Japan,J20,NA,NA,NA,NA
silence,575269,585779,10510,Japan,J20,NA,NA,NA,NA
silence,586749,592308,5559,Japan,J20,NA,NA,NA,NA
mother,1828,2217,389,Japan,J21,c,1,1,a
mother,5414,6736,1322,Japan,J21,c,2,1,a
child,7690,8930,1240,Japan,J21,m,3,1,a
mother,8080,12828,4748,Japan,J21,c,3,2,a
father,13000,14409,1409,Japan,J21,b,4,1,i
child,15090,15497,407,Japan,J21,b,5,1,a
father,15679,16130,451,Japan,J21,c,5,2,q
mother,15791,16180,389,Japan,J21,c,5,3,q
child,16560,18572,2012,Japan,J21,f,5,4,q
father,18963,19767,804,Japan,J21,c,5,5,a
child,21380,22723,1343,Japan,J21,m,5,6,q
mother,22402,24711,2309,Japan,J21,c,5,7,a
mother,20723,22033,1310,Japan,J21,c,6,1,i
mother,24779,28791,4012,Japan,J21,c,6,2,a
child,26930,28040,1110,Japan,J21,b,6,3,a
father,27223,28828,1605,Japan,J21,b,6,4,a
mother,32359,33657,1298,Japan,J21,c,7,1,a
child,34203,36397,2194,Japan,J21,b,7,2,a
father,34291,34902,611,Japan,J21,c,7,3,a
mother,37056,40211,3155,Japan,J21,c,7,4,q
father,37155,38275,1120,Japan,J21,c,7,5,q
child,45311,45957,646,Japan,J21,m,7,6,a
mother,46443,47865,1422,Japan,J21,c,7,7,i
child,47225,49127,1902,Japan,J21,m,7,8,a
mother,48950,49731,781,Japan,J21,c,7,9,q
child,50520,51141,621,Japan,J21,c,7,10,a
mother,51244,51776,532,Japan,J21,c,7,11,a
father,51519,52598,1079,Japan,J21,m,7,12,a
mother,52803,54094,1291,Japan,J21,f,7,13,q
father,54019,54371,352,Japan,J21,m,7,14,a
mother,43118,44402,1284,Japan,J21,c,8,1,a
mother,57838,59687,1849,Japan,J21,f,9,1,a
mother,63611,64476,865,Japan,J21,f,9,2,a
child,64446,66483,2037,Japan,J21,b,9,3,a
mother,65945,71927,5982,Japan,J21,c,9,4,i
child,72492,73166,674,Japan,J21,m,9,5,a
mother,73532,76421,2889,Japan,J21,f,9,6,a
child,79556,80420,864,Japan,J21,f,9,7,a
mother,80529,83614,3085,Japan,J21,c,9,8,a
father,81415,82711,1296,Japan,J21,c,9,9,q
father,76439,77371,932,Japan,J21,c,10,1,i
mother,84433,86163,1730,Japan,J21,c,11,1,a
mother,89444,90110,666,Japan,J21,c,12,1,q
child,90270,90826,556,Japan,J21,m,12,2,a
mother,91039,91539,500,Japan,J21,c,12,3,q
mother,95421,97385,1964,Japan,J21,c,12,4,a
mother,99840,100310,470,Japan,J21,c,12,5,q
child,102448,103136,688,Japan,J21,m,12,6,a
mother,103327,105310,1983,Japan,J21,c,12,7,q
father,92760,93408,648,Japan,J21,b,13,1,a
father,112640,113574,934,Japan,J21,m,14,1,a
mother,114118,114853,735,Japan,J21,f,14,2,a
father,114790,115242,452,Japan,J21,m,14,3,a
child,117514,118677,1163,Japan,J21,b,15,1,a
father,119192,119640,448,Japan,J21,c,15,2,q
mother,119229,119596,367,Japan,J21,c,15,3,q
child,119593,120504,911,Japan,J21,b,15,4,a
father,120717,121473,756,Japan,J21,m,15,5,q
mother,121627,122014,387,Japan,J21,f,15,6,a
child,123274,124193,919,Japan,J21,b,15,7,a
father,124925,126082,1157,Japan,J21,m,16,1,q
mother,126427,126803,376,Japan,J21,f,16,2,a
father,127982,128588,606,Japan,J21,m,16,3,q
mother,128007,128704,697,Japan,J21,f,16,4,a
mother,129303,130349,1046,Japan,J21,f,16,5,q
father,130558,132137,1579,Japan,J21,m,16,6,a
child,133832,134407,575,Japan,J21,f,17,1,a
father,134243,135142,899,Japan,J21,c,17,2,q
child,136811,137772,961,Japan,J21,f,17,3,a
father,138248,139015,767,Japan,J21,c,17,4,q
child,139427,140808,1381,Japan,J21,f,17,5,a
father,142094,142966,872,Japan,J21,c,17,6,a
child,143289,144340,1051,Japan,J21,f,17,7,a
father,144129,145040,911,Japan,J21,c,17,8,q
father,146032,146799,767,Japan,J21,c,17,9,a
mother,147236,149236,2000,Japan,J21,c,17,10,a
father,157444,158337,893,Japan,J21,c,17,11,a
mother,158747,160379,1632,Japan,J21,c,17,12,q
child,161127,163127,2000,Japan,J21,m,17,13,a
mother,162674,165106,2432,Japan,J21,c,17,14,q
child,166544,166992,448,Japan,J21,m,17,15,a
mother,167131,168964,1833,Japan,J21,c,17,16,q
mother,145458,145964,506,Japan,J21,f,18,1,a
mother,169287,176818,7531,Japan,J21,c,19,1,a
child,178501,179250,749,Japan,J21,m,20,1,a
mother,178964,179477,513,Japan,J21,c,20,2,a
mother,185670,186399,729,Japan,J21,c,21,1,q
mother,189287,191610,2323,Japan,J21,c,21,2,a
child,197845,201274,3429,Japan,J21,b,22,1,a
mother,201964,202764,800,Japan,J21,m,22,2,a
mother,205478,205895,417,Japan,J21,c,23,1,a
child,206434,207052,618,Japan,J21,m,23,2,q
mother,210170,211728,1558,Japan,J21,c,23,3,i
mother,214279,217754,3475,Japan,J21,c,23,4,a
mother,220423,222828,2405,Japan,J21,c,24,1,a
mother,239520,240865,1345,Japan,J21,f,25,1,a
father,241045,244111,3066,Japan,J21,NA,25,2,a
mother,244803,245648,845,Japan,J21,f,25,3,q
father,245879,246742,863,Japan,J21,m,25,4,a
mother,246908,247439,531,Japan,J21,f,25,5,a
child,250722,251753,1031,Japan,J21,m,26,1,a
mother,251898,253610,1712,Japan,J21,c,26,2,i
child,254243,255907,1664,Japan,J21,m,26,3,a
mother,255887,256464,577,Japan,J21,c,26,4,a
mother,259090,259612,522,Japan,J21,c,26,5,a
father,259916,262044,2128,Japan,J21,c,26,6,a
mother,262605,263460,855,Japan,J21,c,26,7,a
father,263741,266519,2778,Japan,J21,c,26,8,q
mother,267137,268219,1082,Japan,J21,c,26,9,q
child,274265,274824,559,Japan,J21,o,26,10,a
father,275597,277384,1787,Japan,J21,c,26,11,a
mother,281144,286186,5042,Japan,J21,c,26,12,a
mother,303975,305056,1081,Japan,J21,c,27,1,a
mother,307659,308174,515,Japan,J21,c,27,2,a
father,311061,311808,747,Japan,J21,c,27,3,a
mother,312186,314519,2333,Japan,J21,c,27,4,i
child,314888,315299,411,Japan,J21,m,27,5,a
mother,315431,315972,541,Japan,J21,c,27,6,q
child,316133,316533,400,Japan,J21,m,27,7,a
mother,316544,317340,796,Japan,J21,c,27,8,a
father,318241,319433,1192,Japan,J21,c,27,9,a
mother,319501,319871,370,Japan,J21,f,27,10,a
father,321224,322544,1320,Japan,J21,c,27,11,q
mother,323366,324333,967,Japan,J21,c,27,12,q
child,324230,327839,3609,Japan,J21,b,28,1,a
mother,327519,340519,13000,Japan,J21,c,28,2,a
child,344262,345538,1276,Japan,J21,m,29,1,q
mother,345816,347175,1359,Japan,J21,c,29,2,q
child,347403,347863,460,Japan,J21,m,29,3,a
mother,348753,350316,1563,Japan,J21,c,29,4,a
mother,354445,355828,1383,Japan,J21,f,30,1,q
father,356252,356711,459,Japan,J21,m,30,2,a
mother,356851,359445,2594,Japan,J21,c,30,3,a
mother,361478,363512,2034,Japan,J21,c,30,4,a
child,363883,364222,339,Japan,J21,m,30,5,q
mother,364627,365494,867,Japan,J21,c,30,6,a
mother,366178,367390,1212,Japan,J21,c,31,1,a
father,368754,369921,1167,Japan,J21,c,31,2,a
mother,370461,375352,4891,Japan,J21,c,31,3,a
father,371027,371587,560,Japan,J21,c,31,4,a
mother,377705,385112,7407,Japan,J21,c,31,5,q
father,379573,383871,4298,Japan,J21,c,31,6,q
mother,402748,405513,2765,Japan,J21,c,31,7,i
father,406153,406476,323,Japan,J21,c,31,8,a
mother,408118,408998,880,Japan,J21,c,31,9,q
mother,415143,417671,2528,Japan,J21,c,32,1,q
child,419667,421023,1356,Japan,J21,m,32,2,a
mother,421064,421516,452,Japan,J21,c,32,3,q
father,424869,425869,1000,Japan,J21,m,33,1,q
mother,426155,430908,4753,Japan,J21,f,33,2,a
father,431200,432378,1178,Japan,J21,m,33,3,q
mother,432455,433224,769,Japan,J21,f,33,4,a
child,435917,436420,503,Japan,J21,m,34,1,a
mother,436976,438744,1768,Japan,J21,c,34,2,a
child,440831,443231,2400,Japan,J21,m,34,3,a
mother,441112,442915,1803,Japan,J21,c,34,4,a
mother,453470,455357,1887,Japan,J21,c,35,1,i
father,455594,456378,784,Japan,J21,c,35,2,i
father,460193,464828,4635,Japan,J21,NA,35,3,a
mother,462174,463314,1140,Japan,J21,c,35,4,i
child,470948,473532,2584,Japan,J21,b,36,1,a
mother,472129,474513,2384,Japan,J21,c,36,2,a
father,473544,474647,1103,Japan,J21,c,36,3,a
child,475581,476918,1337,Japan,J21,b,36,4,a
father,477128,477718,590,Japan,J21,c,36,5,a
child,480457,481839,1382,Japan,J21,b,36,6,a
mother,481873,482911,1038,Japan,J21,c,36,7,a
child,483366,484912,1546,Japan,J21,b,37,1,a
child,485645,486928,1283,Japan,J21,b,38,1,q
mother,487075,487538,463,Japan,J21,c,38,2,q
child,487724,488968,1244,Japan,J21,b,38,3,a
mother,489861,490391,530,Japan,J21,c,38,4,q
mother,492652,494526,1874,Japan,J21,c,39,1,q
child,495409,496010,601,Japan,J21,m,39,2,a
mother,496871,499207,2336,Japan,J21,c,39,3,q
father,498717,499829,1112,Japan,J21,c,39,4,i
mother,499900,503915,4015,Japan,J21,c,39,5,i
father,502266,503828,1562,Japan,J21,c,39,6,i
child,549180,549967,787,Japan,J21,b,40,1,a
mother,550130,552803,2673,Japan,J21,c,40,2,a
child,555380,556200,820,Japan,J21,m,40,3,a
mother,556282,556802,520,Japan,J21,c,40,4,a
father,556328,557291,963,Japan,J21,c,40,5,a
child,557354,558712,1358,Japan,J21,b,40,6,a
mother,558816,559278,462,Japan,J21,c,40,7,a
child,559460,560952,1492,Japan,J21,m,40,8,a
mother,560797,561600,803,Japan,J21,c,40,9,a
mother,572109,572544,435,Japan,J21,c,41,1,a
mother,574859,576450,1591,Japan,J21,c,42,1,q
father,575773,577638,1865,Japan,J21,c,42,2,a
mother,578050,580279,2229,Japan,J21,c,42,3,a
mother,583785,584143,358,Japan,J21,c,42,4,a
mother,587303,594112,6809,Japan,J21,c,42,5,a
father,592177,592639,462,Japan,J21,c,42,6,a
mother,597553,599717,2164,Japan,J21,c,42,7,a
father,598358,598816,458,Japan,J21,c,42,8,a
child,56718,59010,2292,Japan,J21,m,43,1,a
mother,150312,154303,3991,Japan,J21,o,44,1,a
father,520816,521933,1117,Japan,J21,m,44,2,q
mother,522057,525600,3543,Japan,J21,f,44,3,a
father,525692,526106,414,Japan,J21,m,44,4,a
child,532542,533459,917,Japan,J21,m,44,5,q
mother,533429,535766,2337,Japan,J21,c,44,6,a
child,534642,537152,2510,Japan,J21,m,44,7,q
mother,546365,547908,1543,Japan,J21,m,44,8,a
father,1143,1795,652,Japan,J21,b,NA,NA,i
silence,1795,1828,33,Japan,J21,NA,NA,NA,NA
silence,2217,5414,3197,Japan,J21,NA,NA,NA,NA
silence,6736,7690,954,Japan,J21,NA,NA,NA,NA
silence,12828,13000,172,Japan,J21,NA,NA,NA,NA
silence,14409,15090,681,Japan,J21,NA,NA,NA,NA
silence,15497,15679,182,Japan,J21,NA,NA,NA,NA
silence,16180,16560,380,Japan,J21,NA,NA,NA,NA
silence,18572,18963,391,Japan,J21,NA,NA,NA,NA
silence,19767,20723,956,Japan,J21,NA,NA,NA,NA
silence,24711,24779,68,Japan,J21,NA,NA,NA,NA
silence,28828,28913,85,Japan,J21,NA,NA,NA,NA
child,28913,32366,3453,Japan,J21,b,NA,NA,a
child_gesture,29058,35605,6547,Japan,J21,NA,NA,NA,NA
silence,33657,34203,546,Japan,J21,NA,NA,NA,NA
silence,36397,37056,659,Japan,J21,NA,NA,NA,NA
silence,40211,41937,1726,Japan,J21,NA,NA,NA,NA
child,41937,43354,1417,Japan,J21,b,NA,NA,a
mother_gesture,42928,44408,1480,Japan,J21,NA,NA,NA,NA
silence,44402,45311,909,Japan,J21,NA,NA,NA,NA
silence,45957,46443,486,Japan,J21,NA,NA,NA,NA
silence,49731,50520,789,Japan,J21,NA,NA,NA,NA
silence,51141,51244,103,Japan,J21,NA,NA,NA,NA
silence,52598,52803,205,Japan,J21,NA,NA,NA,NA
silence,54371,56718,2347,Japan,J21,NA,NA,NA,NA
mother_gesture,58519,60143,1624,Japan,J21,NA,NA,NA,NA
silence,59687,63611,3924,Japan,J21,NA,NA,NA,NA
child_gesture,64458,67031,2573,Japan,J21,NA,NA,NA,NA
silence,71927,72492,565,Japan,J21,NA,NA,NA,NA
silence,73166,73532,366,Japan,J21,NA,NA,NA,NA
silence,76421,76439,18,Japan,J21,NA,NA,NA,NA
silence,77371,79556,2185,Japan,J21,NA,NA,NA,NA
silence,80420,80529,109,Japan,J21,NA,NA,NA,NA
silence,83614,84433,819,Japan,J21,NA,NA,NA,NA
mother_gesture,84433,85970,1537,Japan,J21,NA,NA,NA,NA
silence,86163,89444,3281,Japan,J21,NA,NA,NA,NA
mother_gesture,86205,87627,1422,Japan,J21,NA,NA,NA,NA
silence,90110,90270,160,Japan,J21,NA,NA,NA,NA
silence,90826,91039,213,Japan,J21,NA,NA,NA,NA
silence,91539,92760,1221,Japan,J21,NA,NA,NA,NA
silence,93408,95421,2013,Japan,J21,NA,NA,NA,NA
silence,97385,99840,2455,Japan,J21,NA,NA,NA,NA
silence,100310,102448,2138,Japan,J21,NA,NA,NA,NA
child_gesture,102439,104847,2408,Japan,J21,NA,NA,NA,NA
silence,103136,103327,191,Japan,J21,NA,NA,NA,NA
silence,105310,112640,7330,Japan,J21,NA,NA,NA,NA
silence,113574,114118,544,Japan,J21,NA,NA,NA,NA
silence,115242,117514,2272,Japan,J21,NA,NA,NA,NA
child_gesture,117469,120322,2853,Japan,J21,NA,NA,NA,NA
silence,118677,119192,515,Japan,J21,NA,NA,NA,NA
silence,120504,120717,213,Japan,J21,NA,NA,NA,NA
child_gesture,120655,121540,885,Japan,J21,NA,NA,NA,NA
silence,121473,121627,154,Japan,J21,NA,NA,NA,NA
silence,122014,123274,1260,Japan,J21,NA,NA,NA,NA
silence,124193,124925,732,Japan,J21,NA,NA,NA,NA
father_gesture,124812,126420,1608,Japan,J21,NA,NA,NA,NA
silence,126082,126427,345,Japan,J21,NA,NA,NA,NA
silence,126803,127982,1179,Japan,J21,NA,NA,NA,NA
silence,128704,129303,599,Japan,J21,NA,NA,NA,NA
silence,130349,130558,209,Japan,J21,NA,NA,NA,NA
silence,132137,133832,1695,Japan,J21,NA,NA,NA,NA
silence,135142,136811,1669,Japan,J21,NA,NA,NA,NA
silence,137772,138248,476,Japan,J21,NA,NA,NA,NA
silence,139015,139427,412,Japan,J21,NA,NA,NA,NA
child_gesture,139970,141185,1215,Japan,J21,NA,NA,NA,NA
silence,140808,142094,1286,Japan,J21,NA,NA,NA,NA
silence,142966,143289,323,Japan,J21,NA,NA,NA,NA
silence,145040,145458,418,Japan,J21,NA,NA,NA,NA
silence,145964,146032,68,Japan,J21,NA,NA,NA,NA
silence,146799,147236,437,Japan,J21,NA,NA,NA,NA
silence,149236,150312,1076,Japan,J21,NA,NA,NA,NA
silence,154303,157444,3141,Japan,J21,NA,NA,NA,NA
silence,158337,158747,410,Japan,J21,NA,NA,NA,NA
mother_gesture,158747,160361,1614,Japan,J21,NA,NA,NA,NA
silence,160379,161127,748,Japan,J21,NA,NA,NA,NA
mother_gesture,162470,163549,1079,Japan,J21,NA,NA,NA,NA
mother_gesture,164100,166229,2129,Japan,J21,NA,NA,NA,NA
silence,165106,166544,1438,Japan,J21,NA,NA,NA,NA
silence,166992,167131,139,Japan,J21,NA,NA,NA,NA
mother_gesture,167064,168158,1094,Japan,J21,NA,NA,NA,NA
child_gesture,167143,169023,1880,Japan,J21,NA,NA,NA,NA
silence,168964,169287,323,Japan,J21,NA,NA,NA,NA
silence,176818,178501,1683,Japan,J21,NA,NA,NA,NA
silence,179477,185670,6193,Japan,J21,NA,NA,NA,NA
silence,186399,189287,2888,Japan,J21,NA,NA,NA,NA
silence,191610,197845,6235,Japan,J21,NA,NA,NA,NA
silence,201274,201964,690,Japan,J21,NA,NA,NA,NA
silence,202764,205478,2714,Japan,J21,NA,NA,NA,NA
silence,205895,206434,539,Japan,J21,NA,NA,NA,NA
silence,207052,210170,3118,Japan,J21,NA,NA,NA,NA
silence,211728,214279,2551,Japan,J21,NA,NA,NA,NA
silence,217754,220423,2669,Japan,J21,NA,NA,NA,NA
mother_gesture,220418,222615,2197,Japan,J21,NA,NA,NA,NA
silence,222828,239520,16692,Japan,J21,NA,NA,NA,NA
silence,240865,241045,180,Japan,J21,NA,NA,NA,NA
father_gesture,243174,245834,2660,Japan,J21,NA,NA,NA,NA
silence,244111,244803,692,Japan,J21,NA,NA,NA,NA
silence,245648,245879,231,Japan,J21,NA,NA,NA,NA
silence,246742,246908,166,Japan,J21,NA,NA,NA,NA
silence,247439,250722,3283,Japan,J21,NA,NA,NA,NA
child_gesture,249297,256161,6864,Japan,J21,NA,NA,NA,NA
silence,251753,251898,145,Japan,J21,NA,NA,NA,NA
silence,253610,254243,633,Japan,J21,NA,NA,NA,NA
silence,256464,259090,2626,Japan,J21,NA,NA,NA,NA
silence,259612,259916,304,Japan,J21,NA,NA,NA,NA
silence,262044,262605,561,Japan,J21,NA,NA,NA,NA
silence,263460,263741,281,Japan,J21,NA,NA,NA,NA
silence,266519,267137,618,Japan,J21,NA,NA,NA,NA
silence,268219,274265,6046,Japan,J21,NA,NA,NA,NA
silence,274824,275597,773,Japan,J21,NA,NA,NA,NA
silence,277384,281144,3760,Japan,J21,NA,NA,NA,NA
silence,286186,303975,17789,Japan,J21,NA,NA,NA,NA
silence,305056,307659,2603,Japan,J21,NA,NA,NA,NA
silence,308174,311061,2887,Japan,J21,NA,NA,NA,NA
silence,311808,312186,378,Japan,J21,NA,NA,NA,NA
silence,314519,314888,369,Japan,J21,NA,NA,NA,NA
silence,315299,315431,132,Japan,J21,NA,NA,NA,NA
silence,315972,316133,161,Japan,J21,NA,NA,NA,NA
silence,316533,316544,11,Japan,J21,NA,NA,NA,NA
silence,317340,318241,901,Japan,J21,NA,NA,NA,NA
silence,319433,319501,68,Japan,J21,NA,NA,NA,NA
silence,319871,321224,1353,Japan,J21,NA,NA,NA,NA
silence,322544,323366,822,Japan,J21,NA,NA,NA,NA
silence,340519,344262,3743,Japan,J21,NA,NA,NA,NA
silence,345538,345816,278,Japan,J21,NA,NA,NA,NA
silence,347175,347403,228,Japan,J21,NA,NA,NA,NA
silence,347863,348753,890,Japan,J21,NA,NA,NA,NA
silence,350316,354445,4129,Japan,J21,NA,NA,NA,NA
silence,355828,356252,424,Japan,J21,NA,NA,NA,NA
silence,356711,356851,140,Japan,J21,NA,NA,NA,NA
silence,359445,361478,2033,Japan,J21,NA,NA,NA,NA
silence,363512,363883,371,Japan,J21,NA,NA,NA,NA
child_gesture,363763,365658,1895,Japan,J21,NA,NA,NA,NA
silence,364222,364627,405,Japan,J21,NA,NA,NA,NA
silence,365494,366178,684,Japan,J21,NA,NA,NA,NA
silence,367390,368754,1364,Japan,J21,NA,NA,NA,NA
silence,369921,370461,540,Japan,J21,NA,NA,NA,NA
silence,375352,377705,2353,Japan,J21,NA,NA,NA,NA
silence,385112,402748,17636,Japan,J21,NA,NA,NA,NA
child_gesture,402017,404300,2283,Japan,J21,NA,NA,NA,NA
silence,405513,406153,640,Japan,J21,NA,NA,NA,NA
silence,406476,408118,1642,Japan,J21,NA,NA,NA,NA
silence,408998,415143,6145,Japan,J21,NA,NA,NA,NA
silence,417671,419667,1996,Japan,J21,NA,NA,NA,NA
silence,421023,421064,41,Japan,J21,NA,NA,NA,NA
silence,421516,424869,3353,Japan,J21,NA,NA,NA,NA
silence,425869,426155,286,Japan,J21,NA,NA,NA,NA
silence,430908,431200,292,Japan,J21,NA,NA,NA,NA
silence,432378,432455,77,Japan,J21,NA,NA,NA,NA
silence,433224,435917,2693,Japan,J21,NA,NA,NA,NA
child_gesture,435603,436773,1170,Japan,J21,NA,NA,NA,NA
silence,436420,436976,556,Japan,J21,NA,NA,NA,NA
silence,438744,440831,2087,Japan,J21,NA,NA,NA,NA
silence,443231,453470,10239,Japan,J21,NA,NA,NA,NA
silence,455357,455594,237,Japan,J21,NA,NA,NA,NA
silence,456378,460193,3815,Japan,J21,NA,NA,NA,NA
father_gesture,460997,463981,2984,Japan,J21,NA,NA,NA,NA
father_gesture,464026,465295,1269,Japan,J21,NA,NA,NA,NA
silence,464828,470948,6120,Japan,J21,NA,NA,NA,NA
silence,474647,475581,934,Japan,J21,NA,NA,NA,NA
silence,476918,477128,210,Japan,J21,NA,NA,NA,NA
silence,477718,480457,2739,Japan,J21,NA,NA,NA,NA
silence,481839,481873,34,Japan,J21,NA,NA,NA,NA
silence,482911,483366,455,Japan,J21,NA,NA,NA,NA
silence,484912,485645,733,Japan,J21,NA,NA,NA,NA
silence,486928,487075,147,Japan,J21,NA,NA,NA,NA
silence,487538,487724,186,Japan,J21,NA,NA,NA,NA
silence,488968,489861,893,Japan,J21,NA,NA,NA,NA
silence,490391,492652,2261,Japan,J21,NA,NA,NA,NA
silence,494526,495409,883,Japan,J21,NA,NA,NA,NA
silence,496010,496871,861,Japan,J21,NA,NA,NA,NA
silence,499829,499900,71,Japan,J21,NA,NA,NA,NA
silence,503915,520816,16901,Japan,J21,NA,NA,NA,NA
silence,521933,522057,124,Japan,J21,NA,NA,NA,NA
silence,525600,525692,92,Japan,J21,NA,NA,NA,NA
silence,526106,532542,6436,Japan,J21,NA,NA,NA,NA
silence,537152,546365,9213,Japan,J21,NA,NA,NA,NA
silence,547908,549180,1272,Japan,J21,NA,NA,NA,NA
silence,549967,550130,163,Japan,J21,NA,NA,NA,NA
silence,552803,555380,2577,Japan,J21,NA,NA,NA,NA
silence,556200,556282,82,Japan,J21,NA,NA,NA,NA
silence,557291,557354,63,Japan,J21,NA,NA,NA,NA
silence,558712,558816,104,Japan,J21,NA,NA,NA,NA
silence,559278,559460,182,Japan,J21,NA,NA,NA,NA
silence,561600,572109,10509,Japan,J21,NA,NA,NA,NA
mother_gesture,571435,573222,1787,Japan,J21,NA,NA,NA,NA
silence,572544,574859,2315,Japan,J21,NA,NA,NA,NA
silence,577638,578050,412,Japan,J21,NA,NA,NA,NA
silence,580279,583785,3506,Japan,J21,NA,NA,NA,NA
silence,584143,587303,3160,Japan,J21,NA,NA,NA,NA
silence,594112,597553,3441,Japan,J21,NA,NA,NA,NA
mother,326,1122,796,Japan,J22,f,1,1,a
father,1335,4319,2984,Japan,J22,m,1,2,q
mother,4273,5153,880,Japan,J22,f,1,3,a
father,5223,6333,1110,Japan,J22,m,1,4,a
mother,6083,8777,2694,Japan,J22,f,1,5,a
father,7683,11003,3320,Japan,J22,m,1,6,a
mother,10594,12728,2134,Japan,J22,f,1,7,a
father,12585,15118,2533,Japan,J22,m,1,8,q
child,8713,10173,1460,Japan,J22,b,2,1,a
child,12214,16557,4343,Japan,J22,b,2,2,a
mother,17364,19015,1651,Japan,J22,c,2,3,a
child,21135,22359,1224,Japan,J22,b,2,4,a
father,19009,20110,1101,Japan,J22,c,3,1,q
mother,20330,21054,724,Japan,J22,f,3,2,a
mother,22518,25347,2829,Japan,J22,f,3,3,q
mother,26626,28584,1958,Japan,J22,f,3,4,a
father,28667,29866,1199,Japan,J22,m,3,5,a
mother,29187,30196,1009,Japan,J22,f,3,6,a
father,33430,36369,2939,Japan,J22,m,3,7,a
mother,35375,36430,1055,Japan,J22,f,3,8,a
mother,38064,38610,546,Japan,J22,c,3,9,a
child,39412,41373,1961,Japan,J22,f,4,1,a
mother,41596,42949,1353,Japan,J22,NA,4,2,a
father,41819,42117,298,Japan,J22,c,4,3,a
mother,43143,44634,1491,Japan,J22,c,5,1,q
child,45880,46399,519,Japan,J22,m,5,2,a
mother,46828,56866,10038,Japan,J22,c,5,3,a
father,56933,57597,664,Japan,J22,b,6,1,a
mother,58647,64656,6009,Japan,J22,f,7,1,a
father,60971,61270,299,Japan,J22,m,7,2,a
father,62087,62358,271,Japan,J22,m,7,3,a
father,64565,65794,1229,Japan,J22,m,7,4,q
mother,65578,67148,1570,Japan,J22,f,7,5,a
father,67333,68121,788,Japan,J22,m,7,6,a
mother,70531,73743,3212,Japan,J22,f,7,7,a
father,73194,73570,376,Japan,J22,m,7,8,a
father,74966,75907,941,Japan,J22,m,7,9,q
father,68609,70476,1867,Japan,J22,c,8,1,a
child,73246,76176,2930,Japan,J22,f,8,2,a
mother,76441,79105,2664,Japan,J22,c,8,3,a
child,79004,81962,2958,Japan,J22,f,8,4,a
father,79049,80662,1613,Japan,J22,o,9,1,a
father,82840,83516,676,Japan,J22,o,9,2,a
mother,83503,85618,2115,Japan,J22,f,9,3,a
father,85640,86270,630,Japan,J22,m,9,4,a
child,83806,86971,3165,Japan,J22,m,10,1,a
mother,87215,88348,1133,Japan,J22,c,10,2,q
child,88490,91185,2695,Japan,J22,m,10,3,a
mother,91223,92314,1091,Japan,J22,c,10,4,q
child,92353,92667,314,Japan,J22,m,10,5,a
mother,92498,93236,738,Japan,J22,c,10,6,a
child,95242,98783,3541,Japan,J22,m,10,7,a
father,99115,101966,2851,Japan,J22,m,11,1,q
mother,100535,100928,393,Japan,J22,f,11,2,a
father,102930,104667,1737,Japan,J22,m,13,1,q
mother,104881,106137,1256,Japan,J22,f,13,2,q
father,107395,110170,2775,Japan,J22,m,13,3,a
mother,110148,111855,1707,Japan,J22,f,13,4,a
child,106695,109231,2536,Japan,J22,b,14,1,a
father,110277,112020,1743,Japan,J22,c,15,1,a
child,111203,113148,1945,Japan,J22,f,16,1,a
father,113118,115098,1980,Japan,J22,c,16,2,a
mother,113435,115157,1722,Japan,J22,c,16,3,a
child,116200,117087,887,Japan,J22,f,16,4,i
father,116971,117745,774,Japan,J22,c,16,5,a
mother,117679,119205,1526,Japan,J22,f,16,6,a
father,119293,123533,4240,Japan,J22,m,16,7,a
mother,123931,127463,3532,Japan,J22,c,17,1,i
father,128862,130546,1684,Japan,J22,c,17,2,a
mother,130455,131588,1133,Japan,J22,c,17,3,a
child,124264,127887,3623,Japan,J22,m,18,1,a
mother,128198,128476,278,Japan,J22,c,18,2,a
child,132572,134463,1891,Japan,J22,m,19,1,q
mother,133904,134286,382,Japan,J22,c,19,2,q
mother,134463,136073,1610,Japan,J22,c,19,3,q
father,136570,138004,1434,Japan,J22,c,19,4,a
child,138457,138974,517,Japan,J22,f,19,5,a
mother,138775,139789,1014,Japan,J22,c,19,6,a
father,139004,140231,1227,Japan,J22,c,19,7,a
mother,140391,141977,1586,Japan,J22,c,19,8,i
child,145722,149562,3840,Japan,J22,m,19,9,a
mother,151157,153496,2339,Japan,J22,c,19,10,a
child,157739,158678,939,Japan,J22,m,19,11,i
mother,158464,159454,990,Japan,J22,c,19,12,a
father,143192,149463,6271,Japan,J22,m,20,1,a
father,151794,157728,5934,Japan,J22,m,20,2,q
mother,161242,162115,873,Japan,J22,f,20,3,q
father,161821,162830,1009,Japan,J22,m,20,4,a
child,171716,172207,491,Japan,J22,b,20,5,a
father,172363,172700,337,Japan,J22,c,20,6,a
mother,172706,173872,1166,Japan,J22,f,20,7,a
father,174245,175131,886,Japan,J22,m,20,8,q
mother,175021,175524,503,Japan,J22,f,20,9,a
father,176117,177867,1750,Japan,J22,m,20,10,a
mother,177281,178137,856,Japan,J22,f,20,11,a
father,178374,180717,2343,Japan,J22,m,20,12,a
mother,180846,181341,495,Japan,J22,f,20,13,a
father,181711,182435,724,Japan,J22,m,20,14,q
mother,183772,184225,453,Japan,J22,f,20,15,a
father,184573,185818,1245,Japan,J22,m,20,16,q
mother,186165,188772,2607,Japan,J22,f,20,17,a
father,188936,189623,687,Japan,J22,NA,20,18,q
mother,189579,189905,326,Japan,J22,f,20,19,a
father,190529,191425,896,Japan,J22,m,20,20,a
father,196645,197214,569,Japan,J22,m,20,21,q
mother,197483,199543,2060,Japan,J22,f,20,22,a
father,198419,198800,381,Japan,J22,m,20,23,a
father,200551,201559,1008,Japan,J22,o,20,24,a
mother,163535,170761,7226,Japan,J22,c,21,1,a
child,201364,202722,1358,Japan,J22,m,22,1,a
mother,202712,204877,2165,Japan,J22,c,22,2,a
child,206292,207153,861,Japan,J22,m,22,3,q
father,210330,210630,300,Japan,J22,m,23,1,a
mother,212219,213261,1042,Japan,J22,f,23,2,a
father,213518,214446,928,Japan,J22,m,23,3,a
mother,213918,216211,2293,Japan,J22,o,23,4,a
father,215403,218001,2598,Japan,J22,m,23,5,q
father,221613,223938,2325,Japan,J22,m,23,6,q
mother,225361,229154,3793,Japan,J22,f,23,7,a
father,229806,233601,3795,Japan,J22,m,23,8,a
mother,233033,234020,987,Japan,J22,f,23,9,a
father,234043,234734,691,Japan,J22,m,23,10,a
mother,217364,219901,2537,Japan,J22,c,24,1,i
mother,236562,237977,1415,Japan,J22,f,25,1,a
father,237971,240170,2199,Japan,J22,m,25,2,a
mother,243535,243926,391,Japan,J22,f,25,3,a
mother,245551,246451,900,Japan,J22,f,25,4,q
father,246478,246842,364,Japan,J22,m,25,5,a
father,240822,245623,4801,Japan,J22,m,26,1,a
mother,248096,251043,2947,Japan,J22,m,26,2,a
mother,253340,254656,1316,Japan,J22,c,26,3,a
father,251054,255236,4182,Japan,J22,m,27,1,a
mother,256949,258043,1094,Japan,J22,f,27,2,q
father,258557,261353,2796,Japan,J22,m,27,3,a
father,265239,268070,2831,Japan,J22,m,27,4,q
father,268480,268822,342,Japan,J22,m,27,5,a
child,261662,264547,2885,Japan,J22,o,28,1,a
child,269457,270971,1514,Japan,J22,m,29,1,i
mother,271060,272297,1237,Japan,J22,c,29,2,a
mother,276620,277859,1239,Japan,J22,c,29,3,a
child,279347,280972,1625,Japan,J22,c,29,4,a
mother,281861,284982,3121,Japan,J22,f,29,5,q
father,285012,285227,215,Japan,J22,m,29,6,q
mother,286662,290658,3996,Japan,J22,f,29,7,a
father,290822,292263,1441,Japan,J22,m,29,8,a
mother,292728,293529,801,Japan,J22,f,29,9,a
father,293498,297855,4357,Japan,J22,m,29,10,i
mother,298242,299348,1106,Japan,J22,f,29,11,a
father,299013,300525,1512,Japan,J22,m,29,12,i
child,302299,303476,1177,Japan,J22,NA,29,13,a
father,303893,305726,1833,Japan,J22,c,29,14,i
mother,306612,308001,1389,Japan,J22,o,29,15,a
father,311430,311968,538,Japan,J22,m,29,16,a
mother,312143,316116,3973,Japan,J22,f,29,17,a
father,316582,316994,412,Japan,J22,m,29,18,q
mother,317082,319143,2061,Japan,J22,f,29,19,a
father,319652,320626,974,Japan,J22,m,29,20,q
mother,320557,322289,1732,Japan,J22,f,29,21,a
mother,324253,330146,5893,Japan,J22,f,29,22,a
father,331165,340220,9055,Japan,J22,m,29,23,a
father,346734,347916,1182,Japan,J22,m,29,24,a
mother,347949,348592,643,Japan,J22,f,29,25,a
father,352651,354971,2320,Japan,J22,b,29,26,a
father,360143,361170,1027,Japan,J22,c,29,27,i
father,368463,374159,5696,Japan,J22,m,29,28,a
father,377360,382624,5264,Japan,J22,m,29,29,a
mother,382800,383412,612,Japan,J22,f,29,30,a
father,383488,392574,9086,Japan,J22,m,29,31,a
mother,387060,387955,895,Japan,J22,f,29,32,a
mother,389521,389938,417,Japan,J22,f,29,33,a
mother,390943,391392,449,Japan,J22,NA,29,34,a
father,393176,394787,1611,Japan,J22,c,29,35,a
mother,399110,400121,1011,Japan,J22,c,29,36,a
child,400518,400866,348,Japan,J22,m,29,37,a
mother,401148,401993,845,Japan,J22,NA,29,38,q
child,402181,403548,1367,Japan,J22,m,29,39,a
mother,403971,406888,2917,Japan,J22,c,29,40,a
child,409059,410531,1472,Japan,J22,m,29,41,a
mother,410680,412474,1794,Japan,J22,c,29,42,i
father,277137,278319,1182,Japan,J22,m,30,1,a
father,416325,417287,962,Japan,J22,c,31,1,a
father,418719,420623,1904,Japan,J22,c,32,1,i
father,423160,423563,403,Japan,J22,c,32,2,a
child,424353,426004,1651,Japan,J22,m,32,3,a
mother,426154,427755,1601,Japan,J22,c,32,4,a
father,429043,432386,3343,Japan,J22,c,33,1,a
mother,432723,436159,3436,Japan,J22,c,33,2,a
child,436866,437877,1011,Japan,J22,f,33,3,a
father,439137,440041,904,Japan,J22,c,33,4,a
mother,445905,451960,6055,Japan,J22,f,34,1,a
father,447839,448193,354,Japan,J22,m,34,2,a
mother,453185,455992,2807,Japan,J22,f,34,3,a
father,456863,457280,417,Japan,J22,m,34,4,a
mother,457854,459695,1841,Japan,J22,f,34,5,a
mother,465568,467502,1934,Japan,J22,c,34,6,a
child,458354,459276,922,Japan,J22,f,35,1,a
father,459889,461971,2082,Japan,J22,c,35,2,i
child,465817,467537,1720,Japan,J22,f,36,1,q
father,467938,472684,4746,Japan,J22,c,36,2,a
father,473772,474276,504,Japan,J22,o,36,3,a
mother,475800,477024,1224,Japan,J22,f,37,1,a
father,476902,477859,957,Japan,J22,m,37,2,NA
mother,480079,487452,7373,Japan,J22,f,37,3,a
father,483325,484582,1257,Japan,J22,m,37,4,a
father,487117,487391,274,Japan,J22,m,37,5,a
father,488635,489870,1235,Japan,J22,m,37,6,a
father,491341,498601,7260,Japan,J22,m,38,1,a
mother,498684,499452,768,Japan,J22,NA,38,2,a
father,499317,511521,12204,Japan,J22,m,38,3,a
mother,501071,501469,398,Japan,J22,f,38,4,a
mother,506778,507237,459,Japan,J22,f,38,5,a
mother,511756,512728,972,Japan,J22,f,38,6,a
father,512496,530275,17779,Japan,J22,m,38,7,a
mother,515585,515993,408,Japan,J22,f,38,8,a
mother,526325,526634,309,Japan,J22,m,38,9,a
mother,530178,531078,900,Japan,J22,m,38,10,a
father,531109,552082,20973,Japan,J22,m,38,11,a
father,552507,573761,21254,Japan,J22,m,38,12,a
mother,567177,567831,654,Japan,J22,f,38,13,a
mother,573684,574574,890,Japan,J22,f,38,14,a
father,574396,577104,2708,Japan,J22,m,38,15,a
mother,577203,577800,597,Japan,J22,f,38,16,a
father,580029,586645,6616,Japan,J22,m,38,17,a
mother,586485,588177,1692,Japan,J22,f,38,18,a
mother,519358,521022,1664,Japan,J22,c,39,1,i
child,524664,525933,1269,Japan,J22,m,39,2,a
child,588221,590137,1916,Japan,J22,b,40,1,a
mother,590413,591043,630,Japan,J22,c,40,2,q
father,591065,592933,1868,Japan,J22,c,40,3,q
mother,596365,597076,711,Japan,J22,f,41,1,a
father,596997,597365,368,Japan,J22,m,41,2,a
silence,1122,1335,213,Japan,J22,NA,NA,NA,NA
silence,5153,5223,70,Japan,J22,NA,NA,NA,NA
silence,16557,17364,807,Japan,J22,NA,NA,NA,NA
silence,20110,20330,220,Japan,J22,NA,NA,NA,NA
silence,21054,21135,81,Japan,J22,NA,NA,NA,NA
silence,22359,22518,159,Japan,J22,NA,NA,NA,NA
silence,25347,26626,1279,Japan,J22,NA,NA,NA,NA
mother_gesture,26623,28422,1799,Japan,J22,NA,NA,NA,NA
silence,28584,28667,83,Japan,J22,NA,NA,NA,NA
mother_gesture,29170,30442,1272,Japan,J22,NA,NA,NA,NA
silence,30196,33430,3234,Japan,J22,NA,NA,NA,NA
silence,36430,38064,1634,Japan,J22,NA,NA,NA,NA
silence,38610,39412,802,Japan,J22,NA,NA,NA,NA
silence,41373,41596,223,Japan,J22,NA,NA,NA,NA
silence,42949,43143,194,Japan,J22,NA,NA,NA,NA
silence,44634,45880,1246,Japan,J22,NA,NA,NA,NA
silence,46399,46828,429,Japan,J22,NA,NA,NA,NA
silence,56866,56933,67,Japan,J22,NA,NA,NA,NA
silence,57597,58647,1050,Japan,J22,NA,NA,NA,NA
silence,67148,67333,185,Japan,J22,NA,NA,NA,NA
silence,68121,68609,488,Japan,J22,NA,NA,NA,NA
silence,70476,70531,55,Japan,J22,NA,NA,NA,NA
silence,76176,76441,265,Japan,J22,NA,NA,NA,NA
silence,81962,82840,878,Japan,J22,NA,NA,NA,NA
silence,86971,87215,244,Japan,J22,NA,NA,NA,NA
silence,88348,88490,142,Japan,J22,NA,NA,NA,NA
silence,91185,91223,38,Japan,J22,NA,NA,NA,NA
silence,92314,92353,39,Japan,J22,NA,NA,NA,NA
mother_gesture,92422,93296,874,Japan,J22,NA,NA,NA,NA
silence,93236,95242,2006,Japan,J22,NA,NA,NA,NA
silence,98783,99115,332,Japan,J22,NA,NA,NA,NA
child,101597,106264,4667,Japan,J22,b,NA,NA,a
silence,106264,106695,431,Japan,J22,NA,NA,NA,NA
child_gesture,106699,109115,2416,Japan,J22,NA,NA,NA,NA
child_gesture,110916,112095,1179,Japan,J22,NA,NA,NA,NA
child_gesture,112325,114828,2503,Japan,J22,NA,NA,NA,NA
father_gesture,113128,115150,2022,Japan,J22,NA,NA,NA,NA
mother_gesture,113449,115814,2365,Japan,J22,NA,NA,NA,NA
silence,115157,116200,1043,Japan,J22,NA,NA,NA,NA
silence,119205,119293,88,Japan,J22,NA,NA,NA,NA
silence,123533,123931,398,Japan,J22,NA,NA,NA,NA
silence,127887,128198,311,Japan,J22,NA,NA,NA,NA
silence,128476,128862,386,Japan,J22,NA,NA,NA,NA
silence,131588,132572,984,Japan,J22,NA,NA,NA,NA
silence,136073,136570,497,Japan,J22,NA,NA,NA,NA
silence,138004,138457,453,Japan,J22,NA,NA,NA,NA
silence,140231,140391,160,Japan,J22,NA,NA,NA,NA
silence,141977,143192,1215,Japan,J22,NA,NA,NA,NA
silence,149562,151157,1595,Japan,J22,NA,NA,NA,NA
silence,157728,157739,11,Japan,J22,NA,NA,NA,NA
silence,159454,159785,331,Japan,J22,NA,NA,NA,NA
father,159785,161314,1529,Japan,J22,m,NA,NA,a
silence,162830,163535,705,Japan,J22,NA,NA,NA,NA
silence,170761,171716,955,Japan,J22,NA,NA,NA,NA
silence,172207,172363,156,Japan,J22,NA,NA,NA,NA
silence,172700,172706,6,Japan,J22,NA,NA,NA,NA
silence,173872,174245,373,Japan,J22,NA,NA,NA,NA
silence,175524,176117,593,Japan,J22,NA,NA,NA,NA
silence,178137,178374,237,Japan,J22,NA,NA,NA,NA
silence,180717,180846,129,Japan,J22,NA,NA,NA,NA
silence,181341,181711,370,Japan,J22,NA,NA,NA,NA
silence,182435,183772,1337,Japan,J22,NA,NA,NA,NA
silence,184225,184573,348,Japan,J22,NA,NA,NA,NA
silence,185818,186165,347,Japan,J22,NA,NA,NA,NA
silence,188772,188936,164,Japan,J22,NA,NA,NA,NA
silence,189905,190529,624,Japan,J22,NA,NA,NA,NA
silence,191425,196645,5220,Japan,J22,NA,NA,NA,NA
silence,197214,197483,269,Japan,J22,NA,NA,NA,NA
silence,199543,200551,1008,Japan,J22,NA,NA,NA,NA
mother_gesture,203198,204925,1727,Japan,J22,NA,NA,NA,NA
silence,204877,206292,1415,Japan,J22,NA,NA,NA,NA
child_gesture,206292,207608,1316,Japan,J22,NA,NA,NA,NA
silence,207153,207457,304,Japan,J22,NA,NA,NA,NA
mother,207457,208900,1443,Japan,J22,c,NA,NA,a
silence,208900,210330,1430,Japan,J22,NA,NA,NA,NA
silence,210630,212219,1589,Japan,J22,NA,NA,NA,NA
silence,213261,213518,257,Japan,J22,NA,NA,NA,NA
silence,219901,221613,1712,Japan,J22,NA,NA,NA,NA
silence,223938,225361,1423,Japan,J22,NA,NA,NA,NA
silence,229154,229806,652,Japan,J22,NA,NA,NA,NA
silence,234020,234043,23,Japan,J22,NA,NA,NA,NA
silence,234734,236562,1828,Japan,J22,NA,NA,NA,NA
silence,240170,240374,204,Japan,J22,NA,NA,NA,NA
mother,240374,241154,780,Japan,J22,f,NA,NA,q
silence,246451,246478,27,Japan,J22,NA,NA,NA,NA
silence,246842,248096,1254,Japan,J22,NA,NA,NA,NA
silence,251043,251054,11,Japan,J22,NA,NA,NA,NA
silence,255236,256949,1713,Japan,J22,NA,NA,NA,NA
silence,258043,258557,514,Japan,J22,NA,NA,NA,NA
silence,261353,261662,309,Japan,J22,NA,NA,NA,NA
silence,264547,265239,692,Japan,J22,NA,NA,NA,NA
father_gesture,266496,267940,1444,Japan,J22,NA,NA,NA,NA
mother,267944,269060,1116,Japan,J22,f,NA,NA,a
silence,269060,269457,397,Japan,J22,NA,NA,NA,NA
silence,270971,271060,89,Japan,J22,NA,NA,NA,NA
silence,272297,276620,4323,Japan,J22,NA,NA,NA,NA
silence,278319,279347,1028,Japan,J22,NA,NA,NA,NA
silence,280972,281861,889,Japan,J22,NA,NA,NA,NA
silence,284982,285012,30,Japan,J22,NA,NA,NA,NA
silence,285227,286662,1435,Japan,J22,NA,NA,NA,NA
silence,290658,290822,164,Japan,J22,NA,NA,NA,NA
silence,292263,292728,465,Japan,J22,NA,NA,NA,NA
silence,297855,298242,387,Japan,J22,NA,NA,NA,NA
silence,300525,302299,1774,Japan,J22,NA,NA,NA,NA
silence,303476,303893,417,Japan,J22,NA,NA,NA,NA
silence,305726,306612,886,Japan,J22,NA,NA,NA,NA
silence,308001,311430,3429,Japan,J22,NA,NA,NA,NA
silence,311968,312143,175,Japan,J22,NA,NA,NA,NA
silence,316116,316582,466,Japan,J22,NA,NA,NA,NA
silence,316994,317082,88,Japan,J22,NA,NA,NA,NA
silence,319143,319652,509,Japan,J22,NA,NA,NA,NA
silence,322289,324253,1964,Japan,J22,NA,NA,NA,NA
silence,330146,331165,1019,Japan,J22,NA,NA,NA,NA
silence,340220,346734,6514,Japan,J22,NA,NA,NA,NA
silence,347916,347949,33,Japan,J22,NA,NA,NA,NA
silence,348592,352651,4059,Japan,J22,NA,NA,NA,NA
silence,354971,358503,3532,Japan,J22,NA,NA,NA,NA
child,358503,360289,1786,Japan,J22,f,NA,NA,i
silence,361170,368463,7293,Japan,J22,NA,NA,NA,NA
silence,374159,377360,3201,Japan,J22,NA,NA,NA,NA
silence,382624,382800,176,Japan,J22,NA,NA,NA,NA
silence,383412,383488,76,Japan,J22,NA,NA,NA,NA
silence,392574,393176,602,Japan,J22,NA,NA,NA,NA
silence,394787,395949,1162,Japan,J22,NA,NA,NA,NA
father,395949,397181,1232,Japan,J22,b,NA,NA,a
silence,397181,399110,1929,Japan,J22,NA,NA,NA,NA
silence,400121,400518,397,Japan,J22,NA,NA,NA,NA
silence,400866,401148,282,Japan,J22,NA,NA,NA,NA
silence,401993,402181,188,Japan,J22,NA,NA,NA,NA
silence,403548,403971,423,Japan,J22,NA,NA,NA,NA
silence,406888,409059,2171,Japan,J22,NA,NA,NA,NA
silence,410531,410680,149,Japan,J22,NA,NA,NA,NA
silence,412474,416325,3851,Japan,J22,NA,NA,NA,NA
silence,417287,418719,1432,Japan,J22,NA,NA,NA,NA
silence,420623,423160,2537,Japan,J22,NA,NA,NA,NA
silence,423563,424353,790,Japan,J22,NA,NA,NA,NA
silence,426004,426154,150,Japan,J22,NA,NA,NA,NA
silence,427755,429043,1288,Japan,J22,NA,NA,NA,NA
silence,432386,432723,337,Japan,J22,NA,NA,NA,NA
silence,436159,436866,707,Japan,J22,NA,NA,NA,NA
silence,437877,439137,1260,Japan,J22,NA,NA,NA,NA
silence,440041,445905,5864,Japan,J22,NA,NA,NA,NA
father,449280,449648,368,Japan,J22,m,NA,NA,a
silence,451960,452615,655,Japan,J22,NA,NA,NA,NA
father,452615,453096,481,Japan,J22,m,NA,NA,q
silence,453096,453185,89,Japan,J22,NA,NA,NA,NA
silence,455992,456863,871,Japan,J22,NA,NA,NA,NA
silence,457280,457854,574,Japan,J22,NA,NA,NA,NA
silence,459695,459889,194,Japan,J22,NA,NA,NA,NA
silence,461971,465568,3597,Japan,J22,NA,NA,NA,NA
silence,467537,467938,401,Japan,J22,NA,NA,NA,NA
silence,472684,473772,1088,Japan,J22,NA,NA,NA,NA
silence,474276,475800,1524,Japan,J22,NA,NA,NA,NA
silence,477859,480079,2220,Japan,J22,NA,NA,NA,NA
silence,487452,488635,1183,Japan,J22,NA,NA,NA,NA
silence,489870,491341,1471,Japan,J22,NA,NA,NA,NA
silence,498601,498684,83,Japan,J22,NA,NA,NA,NA
silence,511521,511756,235,Japan,J22,NA,NA,NA,NA
silence,531078,531109,31,Japan,J22,NA,NA,NA,NA
mother,535529,535960,431,Japan,J22,f,NA,NA,NA
mother,539351,539950,599,Japan,J22,f,NA,NA,NA
mother,543010,543529,519,Japan,J22,f,NA,NA,NA
mother,551955,552494,539,Japan,J22,f,NA,NA,NA
silence,552494,552507,13,Japan,J22,NA,NA,NA,NA
silence,577104,577203,99,Japan,J22,NA,NA,NA,NA
silence,577800,580029,2229,Japan,J22,NA,NA,NA,NA
silence,588177,588221,44,Japan,J22,NA,NA,NA,NA
silence,590137,590413,276,Japan,J22,NA,NA,NA,NA
silence,591043,591065,22,Japan,J22,NA,NA,NA,NA
silence,592933,596365,3432,Japan,J22,NA,NA,NA,NA
silence,597365,597806,441,Japan,J22,NA,NA,NA,NA
child,1937,2499,562,Japan,J23,m,1,1,q
mother,14619,17315,2696,Japan,J23,c,1,2,a
father,7932,10317,2385,Japan,J23,m,2,1,a
child,20155,21408,1253,Japan,J23,f,3,1,a
father,26743,28171,1428,Japan,J23,c,4,1,q
child,28757,34569,5812,Japan,J23,f,4,2,a
mother,45326,45891,565,Japan,J23,c,5,1,q
child,46271,48564,2293,Japan,J23,m,5,2,a
child,53597,57380,3783,Japan,J23,m,5,3,a
father,58880,59631,751,Japan,J23,c,6,1,q
child,62117,65017,2900,Japan,J23,f,6,2,a
father,65759,66369,610,Japan,J23,c,6,3,q
child,66657,69457,2800,Japan,J23,f,6,4,a
father,72032,72999,967,Japan,J23,c,6,5,q
child,73427,79177,5750,Japan,J23,f,6,6,a
father,80901,84274,3373,Japan,J23,c,6,7,q
mother,86580,87299,719,Japan,J23,f,6,8,a
father,90843,93422,2579,Japan,J23,c,6,9,i
mother,93818,94928,1110,Japan,J23,b,7,1,a
father,105074,106090,1016,Japan,J23,c,8,1,q
mother,106122,109193,3071,Japan,J23,c,8,2,i
mother,113116,114547,1431,Japan,J23,c,8,3,i
father,118769,119582,813,Japan,J23,b,9,1,a
mother,120117,121485,1368,Japan,J23,f,9,2,a
child,119557,125747,6190,Japan,J23,o,10,1,a
mother,126840,128674,1834,Japan,J23,f,11,1,a
father,128674,130622,1948,Japan,J23,m,11,2,q
mother,131409,131668,259,Japan,J23,f,11,3,q
father,133898,134709,811,Japan,J23,m,11,4,q
mother,135691,136956,1265,Japan,J23,f,11,5,a
father,136675,137351,676,Japan,J23,m,11,6,a
child,131701,138397,6696,Japan,J23,o,12,1,a
mother,142867,143459,592,Japan,J23,c,13,1,a
child,148357,149316,959,Japan,J23,b,14,1,a
mother,150873,152160,1287,Japan,J23,f,15,1,a
father,152201,152786,585,Japan,J23,m,15,2,a
child,155663,169587,13924,Japan,J23,o,16,1,a
father,171274,171952,678,Japan,J23,m,17,1,a
father,171997,173603,1606,Japan,J23,m,18,1,a
mother,172995,173981,986,Japan,J23,f,18,2,q
child,176317,178152,1835,Japan,J23,o,19,1,a
mother,176325,180530,4205,Japan,J23,c,20,1,a
child,180547,182262,1715,Japan,J23,m,20,2,a
mother,183094,186188,3094,Japan,J23,c,20,3,a
child,188225,190330,2105,Japan,J23,m,20,4,a
father,194795,196191,1396,Japan,J23,c,20,5,q
child,197324,199747,2423,Japan,J23,m,20,6,a
mother,197337,198088,751,Japan,J23,c,20,7,q
mother,200044,207343,7299,Japan,J23,f,21,1,q
father,207580,208059,479,Japan,J23,m,21,2,a
mother,208044,209018,974,Japan,J23,f,21,3,q
father,210559,211655,1096,Japan,J23,m,21,4,a
father,217664,219500,1836,Japan,J23,m,21,5,a
mother,220834,223586,2752,Japan,J23,f,21,6,a
father,223559,223922,363,Japan,J23,m,21,7,a
father,225843,227744,1901,Japan,J23,m,22,1,a
mother,227702,228377,675,Japan,J23,m,22,2,a
father,239506,242345,2839,Japan,J23,m,23,1,a
mother,242564,243521,957,Japan,J23,f,23,2,q
father,244174,245932,1758,Japan,J23,m,23,3,a
mother,246247,246652,405,Japan,J23,f,23,4,a
father,250122,251859,1737,Japan,J23,m,23,5,q
mother,251928,252657,729,Japan,J23,f,23,6,a
child,258103,259632,1529,Japan,J23,b,24,1,a
mother,261669,262690,1021,Japan,J23,c,24,2,a
child,262802,265176,2374,Japan,J23,m,24,3,a
father,264664,266390,1726,Japan,J23,m,24,4,q
mother,266276,267215,939,Japan,J23,f,24,5,a
child,273060,275023,1963,Japan,J23,f,25,1,i
father,275290,276482,1192,Japan,J23,c,25,2,a
child,276790,279912,3122,Japan,J23,f,25,3,i
mother,281287,287254,5967,Japan,J23,c,25,4,a
father,283585,284458,873,Japan,J23,c,26,1,a
father,288606,289380,774,Japan,J23,c,26,2,a
child,296647,298796,2149,Japan,J23,f,27,1,i
father,298042,298439,397,Japan,J23,c,27,2,a
father,299311,300317,1006,Japan,J23,c,27,3,a
child,300201,300573,372,Japan,J23,f,27,4,a
father,300738,301836,1098,Japan,J23,c,27,5,i
child,301851,302238,387,Japan,J23,f,27,6,a
child,303876,304532,656,Japan,J23,o,27,7,a
father,305174,305553,379,Japan,J23,c,27,8,q
child,306103,308201,2098,Japan,J23,f,27,9,a
father,308553,316590,8037,Japan,J23,c,27,10,a
father,319611,321117,1506,Japan,J23,c,27,11,a
child,323925,331097,7172,Japan,J23,f,27,12,a
mother,332392,335790,3398,Japan,J23,f,27,13,q
father,334336,334932,596,Japan,J23,m,27,14,a
father,347052,349690,2638,Japan,J23,c,27,15,a
child,350704,351708,1004,Japan,J23,f,27,16,a
father,352364,354695,2331,Japan,J23,c,27,17,a
child,356193,357422,1229,Japan,J23,o,27,18,a
mother,356840,359210,2370,Japan,J23,c,27,19,a
child,361460,361943,483,Japan,J23,m,27,20,a
father,362553,365343,2790,Japan,J23,m,28,1,a
mother,364465,367122,2657,Japan,J23,f,28,2,a
father,367237,367695,458,Japan,J23,m,28,3,a
mother,367718,368166,448,Japan,J23,f,28,4,a
father,370374,372186,1812,Japan,J23,m,28,5,a
mother,372199,372635,436,Japan,J23,f,28,6,a
mother,383735,386856,3121,Japan,J23,f,29,1,a
father,385864,387432,1568,Japan,J23,m,29,2,a
mother,387447,390409,2962,Japan,J23,f,29,3,a
father,390374,390993,619,Japan,J23,m,29,4,a
mother,394641,396856,2215,Japan,J23,f,29,5,a
father,396879,399364,2485,Japan,J23,m,29,6,a
mother,399453,399823,370,Japan,J23,f,29,7,a
father,404490,404932,442,Japan,J23,m,29,8,a
mother,410435,412893,2458,Japan,J23,f,29,9,a
father,413232,413538,306,Japan,J23,m,29,10,a
mother,413757,414356,599,Japan,J23,f,29,11,a
child,393195,397422,4227,Japan,J23,m,30,1,a
child,399839,405833,5994,Japan,J23,o,31,1,a
child,413446,417402,3956,Japan,J23,f,32,1,a
father,418590,419780,1190,Japan,J23,c,32,2,a
child,420722,421906,1184,Japan,J23,f,32,3,a
father,421750,422318,568,Japan,J23,c,32,4,i
child,422600,423416,816,Japan,J23,f,32,5,a
father,424222,425711,1489,Japan,J23,c,32,6,a
child,425855,428031,2176,Japan,J23,f,32,7,a
father,436006,436835,829,Japan,J23,c,33,1,a
father,442699,444764,2065,Japan,J23,b,34,1,a
mother,444784,446884,2100,Japan,J23,f,34,2,a
mother,450276,450834,558,Japan,J23,m,34,3,q
child,451483,453103,1620,Japan,J23,m,34,4,a
mother,453414,454552,1138,Japan,J23,c,34,5,q
child,454961,460256,5295,Japan,J23,m,34,6,a
father,460274,463051,2777,Japan,J23,c,34,7,a
child,465293,467244,1951,Japan,J23,f,35,1,i
father,467117,469262,2145,Japan,J23,c,35,2,a
child,469702,473158,3456,Japan,J23,f,35,3,a
father,473390,474957,1567,Japan,J23,c,35,4,a
child,475084,476814,1730,Japan,J23,f,35,5,a
father,477890,479933,2043,Japan,J23,c,35,6,a
child,480274,484004,3730,Japan,J23,f,35,7,a
father,484143,486106,1963,Japan,J23,c,35,8,a
child,486164,490452,4288,Japan,J23,f,35,9,a
child,496332,498970,2638,Japan,J23,m,35,10,a
child,501256,504225,2969,Japan,J23,o,36,1,a
mother,515912,517862,1950,Japan,J23,f,37,1,q
father,516143,518611,2468,Japan,J23,m,38,1,q
mother,518950,520447,1497,Japan,J23,f,38,2,q
father,520590,520938,348,Japan,J23,m,38,3,a
mother,520967,521293,326,Japan,J23,f,38,4,a
father,526274,529411,3137,Japan,J23,m,38,5,a
mother,529442,529907,465,Japan,J23,f,38,6,a
child,523167,534078,10911,Japan,J23,b,39,1,a
father,533753,535567,1814,Japan,J23,c,39,2,a
child,537330,538288,958,Japan,J23,f,39,3,i
father,541053,542270,1217,Japan,J23,c,39,4,a
child,542426,543919,1493,Japan,J23,f,39,5,a
father,543504,547353,3849,Japan,J23,c,39,6,a
mother,551032,552199,1167,Japan,J23,f,40,1,q
father,553501,560527,7026,Japan,J23,m,40,2,a
mother,560619,561733,1114,Japan,J23,f,40,3,a
mother,579609,580441,832,Japan,J23,f,40,4,a
father,581017,582569,1552,Japan,J23,m,40,5,a
mother,582653,583187,534,Japan,J23,f,40,6,a
mother,584343,586599,2256,Japan,J23,f,40,7,q
father,586622,587364,742,Japan,J23,m,40,8,q
mother,587663,587972,309,Japan,J23,f,40,9,a
mother,589917,591740,1823,Japan,J23,f,40,10,q
father,591885,593601,1716,Japan,J23,m,40,11,q
mother,593762,594066,304,Japan,J23,f,40,12,q
father,594169,594638,469,Japan,J23,m,40,13,q
mother,595265,597691,2426,Japan,J23,f,40,14,a
father,597853,599538,1685,Japan,J23,m,40,15,a
mother,141298,141917,619,Japan,J23,f,41,1,q
silence,2499,7932,5433,Japan,J23,NA,NA,NA,NA
silence,10317,10475,158,Japan,J23,NA,NA,NA,NA
mother,10475,11895,1420,Japan,J23,f,NA,NA,a
silence,11895,14619,2724,Japan,J23,NA,NA,NA,NA
silence,17315,20155,2840,Japan,J23,NA,NA,NA,NA
silence,21408,26743,5335,Japan,J23,NA,NA,NA,NA
silence,28171,28757,586,Japan,J23,NA,NA,NA,NA
silence,34569,45326,10757,Japan,J23,NA,NA,NA,NA
silence,45891,46271,380,Japan,J23,NA,NA,NA,NA
silence,48564,53597,5033,Japan,J23,NA,NA,NA,NA
silence,57380,58880,1500,Japan,J23,NA,NA,NA,NA
silence,59631,62117,2486,Japan,J23,NA,NA,NA,NA
silence,65017,65759,742,Japan,J23,NA,NA,NA,NA
silence,66369,66657,288,Japan,J23,NA,NA,NA,NA
silence,69457,72032,2575,Japan,J23,NA,NA,NA,NA
silence,72999,73427,428,Japan,J23,NA,NA,NA,NA
child_gesture,76050,77249,1199,Japan,J23,NA,NA,NA,NA
silence,79177,80901,1724,Japan,J23,NA,NA,NA,NA
silence,84274,86580,2306,Japan,J23,NA,NA,NA,NA
silence,87299,90843,3544,Japan,J23,NA,NA,NA,NA
father_gesture,92094,93431,1337,Japan,J23,NA,NA,NA,NA
silence,93422,93818,396,Japan,J23,NA,NA,NA,NA
silence,94928,105074,10146,Japan,J23,NA,NA,NA,NA
silence,106090,106122,32,Japan,J23,NA,NA,NA,NA
silence,109193,113116,3923,Japan,J23,NA,NA,NA,NA
silence,114547,118769,4222,Japan,J23,NA,NA,NA,NA
silence,125747,126840,1093,Japan,J23,NA,NA,NA,NA
silence,130622,131409,787,Japan,J23,NA,NA,NA,NA
silence,131668,131701,33,Japan,J23,NA,NA,NA,NA
mother_gesture,135932,137182,1250,Japan,J23,NA,NA,NA,NA
silence,138397,141298,2901,Japan,J23,NA,NA,NA,NA
silence,141917,142867,950,Japan,J23,NA,NA,NA,NA
silence,143459,148357,4898,Japan,J23,NA,NA,NA,NA
silence,149316,150873,1557,Japan,J23,NA,NA,NA,NA
silence,152160,152201,41,Japan,J23,NA,NA,NA,NA
silence,152786,155663,2877,Japan,J23,NA,NA,NA,NA
silence,169587,171274,1687,Japan,J23,NA,NA,NA,NA
silence,171952,171997,45,Japan,J23,NA,NA,NA,NA
silence,173981,176317,2336,Japan,J23,NA,NA,NA,NA
silence,180530,180547,17,Japan,J23,NA,NA,NA,NA
silence,182262,183094,832,Japan,J23,NA,NA,NA,NA
silence,186188,188225,2037,Japan,J23,NA,NA,NA,NA
silence,190330,194795,4465,Japan,J23,NA,NA,NA,NA
silence,196191,197324,1133,Japan,J23,NA,NA,NA,NA
child_gesture,197874,199691,1817,Japan,J23,NA,NA,NA,NA
silence,199747,200044,297,Japan,J23,NA,NA,NA,NA
silence,207343,207580,237,Japan,J23,NA,NA,NA,NA
silence,209018,210559,1541,Japan,J23,NA,NA,NA,NA
silence,211655,217664,6009,Japan,J23,NA,NA,NA,NA
silence,219500,220834,1334,Japan,J23,NA,NA,NA,NA
silence,223922,225843,1921,Japan,J23,NA,NA,NA,NA
silence,228377,239506,11129,Japan,J23,NA,NA,NA,NA
silence,242345,242564,219,Japan,J23,NA,NA,NA,NA
silence,243521,244174,653,Japan,J23,NA,NA,NA,NA
silence,245932,246247,315,Japan,J23,NA,NA,NA,NA
silence,246652,250122,3470,Japan,J23,NA,NA,NA,NA
silence,251859,251928,69,Japan,J23,NA,NA,NA,NA
silence,252657,258103,5446,Japan,J23,NA,NA,NA,NA
silence,259632,261669,2037,Japan,J23,NA,NA,NA,NA
silence,262690,262802,112,Japan,J23,NA,NA,NA,NA
silence,267215,273060,5845,Japan,J23,NA,NA,NA,NA
silence,275023,275290,267,Japan,J23,NA,NA,NA,NA
silence,276482,276790,308,Japan,J23,NA,NA,NA,NA
silence,279912,281287,1375,Japan,J23,NA,NA,NA,NA
silence,287254,288606,1352,Japan,J23,NA,NA,NA,NA
silence,289380,296647,7267,Japan,J23,NA,NA,NA,NA
silence,298796,299311,515,Japan,J23,NA,NA,NA,NA
silence,300573,300738,165,Japan,J23,NA,NA,NA,NA
father_gesture,300652,301560,908,Japan,J23,NA,NA,NA,NA
silence,301836,301851,15,Japan,J23,NA,NA,NA,NA
silence,302238,303876,1638,Japan,J23,NA,NA,NA,NA
silence,304532,305174,642,Japan,J23,NA,NA,NA,NA
silence,305553,306103,550,Japan,J23,NA,NA,NA,NA
child_gesture,305696,307381,1685,Japan,J23,NA,NA,NA,NA
silence,308201,308553,352,Japan,J23,NA,NA,NA,NA
father_gesture,308436,310265,1829,Japan,J23,NA,NA,NA,NA
father_gesture,312812,315851,3039,Japan,J23,NA,NA,NA,NA
silence,316590,319611,3021,Japan,J23,NA,NA,NA,NA
silence,321117,323925,2808,Japan,J23,NA,NA,NA,NA
child_gesture,323664,325625,1961,Japan,J23,NA,NA,NA,NA
silence,331097,332392,1295,Japan,J23,NA,NA,NA,NA
silence,335790,347052,11262,Japan,J23,NA,NA,NA,NA
silence,349690,350704,1014,Japan,J23,NA,NA,NA,NA
silence,351708,352364,656,Japan,J23,NA,NA,NA,NA
silence,354695,356193,1498,Japan,J23,NA,NA,NA,NA
silence,359210,361460,2250,Japan,J23,NA,NA,NA,NA
silence,361943,362553,610,Japan,J23,NA,NA,NA,NA
silence,367122,367237,115,Japan,J23,NA,NA,NA,NA
silence,367695,367718,23,Japan,J23,NA,NA,NA,NA
silence,368166,370374,2208,Japan,J23,NA,NA,NA,NA
silence,372186,372199,13,Japan,J23,NA,NA,NA,NA
silence,372635,383735,11100,Japan,J23,NA,NA,NA,NA
silence,387432,387447,15,Japan,J23,NA,NA,NA,NA
silence,390993,393195,2202,Japan,J23,NA,NA,NA,NA
silence,399364,399453,89,Japan,J23,NA,NA,NA,NA
silence,399823,399839,16,Japan,J23,NA,NA,NA,NA
mother,403365,404442,1077,Japan,J23,f,NA,NA,a
silence,405833,410435,4602,Japan,J23,NA,NA,NA,NA
silence,412893,413232,339,Japan,J23,NA,NA,NA,NA
silence,417402,418590,1188,Japan,J23,NA,NA,NA,NA
father_gesture,418456,419965,1509,Japan,J23,NA,NA,NA,NA
silence,419780,420722,942,Japan,J23,NA,NA,NA,NA
silence,422318,422600,282,Japan,J23,NA,NA,NA,NA
silence,423416,424222,806,Japan,J23,NA,NA,NA,NA
silence,425711,425855,144,Japan,J23,NA,NA,NA,NA
silence,428031,436006,7975,Japan,J23,NA,NA,NA,NA
silence,436835,442699,5864,Japan,J23,NA,NA,NA,NA
silence,444764,444784,20,Japan,J23,NA,NA,NA,NA
silence,446884,447974,1090,Japan,J23,NA,NA,NA,NA
child,447974,450072,2098,Japan,J23,f,NA,NA,a
silence,450072,450276,204,Japan,J23,NA,NA,NA,NA
silence,450834,451483,649,Japan,J23,NA,NA,NA,NA
silence,453103,453414,311,Japan,J23,NA,NA,NA,NA
silence,454552,454961,409,Japan,J23,NA,NA,NA,NA
father_gesture,459939,462646,2707,Japan,J23,NA,NA,NA,NA
silence,460256,460274,18,Japan,J23,NA,NA,NA,NA
silence,463051,465293,2242,Japan,J23,NA,NA,NA,NA
child_gesture,465402,467729,2327,Japan,J23,NA,NA,NA,NA
father_gesture,467447,469254,1807,Japan,J23,NA,NA,NA,NA
silence,469262,469702,440,Japan,J23,NA,NA,NA,NA
child_gesture,469608,471469,1861,Japan,J23,NA,NA,NA,NA
father_gesture,473141,474665,1524,Japan,J23,NA,NA,NA,NA
silence,473158,473390,232,Japan,J23,NA,NA,NA,NA
child_gesture,474948,476760,1812,Japan,J23,NA,NA,NA,NA
silence,474957,475084,127,Japan,J23,NA,NA,NA,NA
silence,476814,477890,1076,Japan,J23,NA,NA,NA,NA
father_gesture,477676,479274,1598,Japan,J23,NA,NA,NA,NA
silence,479933,480274,341,Japan,J23,NA,NA,NA,NA
child_gesture,480115,484356,4241,Japan,J23,NA,NA,NA,NA
silence,484004,484143,139,Japan,J23,NA,NA,NA,NA
father_gesture,484934,486203,1269,Japan,J23,NA,NA,NA,NA
silence,486106,486164,58,Japan,J23,NA,NA,NA,NA
silence,490452,496332,5880,Japan,J23,NA,NA,NA,NA
silence,498970,501256,2286,Japan,J23,NA,NA,NA,NA
silence,504225,515912,11687,Japan,J23,NA,NA,NA,NA
silence,518611,518950,339,Japan,J23,NA,NA,NA,NA
silence,520447,520590,143,Japan,J23,NA,NA,NA,NA
silence,520938,520967,29,Japan,J23,NA,NA,NA,NA
silence,521293,523167,1874,Japan,J23,NA,NA,NA,NA
child_gesture,529556,534315,4759,Japan,J23,NA,NA,NA,NA
silence,535567,537330,1763,Japan,J23,NA,NA,NA,NA
silence,538288,541053,2765,Japan,J23,NA,NA,NA,NA
silence,542270,542426,156,Japan,J23,NA,NA,NA,NA
silence,547353,551032,3679,Japan,J23,NA,NA,NA,NA
silence,552199,553501,1302,Japan,J23,NA,NA,NA,NA
silence,560527,560619,92,Japan,J23,NA,NA,NA,NA
silence,561733,577948,16215,Japan,J23,NA,NA,NA,NA
father,577948,579301,1353,Japan,J23,m,NA,NA,a
silence,579301,579609,308,Japan,J23,NA,NA,NA,NA
silence,580441,581017,576,Japan,J23,NA,NA,NA,NA
silence,582569,582653,84,Japan,J23,NA,NA,NA,NA
silence,583187,584343,1156,Japan,J23,NA,NA,NA,NA
silence,586599,586622,23,Japan,J23,NA,NA,NA,NA
silence,587364,587663,299,Japan,J23,NA,NA,NA,NA
silence,587972,589917,1945,Japan,J23,NA,NA,NA,NA
silence,591740,591885,145,Japan,J23,NA,NA,NA,NA
silence,593601,593762,161,Japan,J23,NA,NA,NA,NA
silence,594066,594169,103,Japan,J23,NA,NA,NA,NA
silence,594638,595265,627,Japan,J23,NA,NA,NA,NA
silence,597691,597853,162,Japan,J23,NA,NA,NA,NA
mother,6571,8697,2126,Japan,J24,b,1,1,a
child,14518,16786,2268,Japan,J24,f,1,2,a
father,16462,17382,920,Japan,J24,c,1,3,a
mother,16827,19888,3061,Japan,J24,c,1,4,q
child,20415,22905,2490,Japan,J24,m,2,1,NA
mother,22739,24629,1890,Japan,J24,c,2,2,i
mother,32344,33706,1362,Japan,J24,b,3,1,a
mother,51634,53428,1794,Japan,J24,c,5,1,i
child,53001,56452,3451,Japan,J24,f,6,1,q
mother,56524,56879,355,Japan,J24,c,6,2,q
child,57584,60089,2505,Japan,J24,f,6,3,q
father,60249,61756,1507,Japan,J24,c,6,4,a
father,66463,67408,945,Japan,J24,c,7,1,a
child,69793,70731,938,Japan,J24,f,7,2,a
father,71314,71983,669,Japan,J24,f,7,3,a
father,64170,65667,1497,Japan,J24,m,8,1,i
father,68573,69628,1055,Japan,J24,m,8,2,a
father,72014,73021,1007,Japan,J24,c,9,1,a
mother,98739,100492,1753,Japan,J24,c,10,1,a
mother,105722,106515,793,Japan,J24,c,10,2,q
mother,106565,107211,646,Japan,J24,c,11,1,q
father,107362,108265,903,Japan,J24,m,11,2,a
father,109888,110243,355,Japan,J24,b,11,3,a
mother,110628,113711,3083,Japan,J24,c,12,1,a
mother,117656,121783,4127,Japan,J24,c,13,1,a
father,125722,126304,582,Japan,J24,m,14,1,a
mother,126745,127048,303,Japan,J24,f,14,2,a
father,126778,127743,965,Japan,J24,m,14,3,q
mother,127855,128501,646,Japan,J24,f,14,4,q
mother,129568,131041,1473,Japan,J24,f,14,5,q
father,131626,133826,2200,Japan,J24,m,14,6,q
mother,134101,136154,2053,Japan,J24,f,14,7,a
father,136214,136739,525,Japan,J24,m,14,8,a
mother,137115,137522,407,Japan,J24,f,14,9,a
child,134894,135921,1027,Japan,J24,o,15,1,a
child,138629,139682,1053,Japan,J24,m,15,2,a
mother,142373,144535,2162,Japan,J24,c,16,1,q
mother,146071,149972,3901,Japan,J24,c,16,2,a
mother,151225,155164,3939,Japan,J24,c,16,3,a
mother,158247,159177,930,Japan,J24,c,16,4,q
child,161034,162282,1248,Japan,J24,m,16,5,a
mother,162133,166275,4142,Japan,J24,c,16,6,q
mother,170168,171791,1623,Japan,J24,c,16,7,a
mother,179330,180380,1050,Japan,J24,f,17,1,a
father,181960,183220,1260,Japan,J24,m,17,2,a
mother,182820,183457,637,Japan,J24,f,17,3,a
mother,185242,186396,1154,Japan,J24,o,18,1,a
father,188606,191855,3249,Japan,J24,m,19,1,i
mother,192242,193210,968,Japan,J24,c,20,1,i
mother,196954,198254,1300,Japan,J24,NA,20,2,a
mother,214490,216238,1748,Japan,J24,f,21,1,q
father,216314,216954,640,Japan,J24,m,21,2,a
mother,219225,231037,11812,Japan,J24,f,21,3,a
father,221838,222258,420,Japan,J24,m,21,4,a
father,225430,225722,292,Japan,J24,m,21,5,a
father,231214,232363,1149,Japan,J24,m,21,6,a
mother,232412,233272,860,Japan,J24,f,21,7,q
father,233269,233761,492,Japan,J24,m,21,8,a
mother,233989,237745,3756,Japan,J24,f,21,9,a
father,238043,238849,806,Japan,J24,m,21,10,q
mother,238927,239651,724,Japan,J24,f,21,11,a
father,239745,240065,320,Japan,J24,m,21,12,q
mother,240104,240949,845,Japan,J24,f,21,13,a
mother,243579,246142,2563,Japan,J24,f,21,14,a
child,267103,268218,1115,Japan,J24,m,22,1,a
mother,268524,269004,480,Japan,J24,c,22,2,q
child,279224,280775,1551,Japan,J24,m,22,3,a
mother,281258,283357,2099,Japan,J24,c,22,4,a
child,283868,285971,2103,Japan,J24,m,22,5,q
mother,285997,291175,5178,Japan,J24,c,22,6,a
child,292441,299102,6661,Japan,J24,m,22,7,q
mother,298888,299527,639,Japan,J24,c,22,8,q
child,299507,301446,1939,Japan,J24,m,22,9,a
mother,301676,303001,1325,Japan,J24,c,22,10,q
child,304927,306745,1818,Japan,J24,m,22,11,a
mother,306849,307433,584,Japan,J24,c,22,12,a
child,307419,313308,5889,Japan,J24,c,22,13,a
mother,313463,314385,922,Japan,J24,c,22,14,q
mother,276709,278253,1544,Japan,J24,c,23,1,a
mother,314562,316275,1713,Japan,J24,c,24,1,a
mother,319943,321170,1227,Japan,J24,c,24,2,q
mother,323242,325043,1801,Japan,J24,c,25,1,a
father,326617,327287,670,Japan,J24,m,25,2,q
mother,327656,328143,487,Japan,J24,f,25,3,a
father,329949,330600,651,Japan,J24,m,25,4,a
mother,331396,331855,459,Japan,J24,f,25,5,a
mother,340560,341134,574,Japan,J24,c,26,1,a
mother,343186,344460,1274,Japan,J24,c,26,2,q
mother,361970,364446,2476,Japan,J24,f,27,1,q
father,364639,365076,437,Japan,J24,m,27,2,q
mother,371170,372899,1729,Japan,J24,c,28,1,a
child,374107,375147,1040,Japan,J24,m,29,1,q
mother,375075,375536,461,Japan,J24,c,29,2,q
mother,376815,377612,797,Japan,J24,c,29,3,q
child,378700,382739,4039,Japan,J24,m,29,4,q
mother,382816,384457,1641,Japan,J24,c,29,5,q
mother,386667,388275,1608,Japan,J24,c,29,6,q
mother,421457,423164,1707,Japan,J24,f,30,1,a
father,423982,424855,873,Japan,J24,m,30,2,a
child,430364,432568,2204,Japan,J24,m,31,1,a
mother,433140,439363,6223,Japan,J24,c,31,2,q
mother,464739,466371,1632,Japan,J24,c,32,1,i
mother,472551,475497,2946,Japan,J24,c,32,2,q
mother,482535,486308,3773,Japan,J24,f,32,3,q
father,485756,486463,707,Japan,J24,m,32,4,a
mother,491463,493352,1889,Japan,J24,f,32,5,a
mother,502998,504323,1325,Japan,J24,f,32,6,q
father,504468,504910,442,Japan,J24,m,32,7,q
mother,506314,507750,1436,Japan,J24,f,33,1,q
father,507838,508115,277,Japan,J24,m,33,2,a
mother,509684,510695,1011,Japan,J24,f,33,3,q
father,511297,511789,492,Japan,J24,f,33,4,q
mother,511966,512599,633,Japan,J24,f,33,5,q
father,512683,512985,302,Japan,J24,m,33,6,a
mother,514462,515557,1095,Japan,J24,f,33,7,q
father,516446,516861,415,Japan,J24,m,33,8,a
mother,517761,519153,1392,Japan,J24,f,33,9,q
father,519573,519982,409,Japan,J24,m,33,10,q
mother,521955,522817,862,Japan,J24,f,33,11,a
father,525060,528402,3342,Japan,J24,m,33,12,a
mother,530584,531168,584,Japan,J24,c,34,1,q
child,531382,532131,749,Japan,J24,m,34,2,a
mother,533292,536496,3204,Japan,J24,c,34,3,i
father,536910,537888,978,Japan,J24,m,35,1,a
mother,538753,539584,831,Japan,J24,f,35,2,q
mother,541629,543149,1520,Japan,J24,f,35,3,a
father,543836,552015,8179,Japan,J24,m,35,4,a
mother,552630,553043,413,Japan,J24,f,35,5,a
father,558501,559776,1275,Japan,J24,m,35,6,a
mother,562560,564836,2276,Japan,J24,c,35,7,a
mother,578657,581263,2606,Japan,J24,c,36,1,a
mother,592863,593339,476,Japan,J24,c,37,1,q
child,594498,596209,1711,Japan,J24,m,37,2,a
mother,596543,597553,1010,Japan,J24,c,37,3,q
silence,8697,14518,5821,Japan,J24,NA,NA,NA,NA
silence,19888,20415,527,Japan,J24,NA,NA,NA,NA
silence,24629,32344,7715,Japan,J24,NA,NA,NA,NA
silence,33706,35648,1942,Japan,J24,NA,NA,NA,NA
mother,35648,36341,693,Japan,J24,c,NA,NA,a
silence,36341,51634,15293,Japan,J24,NA,NA,NA,NA
silence,56452,56524,72,Japan,J24,NA,NA,NA,NA
silence,56879,57584,705,Japan,J24,NA,NA,NA,NA
silence,60089,60249,160,Japan,J24,NA,NA,NA,NA
silence,61756,63529,1773,Japan,J24,NA,NA,NA,NA
child,63529,66734,3205,Japan,J24,f,NA,NA,a
silence,67408,68573,1165,Japan,J24,NA,NA,NA,NA
silence,69628,69793,165,Japan,J24,NA,NA,NA,NA
silence,70731,71314,583,Japan,J24,NA,NA,NA,NA
silence,71983,72014,31,Japan,J24,NA,NA,NA,NA
silence,73021,98739,25718,Japan,J24,NA,NA,NA,NA
silence,100492,105722,5230,Japan,J24,NA,NA,NA,NA
silence,106515,106565,50,Japan,J24,NA,NA,NA,NA
silence,107211,107362,151,Japan,J24,NA,NA,NA,NA
silence,108265,109888,1623,Japan,J24,NA,NA,NA,NA
silence,110243,110628,385,Japan,J24,NA,NA,NA,NA
silence,113711,117656,3945,Japan,J24,NA,NA,NA,NA
silence,121783,125722,3939,Japan,J24,NA,NA,NA,NA
silence,126304,126745,441,Japan,J24,NA,NA,NA,NA
silence,127743,127855,112,Japan,J24,NA,NA,NA,NA
father,128369,129206,837,Japan,J24,m,NA,NA,a
silence,129206,129568,362,Japan,J24,NA,NA,NA,NA
silence,131041,131626,585,Japan,J24,NA,NA,NA,NA
silence,133826,134101,275,Japan,J24,NA,NA,NA,NA
mother_gesture,134104,135783,1679,Japan,J24,NA,NA,NA,NA
silence,136154,136214,60,Japan,J24,NA,NA,NA,NA
silence,136739,137115,376,Japan,J24,NA,NA,NA,NA
silence,137522,138629,1107,Japan,J24,NA,NA,NA,NA
silence,139682,142373,2691,Japan,J24,NA,NA,NA,NA
silence,144535,146071,1536,Japan,J24,NA,NA,NA,NA
silence,149972,151225,1253,Japan,J24,NA,NA,NA,NA
silence,155164,158247,3083,Japan,J24,NA,NA,NA,NA
silence,159177,161034,1857,Japan,J24,NA,NA,NA,NA
silence,166275,170168,3893,Japan,J24,NA,NA,NA,NA
silence,171791,179330,7539,Japan,J24,NA,NA,NA,NA
silence,180380,181960,1580,Japan,J24,NA,NA,NA,NA
silence,183457,185242,1785,Japan,J24,NA,NA,NA,NA
silence,186396,188606,2210,Japan,J24,NA,NA,NA,NA
silence,191855,192242,387,Japan,J24,NA,NA,NA,NA
silence,193210,196954,3744,Japan,J24,NA,NA,NA,NA
silence,198254,214490,16236,Japan,J24,NA,NA,NA,NA
silence,216238,216314,76,Japan,J24,NA,NA,NA,NA
silence,216954,219225,2271,Japan,J24,NA,NA,NA,NA
mother_gesture,219174,224468,5294,Japan,J24,NA,NA,NA,NA
mother_gesture,225529,229312,3783,Japan,J24,NA,NA,NA,NA
silence,231037,231214,177,Japan,J24,NA,NA,NA,NA
silence,232363,232412,49,Japan,J24,NA,NA,NA,NA
silence,233761,233989,228,Japan,J24,NA,NA,NA,NA
silence,237745,238043,298,Japan,J24,NA,NA,NA,NA
silence,238849,238927,78,Japan,J24,NA,NA,NA,NA
silence,239651,239745,94,Japan,J24,NA,NA,NA,NA
silence,240065,240104,39,Japan,J24,NA,NA,NA,NA
silence,240949,243579,2630,Japan,J24,NA,NA,NA,NA
silence,246142,267103,20961,Japan,J24,NA,NA,NA,NA
silence,268218,268524,306,Japan,J24,NA,NA,NA,NA
silence,269004,276709,7705,Japan,J24,NA,NA,NA,NA
silence,278253,279224,971,Japan,J24,NA,NA,NA,NA
child_gesture,279475,283288,3813,Japan,J24,NA,NA,NA,NA
silence,280775,281258,483,Japan,J24,NA,NA,NA,NA
mother_gesture,281280,282877,1597,Japan,J24,NA,NA,NA,NA
silence,283357,283868,511,Japan,J24,NA,NA,NA,NA
silence,285971,285997,26,Japan,J24,NA,NA,NA,NA
silence,291175,292441,1266,Japan,J24,NA,NA,NA,NA
silence,301446,301676,230,Japan,J24,NA,NA,NA,NA
silence,303001,304927,1926,Japan,J24,NA,NA,NA,NA
child_gesture,304921,306968,2047,Japan,J24,NA,NA,NA,NA
silence,306745,306849,104,Japan,J24,NA,NA,NA,NA
child_gesture,308623,311159,2536,Japan,J24,NA,NA,NA,NA
child_gesture,311446,313949,2503,Japan,J24,NA,NA,NA,NA
silence,313308,313463,155,Japan,J24,NA,NA,NA,NA
silence,314385,314562,177,Japan,J24,NA,NA,NA,NA
silence,316275,319943,3668,Japan,J24,NA,NA,NA,NA
child_gesture,318590,320131,1541,Japan,J24,NA,NA,NA,NA
silence,321170,323242,2072,Japan,J24,NA,NA,NA,NA
silence,325043,326617,1574,Japan,J24,NA,NA,NA,NA
silence,327287,327656,369,Japan,J24,NA,NA,NA,NA
silence,328143,329949,1806,Japan,J24,NA,NA,NA,NA
silence,330600,331396,796,Japan,J24,NA,NA,NA,NA
silence,331855,340560,8705,Japan,J24,NA,NA,NA,NA
silence,341134,343186,2052,Japan,J24,NA,NA,NA,NA
silence,344460,361970,17510,Japan,J24,NA,NA,NA,NA
silence,364446,364639,193,Japan,J24,NA,NA,NA,NA
silence,365076,371170,6094,Japan,J24,NA,NA,NA,NA
silence,372899,374107,1208,Japan,J24,NA,NA,NA,NA
silence,375536,376815,1279,Japan,J24,NA,NA,NA,NA
silence,377612,378700,1088,Japan,J24,NA,NA,NA,NA
silence,382739,382816,77,Japan,J24,NA,NA,NA,NA
silence,384457,386667,2210,Japan,J24,NA,NA,NA,NA
silence,388275,421457,33182,Japan,J24,NA,NA,NA,NA
silence,423164,423982,818,Japan,J24,NA,NA,NA,NA
silence,424855,430364,5509,Japan,J24,NA,NA,NA,NA
silence,432568,433140,572,Japan,J24,NA,NA,NA,NA
silence,439363,464739,25376,Japan,J24,NA,NA,NA,NA
silence,466371,472551,6180,Japan,J24,NA,NA,NA,NA
silence,475497,482535,7038,Japan,J24,NA,NA,NA,NA
silence,486463,491463,5000,Japan,J24,NA,NA,NA,NA
silence,493352,502998,9646,Japan,J24,NA,NA,NA,NA
silence,504323,504468,145,Japan,J24,NA,NA,NA,NA
silence,504910,506314,1404,Japan,J24,NA,NA,NA,NA
silence,507750,507838,88,Japan,J24,NA,NA,NA,NA
silence,508115,509684,1569,Japan,J24,NA,NA,NA,NA
silence,510695,511297,602,Japan,J24,NA,NA,NA,NA
silence,511789,511966,177,Japan,J24,NA,NA,NA,NA
silence,512599,512683,84,Japan,J24,NA,NA,NA,NA
silence,512985,514462,1477,Japan,J24,NA,NA,NA,NA
silence,515557,516446,889,Japan,J24,NA,NA,NA,NA
silence,516861,517761,900,Japan,J24,NA,NA,NA,NA
silence,519153,519573,420,Japan,J24,NA,NA,NA,NA
silence,519982,521955,1973,Japan,J24,NA,NA,NA,NA
silence,522817,525060,2243,Japan,J24,NA,NA,NA,NA
child,527142,530187,3045,Japan,J24,m,NA,NA,a
silence,530187,530584,397,Japan,J24,NA,NA,NA,NA
silence,531168,531382,214,Japan,J24,NA,NA,NA,NA
silence,532131,533292,1161,Japan,J24,NA,NA,NA,NA
silence,536496,536910,414,Japan,J24,NA,NA,NA,NA
silence,537888,538753,865,Japan,J24,NA,NA,NA,NA
silence,539584,541629,2045,Japan,J24,NA,NA,NA,NA
silence,543149,543836,687,Japan,J24,NA,NA,NA,NA
silence,552015,552630,615,Japan,J24,NA,NA,NA,NA
silence,553043,558501,5458,Japan,J24,NA,NA,NA,NA
silence,559776,562560,2784,Japan,J24,NA,NA,NA,NA
silence,564836,578657,13821,Japan,J24,NA,NA,NA,NA
silence,581263,592863,11600,Japan,J24,NA,NA,NA,NA
silence,593339,594498,1159,Japan,J24,NA,NA,NA,NA
silence,596209,596543,334,Japan,J24,NA,NA,NA,NA
